date,username,content,reply_count,retweet_count,like_count,view_count,tweet_url,total_engagement
2025-10-10 08:22:46+00:00,IndoPopBase,Ariel Tatum serves as a KAI announcer in new video.,14,18,0,2568,https://x.com/IndoPopBase/status/1976564048780234777,32
2025-10-10 07:41:52+00:00,IndoPopBase,Sheryl Sheinafia announces new single ‘Lepas Kendali.’ Out next Friday.,3,2,0,2630,https://x.com/IndoPopBase/status/1976553753785532724,5
2025-10-10 07:31:34+00:00,IndoPopBase,"Afgan has released the music video for ‘Kacamata’ starring Yuki Kato.

Watch: 
youtu.be/DUyvYKa7sI4?si
…",6,15,0,4946,https://x.com/IndoPopBase/status/1976551164960440600,21
2025-10-10 06:32:23+00:00,IndoPopBase,"Nominations for the 28th annual #AMIAwards will be announced on October 13th at 14:00 WIB.

What are your predictions?",11,9,0,5055,https://x.com/IndoPopBase/status/1976536268361380248,20
2025-10-10 05:50:12+00:00,IndoPopBase,"Rossa drops new EP ‘Asmara Dansa.’

: 
open.spotify.com/album/78Jt2I1k
…",3,3,0,2988,https://x.com/IndoPopBase/status/1976525653005779369,6
2025-10-09 07:29:56+00:00,IndoPopBase,"Nikita Mirzani has been charged with extortion and threats, facing up to 11 years in jail and a Rp2 billion fine.",125,163,0,260551,https://x.com/IndoPopBase/status/1976188365889470543,288
2025-10-09 06:34:53+00:00,IndoPopBase,"Happy 47th birthday to the iconic Rossa.

Throughout her career, the multi-award-winning singer has released notable works such as ‘Tegar’, ‘Ayat-Ayat Cinta’, ‘Hati Yang Kau Sakiti’, and more. She remains one of Indonesia’s best-selling artists of all time, with over 12 million",21,43,0,17894,https://x.com/IndoPopBase/status/1976174511029662051,64
2025-10-08 19:24:01+00:00,IndoPopBase,Indonesia loses 2-3 against Saudi Arabia in the fourth round of the 2026 FIFA World Cup Qualifiers.,66,179,0,71006,https://x.com/IndoPopBase/status/1976005680743186483,245
2025-10-08 18:48:09+00:00,IndoPopBase,,52,304,0,62355,https://x.com/IndoPopBase/status/1975996654588432522,356
2025-10-08 16:18:43+00:00,IndoPopBase,"Chaos erupts ahead of the FIFA World Cup Qualifier Indonesia vs. Saudi Arabia as supporters face sudden gate changes, mixed-up seats, and several fainting outside amid confusion.",57,480,0,186722,https://x.com/IndoPopBase/status/1975959048869781896,537
2025-10-08 12:34:00+00:00,IndoPopBase,Rossa previews her new single ‘Sinaran’ feat. MK K-Clique. Out this Friday.,24,39,0,19220,https://x.com/IndoPopBase/status/1975902499031973927,63
2025-10-08 08:11:02+00:00,IndoPopBase,Naykilla announces her debut EP ‘centyl.’ Out October 17th.,131,696,0,297794,https://x.com/IndoPopBase/status/1975836321026613482,827
2025-10-08 08:06:02+00:00,IndoPopBase,"JKT48 has released their first original setlist ‘Pertaruhan Cinta.’

: 
open.spotify.com/album/5jhaywps
…",71,519,0,85861,https://x.com/IndoPopBase/status/1975835062110396788,590
2025-10-08 07:21:40+00:00,IndoPopBase,"GIGI has released their 14th studio album ‘Forever In The Air.’

: 
open.spotify.com/album/07rCINMa
…",23,70,0,80686,https://x.com/IndoPopBase/status/1975823896046936326,93
2025-10-08 06:49:26+00:00,IndoPopBase,"22 years ago today, Agnes Monica debuted as a popstar.",51,152,0,66476,https://x.com/IndoPopBase/status/1975815782849520044,203
2025-10-08 01:09:03+00:00,IndoPopBase,‘Penyalin Cahaya’ premiered 4 years ago today.,51,463,0,115574,https://x.com/IndoPopBase/status/1975730125808504964,514
2025-10-08 00:48:29+00:00,IndoPopBase,Idgitaf has released her new single ‘Sedia Aku Sebelum Hujan.’,36,120,0,28384,https://x.com/IndoPopBase/status/1975724946543550817,156
2025-10-06 07:37:56+00:00,IndoPopBase,The first episode of ‘Keluarga Cemara’ aired 29 years ago today on RCTI.,34,144,0,130987,https://x.com/IndoPopBase/status/1975103213763490249,178
2025-10-06 04:55:35+00:00,IndoPopBase,Andien stuns at #SynchronizeFest.,103,324,0,160266,https://x.com/IndoPopBase/status/1975062358600056852,427
2025-10-06 04:37:22+00:00,IndoPopBase,Syahrini is recording new music.,312,602,0,531251,https://x.com/IndoPopBase/status/1975057772657115583,914
2025-10-06 04:35:53+00:00,IndoPopBase,‘Album Vakansi’ by White Shoes & The Couples Company turns 15.,39,556,0,94477,https://x.com/IndoPopBase/status/1975057400010006584,595
2025-10-06 04:20:57+00:00,IndoPopBase,"27 years ago today, TEMPO Magazine made its comeback after a four-year ban under the New Order regime.",54,1862,0,234785,https://x.com/IndoPopBase/status/1975053641322303817,1916
2025-10-05 15:48:54+00:00,IndoPopBase,": 
@halief",0,0,0,55919,https://x.com/IndoPopBase/status/1974864379939344457,0
2025-10-05 15:48:52+00:00,IndoPopBase,Andika of Kangen Band wears a ‘We Should All Be Feminists’ shirt during their set at Synchronize Fest.,191,860,0,758929,https://x.com/IndoPopBase/status/1974864374952316950,1051
2025-10-05 15:42:03+00:00,IndoPopBase,Prilly Latuconsina debuts a bob cut.,190,363,0,447112,https://x.com/IndoPopBase/status/1974862659188363324,553
2025-10-05 14:18:48+00:00,IndoPopBase,Angga Yunanda with the chequered flag at the 2025 MotoGP Mandalika Grand Prix.,472,2457,0,997852,https://x.com/IndoPopBase/status/1974841709478793585,2929
2025-10-05 12:58:16+00:00,IndoPopBase,Marion Jola and Valerie Thomas in the studio together.,72,253,0,206350,https://x.com/IndoPopBase/status/1974821441347723347,325
2025-10-05 08:30:32+00:00,IndoPopBase,"‘Alamak’ by Rizky Febian and Adrian Khalif debuts at #3 on the Spotify Indonesia Top 50 chart with 969,868 streams.",75,266,0,110255,https://x.com/IndoPopBase/status/1974754064627015925,341
2025-10-05 08:16:05+00:00,IndoPopBase,"The Indonesian military has changed its camouflage to sage green.

Old vs New",855,2390,0,2458965,https://x.com/IndoPopBase/status/1974750424734617996,3245
2025-10-05 06:37:37+00:00,IndoPopBase,‘Dealova’ by Once Mekel turns 20.,30,165,0,40811,https://x.com/IndoPopBase/status/1974725648439783772,195
2025-10-04 06:18:59+00:00,IndoPopBase,The cast of ‘Rangga & Cinta’ stun in group photo for Cosmopolitan Indonesia.,68,718,0,1235583,https://x.com/IndoPopBase/status/1974358569475846538,786
2025-10-03 15:29:43+00:00,IndoPopBase,"Most streamed Indonesian female artists on Spotify in 2025 by week so far:

Week 1: Bernadya
Week 2: Bernadya
Week 3: Bernadya
Week 4: Bernadya
Week 5: Bernadya
Week 6: Bernadya
Week 7: Nadin Amizah
Week 8: Nadin Amizah
Week 9: Nadin Amizah
Week 10: Nadin Amizah
Week 11: NIKI",208,1423,0,1173328,https://x.com/IndoPopBase/status/1974134779827339622,1631
2025-10-03 15:25:35+00:00,IndoPopBase,"Hindia remains the most streamed Indonesian artist of 2025, topping Spotify Indonesia for 30 weeks.",45,349,0,66411,https://x.com/IndoPopBase/status/1974133737752608866,394
2025-10-03 11:28:19+00:00,IndoPopBase,The Indonesian flag at Monas was torn in two amid the military anniversary celebration.,1470,10673,0,3687206,https://x.com/IndoPopBase/status/1974074028173525354,12143
2025-10-03 09:00:56+00:00,IndoPopBase,"14 years ago today, Agnes Monica released ‘Rindu.’

Her rendition of Fryda Lucyana’s song became one of 2012’s biggest Indonesian hits and earned widespread acclaim, including an AMI Award for Karya Produksi Terbaik Terbaik (ROTD).",29,115,0,28664,https://x.com/IndoPopBase/status/1974036938777907429,144
2025-10-03 08:11:37+00:00,IndoPopBase,‘Bebas’ premiered 6 years ago today.,158,1464,0,414379,https://x.com/IndoPopBase/status/1974024525973971010,1622
2025-10-03 05:52:13+00:00,IndoPopBase,"no na’s Christy responds to a fan worried she might have a boyfriend someday:

“I already have a wife ”",146,2283,0,973248,https://x.com/IndoPopBase/status/1973989447558705319,2429
2025-10-03 05:22:10+00:00,IndoPopBase,"Sheila Dara to ELLE Indonesia on how time shapes us:

“Saya percaya bahwa cara pandang manusia, beserta setiap keputusan yang diambil, berakar pada pengalaman dan peristiwa di masa lalu, yang membentuk karakteristik serta cara pandangnya dalam mengambil langkah.”",19,122,0,29039,https://x.com/IndoPopBase/status/1973981884284866995,141
2025-10-03 05:20:25+00:00,IndoPopBase,Sheila Dara graces the cover of ELLE Indonesia.,9,40,0,18966,https://x.com/IndoPopBase/status/1973981442771427465,49
2025-10-03 05:05:55+00:00,IndoPopBase,"New music this week:

• Danilla — Ditinggal Begitu Saja 
• Tiara Andini — Dengar 
• Yovie Widianto, RAN — Cukup Sudah 
• Rizky Febian, Adrian Khalif — Alamak 
• Kunto Aji, IKLIM — Manusia Terakhir di Bumi 
• Sukatani, IKLIM — Kebangkitan 
• Denny Caknan, NDX",15,60,0,52505,https://x.com/IndoPopBase/status/1973977793601106156,75
2025-10-03 04:03:17+00:00,IndoPopBase,Andien says she will be performing the entire ‘Kinanti’ album at this year’s Synchronize Fest.,30,125,0,46480,https://x.com/IndoPopBase/status/1973962033537450112,155
2025-10-02 06:23:30+00:00,IndoPopBase,"The apartheid state of Israel has tried to reframe the GLOBAL Sumud Flotilla as the ‘Hamas-Sumud Flotilla.’

This is an attempt to discredit a global humanitarian movement.",55,3138,0,146452,https://x.com/IndoPopBase/status/1973634930807808374,3193
2025-10-02 05:44:06+00:00,IndoPopBase,"The Indonesian government has not yet publicly addressed the Israeli occupation forces’ abduction of the Global Sumud Flotilla in international waters.

This is considered a violation of international law.",396,9242,0,652451,https://x.com/IndoPopBase/status/1973625015645118820,9638
2025-10-01 16:27:18+00:00,IndoPopBase,,3,5,0,6976,https://x.com/IndoPopBase/status/1973424494103638368,8
2025-10-01 16:27:00+00:00,IndoPopBase,"no na teases new music in interview with JoySauce:

“We can say that something exciting is coming. Very new and exciting.”",31,196,0,34695,https://x.com/IndoPopBase/status/1973424417104601124,227
2025-10-01 15:54:08+00:00,IndoPopBase,,4,1,0,13732,https://x.com/IndoPopBase/status/1973416148256608483,5
2025-10-01 15:53:58+00:00,IndoPopBase,"Ahmad Dhani favors the Constitutional Court’s decision to reject the judicial review of education requirements for the president and state officials:

“Syarat Pemimpin menurut ISLAM itu adalah SHIDIQ-AMANAH-FATHONAH dan TABLIGH.. Gak pernah dengar syaratnya itu harus sarjana.”",261,486,0,93105,https://x.com/IndoPopBase/status/1973416105457885332,747
2025-10-01 15:27:22+00:00,IndoPopBase,"Prabowo Subianto wishes Gibran Rakabuming Raka a happy birthday:

“            ”",252,551,0,268314,https://x.com/IndoPopBase/status/1973409412233699540,803
2025-10-01 15:00:19+00:00,IndoPopBase,Aceh enters its third day of a major blackout.,453,7766,0,1540094,https://x.com/IndoPopBase/status/1973402605645865373,8219
2025-10-01 14:27:44+00:00,IndoPopBase,Danilla stuns for her new single ‘Ditinggal Begitu Saja.’,29,94,0,192541,https://x.com/IndoPopBase/status/1973394405307347424,123
2025-10-01 04:10:11+00:00,IndoPopBase,"60 years ago this month, a politicide led by Soeharto in the aftermath of G30S/PKI began. It took the lives of over 500,000 civilians, including PKI members, leftists, Gerwani women, trade unionists, teachers, activists, artists, Chinese Indonesians, and others. The Indonesian",175,5439,0,574712,https://x.com/IndoPopBase/status/1973238994369651130,5614
2025-09-30 19:12:54+00:00,IndoPopBase,"Twelve earthquakes have been felt in Sumenep within the span of less than two hours, BMKG reports.",64,1293,0,211912,https://x.com/IndoPopBase/status/1973103780737720564,1357
2025-09-30 16:07:08+00:00,IndoPopBase,"Several cities in Aceh have been hit by a major power outage for more than two days, affecting water distribution, internet, and banking services.",158,2463,0,420876,https://x.com/IndoPopBase/status/1973057030601445381,2621
2025-09-30 12:58:22+00:00,IndoPopBase,A Ki Hadjar Dewantara biopic is in the works.,33,150,0,77299,https://x.com/IndoPopBase/status/1973009524413133313,183
2025-09-30 12:19:47+00:00,IndoPopBase,"Ages when popstars had their breakout hits:

Agnez Mo, 19 — Tak Ada Logika
Andien, 25 — Saat Bahagia
Anggun, 23 — Snow on The Sahara 
Ayu Ting Ting, 19 — Alamat Palsu
Bernadya, 20 — Untungnya, Hidup Harus Tetap Berjalan
Bunga Citra Lestari, 25 — Kecewa
Cinta Laura, 15 — Oh Baby",70,233,0,91405,https://x.com/IndoPopBase/status/1972999818126704712,303
2025-09-30 11:41:11+00:00,IndoPopBase,The 2026 FIFA World Cup is set to be broadcast on TVRI.,71,412,0,125356,https://x.com/IndoPopBase/status/1972990103741153523,483
2025-09-30 10:16:06+00:00,IndoPopBase,"16 years ago today, a 7.6 magnitude earthquake struck Padang, marking one of Indonesia’s worst modern disasters.",169,1685,0,1229607,https://x.com/IndoPopBase/status/1972968688778392051,1854
2025-09-30 06:32:48+00:00,IndoPopBase,"The Global Sumud Flotilla humanitarian mission is expected to reach Gaza in less than two days.

Keep an eye: 
globalsumudflotilla.org/tracker/",37,1016,0,89931,https://x.com/IndoPopBase/status/1972912494349017434,1053
2025-09-30 04:45:16+00:00,IndoPopBase,"Happy birthday to the legendary Glenn Fredly, who would’ve turned 50 today.",27,145,0,46498,https://x.com/IndoPopBase/status/1972885431755899333,172
2025-09-30 04:21:40+00:00,IndoPopBase,Today is September the 30th.,219,6844,0,2682165,https://x.com/IndoPopBase/status/1972879494454427833,7063
2025-09-30 04:14:32+00:00,IndoPopBase,A series of old tweets from Pertamina commissioner and former head of PCO Hasan Nasbi has resurfaced online following his back-and-forth beef with Fedi Nuril.,172,2273,0,504168,https://x.com/IndoPopBase/status/1972877699422281921,2445
2025-09-29 14:47:41+00:00,IndoPopBase,"Anies Baswedan demands Benjamin Netanyahu be held internationally accountable for Israel’s genocide on Palestine:

“Ending Genocide, Enforcing Justice. The world cannot continue to pretend that reasonable solutions will be possible so long as Israel remains under the leadership",240,3996,0,1920772,https://x.com/IndoPopBase/status/1972674647780212790,4236
2025-09-29 14:38:29+00:00,IndoPopBase,Najwa Shihab will be interviewing Bill Gates in an upcoming episode of Mata Najwa.,56,326,0,61528,https://x.com/IndoPopBase/status/1972672333417431283,382
2025-09-29 06:47:33+00:00,IndoPopBase,‘SORE: Istri Dari Masa Depan’ ranks #10 among Letterboxd’s highest-rated films of 2025 so far.,48,632,0,123754,https://x.com/IndoPopBase/status/1972553818585080239,680
2025-09-29 06:06:39+00:00,IndoPopBase,"MBG poisoning cases across Indonesia from January to September, according to 
@CISDI_ID
:

West Java — 2.945
DI Yogyakarta — 905
Central Java — 468
Bengkulu — 456
Lampung — 307
East Nusa Tenggara — 305
Central Sulawesi — 277
South Sumatra — 271
East Java — 252
West Nusa Tenggara —",43,1197,0,81402,https://x.com/IndoPopBase/status/1972543528451600508,1240
2025-09-29 05:03:09+00:00,IndoPopBase,"13 years ago today, Joko Widodo and Basuki Tjahaja Purnama won the 2012 Jakarta gubernatorial election.",46,65,0,34681,https://x.com/IndoPopBase/status/1972527548207870169,111
2025-09-28 15:51:22+00:00,IndoPopBase,Happy 24th birthday to the talented Baila of no na.,42,418,0,101700,https://x.com/IndoPopBase/status/1972328287776190805,460
2025-09-28 15:45:11+00:00,IndoPopBase,no na defines elok in new photo.,131,1799,0,519421,https://x.com/IndoPopBase/status/1972326731836194857,1930
2025-09-28 15:19:59+00:00,IndoPopBase,Tulus drops four music videos from ‘Manusia’ in honor of his 14-year career.,152,1715,0,327171,https://x.com/IndoPopBase/status/1972320387968200734,1867
2025-09-28 15:19:18+00:00,IndoPopBase,"14 years ago today, Tulus released his self-titled debut album.",30,325,0,53303,https://x.com/IndoPopBase/status/1972320216572105060,355
2025-09-28 11:27:24+00:00,IndoPopBase,"Inul Daratista addresses money laundering allegations against her regarding her frequent appearances with high-profile figures:

“Percayalah, bidang saya cuma di dunia nyanyi dan bisnis. Tak sepeser pun ada uang partai dan money laundry mampir di saya kecuali honor show.”",48,84,0,64803,https://x.com/IndoPopBase/status/1972261857890361424,132
2025-09-28 09:51:55+00:00,IndoPopBase,"BGN chief Dadan Hindayana says the Free Nutritious Meal (MBG) program will start costing Rp1.2 TRILLION per day in 2026.

(
cnnindonesia.com/ekonomi/202509
…)",188,1335,0,440631,https://x.com/IndoPopBase/status/1972237830702366795,1523
2025-09-28 09:00:53+00:00,IndoPopBase,"CNN Indonesia’s reporter reportedly had their press pass revoked by the Istana over an MBG-related question.

(
tempo.co/politik/istana
…)",140,3404,0,363336,https://x.com/IndoPopBase/status/1972224987407974712,3544
2025-09-28 08:48:23+00:00,IndoPopBase,Rossa will release a cover of Sheila Majid’s ‘Sinaran’ for her new EP ‘Asmara Dansa.’ Out October 10th.,16,42,0,24720,https://x.com/IndoPopBase/status/1972221839821959459,58
2025-09-28 08:38:49+00:00,IndoPopBase,Rossa announces new EP ‘Asmara Dansa’ out October 10th.,30,31,0,25708,https://x.com/IndoPopBase/status/1972219432186651089,61
2025-09-27 09:08:50+00:00,IndoPopBase,"One year ago today, BAP. released ‘m. album tiga.’",19,240,0,44966,https://x.com/IndoPopBase/status/1971864599969644587,259
2025-09-27 08:36:26+00:00,IndoPopBase,"As the genocide in Gaza continues, Indonesian Pop Base has donated its Twitter/X revenue to the Palestine Children’s Relief Fund and we encourage those with the means to do the same.

: 
pcrf.net",107,1399,0,204839,https://x.com/IndoPopBase/status/1971856446615961852,1506
2025-09-27 06:26:36+00:00,IndoPopBase,"Benjamin Netanyahu addresses Prabowo’s UN speech on a two-state solution and insists on guarantees for Israel’s security:

“I took note, as I’m sure you did too, of the encouraging words spoken here by the President of Indonesia. This is the country with the world’s largest",1274,8615,0,6461958,https://x.com/IndoPopBase/status/1971823769816912112,9889
2025-09-27 03:51:57+00:00,IndoPopBase,"MBG poisoning in West Bandung has affected 1,333 people, Dinkes reports.",81,1883,0,188923,https://x.com/IndoPopBase/status/1971784853810237597,1964
2025-09-27 03:27:43+00:00,IndoPopBase,KATSEYE gets interviewed by TikTok user aulianuzl.,33,246,0,42311,https://x.com/IndoPopBase/status/1971778755069989215,279
2025-09-27 03:17:59+00:00,IndoPopBase,Najwa Shihab joins New York’s ‘March for Palestine’ protest.,266,10430,0,2716648,https://x.com/IndoPopBase/status/1971776303956468165,10696
2025-09-26 12:59:25+00:00,IndoPopBase,"Trailer for ‘Abadi Nan Jaya’ starring Mikha Tambayong, Eva Celia, Marthino Lio, Dimas Anggara, and more. Out October 23rd.",12,28,0,21796,https://x.com/IndoPopBase/status/1971560239137992934,40
2025-09-26 07:21:07+00:00,IndoPopBase,"Nutritionist DR. dr. Tan Shot Yen, M.Hum addresses MBG’s cut to the education budget in the 2026 APBN:

“Semakin banyak orang bodoh yang merasa bersyukur diberi jajanan minimarket.”",102,2468,0,159995,https://x.com/IndoPopBase/status/1971475105239994721,2570
2025-09-26 06:34:56+00:00,IndoPopBase,"Comedian and actor Sule when Dishub pulled him over for a missing KIR:

“Nggak apa-apa ini kalau mau tilang aja, saya mau buru-buru syuting Pak, cuman jangan dilama-lamain gitu Pak. Kita kerja lo, Bapak kerja kita kerja.”",30,70,0,101349,https://x.com/IndoPopBase/status/1971463479887528010,100
2025-09-26 05:01:35+00:00,IndoPopBase,The Ministry of Marine Affairs and Fisheries found 226 mining permits across 477 small islands. (via Mongabay),22,161,0,44416,https://x.com/IndoPopBase/status/1971439988681343240,183
2025-09-26 04:12:43+00:00,IndoPopBase,"New music this week:

• Rafi Sudirman — Hari Ini, Esok & Selamanya 
• White Chorus —  do you guys *still* wanna listen to some electro-pop music? (EP) 
• Anggis Devaki — Devaki 
• Hearts2Hearts — Pretty Please 
• Vierratale — Forevermore 
• Nosstress — Semakin",38,71,0,53192,https://x.com/IndoPopBase/status/1971427689253962192,109
2025-09-25 04:43:41+00:00,IndoPopBase,"Nutritionist DR. dr. Tan Shot Yen, M.Hum blasts Badan Gizi Nasional over the poor quality of MBG during DPR meeting.",461,17985,0,2087974,https://x.com/IndoPopBase/status/1971073094778511523,18446
2025-09-25 03:44:30+00:00,IndoPopBase,Nicholas Saputra does Gen-Z pop culture trivia with USS Her.,55,462,0,113117,https://x.com/IndoPopBase/status/1971058202776305782,517
2025-09-25 03:17:27+00:00,IndoPopBase,"Lucinta Luna calls out Traveloka Indonesia for allegedly keeping her refund after rescheduling her flight:

“Balikin refund gue.”",98,397,0,752337,https://x.com/IndoPopBase/status/1971051395974648212,495
2025-09-25 02:50:26+00:00,IndoPopBase,"12 years ago today, Morgan Oey left SM*SH.",40,153,0,65490,https://x.com/IndoPopBase/status/1971044597569913130,193
2025-09-25 02:33:44+00:00,IndoPopBase,Jakarta is set to host the 2026 Asia’s Got Talent.,69,177,0,79233,https://x.com/IndoPopBase/status/1971040394839486675,246
2025-09-25 01:55:47+00:00,IndoPopBase,‘Laskar Pelangi’ premiered 17 years ago today.,187,2758,0,1217496,https://x.com/IndoPopBase/status/1971030844346335392,2945
2025-09-24 11:38:51+00:00,IndoPopBase,"Around 500 students in West Bandung were hospitalized following an MBG mass poisoning.

(
cnnindonesia.com/nasional/20250
…)",143,2505,0,220866,https://x.com/IndoPopBase/status/1970815187885457679,2648
2025-09-24 11:29:32+00:00,IndoPopBase,"Afgan is working with Bilal Indrajaya, Petra Sihombing, and Kamga for his upcoming album ‘RETROSPEKTIF.’

It will be his first Indonesian-language album in seven years, which he says marks a return to his original genre.",46,117,0,45078,https://x.com/IndoPopBase/status/1970812843508498737,163
2025-09-24 11:15:52+00:00,IndoPopBase,Afgan announces his seventh studio album ‘RETROSPEKTIF.’ Coming in November.,10,22,0,18679,https://x.com/IndoPopBase/status/1970809406205075947,32
2025-09-24 09:43:00+00:00,IndoPopBase,"Tasya Farasya is suing Ahmad Assegaf for Rp100 perak over his failure to provide financial support as a husband, Insert reports.",1092,8462,0,11146800,https://x.com/IndoPopBase/status/1970786034289107197,9554
2025-09-24 09:20:00+00:00,IndoPopBase,‘Stand Up Comedy Indonesia’ premiered 14 years ago today.,54,272,0,76446,https://x.com/IndoPopBase/status/1970780246560628804,326
2025-09-24 08:34:39+00:00,IndoPopBase,Happy 33rd birthday to the talented Sheila Dara.,147,1082,0,454183,https://x.com/IndoPopBase/status/1970768832202694800,1229
2025-09-23 06:25:38+00:00,IndoPopBase,Happy 24th birthday to the talented Tiara Andini.,34,55,0,46511,https://x.com/IndoPopBase/status/1970373977597190426,89
2025-09-23 03:29:19+00:00,IndoPopBase,"8 years ago today, AGNEZ MO released ‘Long As I Get Paid.’",59,134,0,63345,https://x.com/IndoPopBase/status/1970329605824487932,193
2025-09-23 03:08:19+00:00,IndoPopBase,‘Malam Satu Suro’ premiered 37 years ago today.,94,297,0,91152,https://x.com/IndoPopBase/status/1970324322335236460,391
2025-09-23 02:29:24+00:00,IndoPopBase,"“We must guarantee statehood for Palestine, but Indonesia also declares that once Israel recognizes the independence and statehood of Palestine, Indonesia will immediately recognize the state of Israel. We will support all guarantees for the security of Israel.” 

— Prabowo",3664,27567,0,13903030,https://x.com/IndoPopBase/status/1970314525993034222,31231
2025-09-23 02:10:56+00:00,IndoPopBase,"Today marks the equinox, when the sun is exactly above the equator.",79,642,0,169255,https://x.com/IndoPopBase/status/1970309879584956899,721
2025-09-22 09:15:32+00:00,IndoPopBase,Yoshi Sudarso stuns for L'Officiel Philippines.,111,447,0,699389,https://x.com/IndoPopBase/status/1970054346806296808,558
2025-09-22 08:32:20+00:00,IndoPopBase,"The lawsuit over an unqualified diploma against ‘Sesuai Aplikasi’ star Gibran Rakabuming Raka has reportedly entered the mediation phase.

(
cnnindonesia.com/nasional/20250
…)",100,651,0,486835,https://x.com/IndoPopBase/status/1970043472234283120,751
2025-09-22 08:11:29+00:00,IndoPopBase,"Former President Joko Widodo has told his volunteer group, Projo, to endorse Prabowo-Gibran for two consecutive terms.

(
nasional.kompas.com/read/2025/09/2
…)",112,286,0,72606,https://x.com/IndoPopBase/status/1970038227265552766,398
2025-09-22 06:45:49+00:00,IndoPopBase,"Hearts2Hearts announces their first mini-album ‘FOCUS.’

Out October 20th.",31,270,0,51603,https://x.com/IndoPopBase/status/1970016667343442054,301
2025-09-22 06:32:41+00:00,IndoPopBase,Andien stuns for ‘Suarasmara.’,16,24,0,24895,https://x.com/IndoPopBase/status/1970013363985129894,40
2025-09-22 06:24:27+00:00,IndoPopBase,NIKI stuns at a boba shop.,63,295,0,90998,https://x.com/IndoPopBase/status/1970011291868881406,358
2025-09-22 06:20:26+00:00,IndoPopBase,"Agnez Mo when asked to get an iPhone 17:

“ga mauuuuu lol ”",51,93,0,386458,https://x.com/IndoPopBase/status/1970010278575354072,144
2025-09-21 05:37:53+00:00,IndoPopBase,Happy 33rd birthday to the talented Eva Celia.,21,54,0,35738,https://x.com/IndoPopBase/status/1969637185709359431,75
2025-09-21 05:21:08+00:00,IndoPopBase,"7 years ago today, .Feast released ‘Beberapa Orang Memaafkan.’",36,591,0,88033,https://x.com/IndoPopBase/status/1969632970924572738,627
2025-09-21 05:15:46+00:00,IndoPopBase,"7 years ago today, Yura Yunita released her sophomore album ‘Merakit.’",8,13,0,16645,https://x.com/IndoPopBase/status/1969631620476125480,21
2025-09-21 05:03:52+00:00,IndoPopBase,Seblak is currently trending in Thailand.,816,7455,0,3540774,https://x.com/IndoPopBase/status/1969628625139089670,8271
2025-09-20 04:09:17+00:00,IndoPopBase,"Korlantas Polri announces a temporary stop to sirens, rotators, and strobes in convoys following public backlash.

(
nasional.kompas.com/read/2025/09/1
…)",136,701,0,166794,https://x.com/IndoPopBase/status/1969252499526684858,837
2025-09-20 03:50:07+00:00,IndoPopBase,IKN is set as political capital in 2028.,45,100,0,42939,https://x.com/IndoPopBase/status/1969247674445517148,145
2025-09-20 03:45:09+00:00,IndoPopBase,The 2004 presidential election took place 21 years ago today.,22,53,0,28226,https://x.com/IndoPopBase/status/1969246428221382976,75
2025-09-20 03:09:01+00:00,IndoPopBase,"8 years ago today, .Feast released their debut album ‘Multiverses.’",102,1170,0,378775,https://x.com/IndoPopBase/status/1969237331241521409,1272
2025-09-19 13:03:50+00:00,IndoPopBase,"Alba, the world’s only known blue-eyed albino orangutan, hails from Central Kalimantan.",583,7431,0,7761890,https://x.com/IndoPopBase/status/1969024637276131734,8014
2025-09-19 12:46:29+00:00,IndoPopBase,"Energy Minister Bahlil Lahadalia says he’s urged Shell Indonesia to avoid mass layoffs:

“Saya tadi sudah minta ke mereka (manajemen Shell Indonesia) untuk tidak boleh ada gerakan tambahan (PHK). Kita ingin harus semuanya damai tapi juga kita harus mengerti bahwa mengolah negara",425,990,0,184241,https://x.com/IndoPopBase/status/1969020268766236902,1415
2025-09-19 12:01:13+00:00,IndoPopBase,17 national holidays and 8 collective leave days for 2026 have been unveiled.,189,3454,0,604608,https://x.com/IndoPopBase/status/1969008879640957347,3643
2025-09-19 03:52:03+00:00,IndoPopBase,"Around 250 students in Banggai, South Sulawesi, were hospitalized after reportedly being affected by mass poisoning from MBG.

(
detik.com/sulsel/berita/
…)",117,2056,0,161084,https://x.com/IndoPopBase/status/1968885776889823370,2173
2025-09-18 15:48:26+00:00,IndoPopBase,Soekarno’s eighth wife Yurike Sanger has died at the age of 80.,37,163,0,99529,https://x.com/IndoPopBase/status/1968703669433426257,200
2025-09-18 13:12:39+00:00,IndoPopBase,Duolingo tries Sambalado in new TikTok.,36,64,0,19423,https://x.com/IndoPopBase/status/1968664468285702523,100
2025-09-18 10:38:20+00:00,IndoPopBase,Indonesia is in talks to acquire Italian aircraft carrier Giuseppe Garibaldi.,27,24,0,22608,https://x.com/IndoPopBase/status/1968625630280323438,51
2025-09-18 10:07:29+00:00,IndoPopBase,"One of the three missing late-August protesters was reportedly found safe selling barongsai toys in Malang.

(
megapolitan.kompas.com/read/2025/09/1
…)",166,2036,0,662626,https://x.com/IndoPopBase/status/1968617866116436277,2202
2025-09-18 09:19:35+00:00,IndoPopBase,"Dito Ariotedjo jokingly asked Roy Suryo during his farewell speech as Minister of Youth and Sports:

“Ijazahnya Pak Erick [Thohir] aman, Pak?”",186,705,0,754680,https://x.com/IndoPopBase/status/1968605812701434246,891
2025-09-18 05:40:20+00:00,IndoPopBase,"Our ‘Deep Cuts’ playlist has been updated, featuring NIKI, White Chorus, Danilla, Petra Sihombing, The Dare, no na, and many more.

: 
open.spotify.com/playlist/3KlXF
…",24,44,0,75188,https://x.com/IndoPopBase/status/1968550637140082770,68
2025-09-18 05:08:27+00:00,IndoPopBase,"BPS reports that 63 of the DPR RI members are high school graduates while 211 left their education unreported.

(
detik.com/edu/detikpedia
…)",25,191,0,28300,https://x.com/IndoPopBase/status/1968542615550513478,216
2025-09-18 03:50:26+00:00,IndoPopBase,"9 years ago today, Young Lex & Awkarin released ‘BAD.’",273,885,0,399145,https://x.com/IndoPopBase/status/1968522980277010667,1158
2025-09-18 03:41:29+00:00,IndoPopBase,"19 years ago today, Ayu Ting Ting released her debut album ‘Alamat Palsu.’",78,171,0,49411,https://x.com/IndoPopBase/status/1968520728233570800,249
2025-09-17 16:09:03+00:00,IndoPopBase,Carmen of Hearts2Hearts puts the C in chic in new photos.,152,3341,0,648743,https://x.com/IndoPopBase/status/1968346471750905991,3493
2025-09-17 15:00:50+00:00,IndoPopBase,The Constitutional Court has rejected a judicial review regarding the bachelor’s degree requirement for joining Polri.,94,268,0,76247,https://x.com/IndoPopBase/status/1968329305550954905,362
2025-09-17 05:10:37+00:00,IndoPopBase,"Human Rights Minister Natalius Pigai reacts to reports of people going missing during the late-August protests:

“Terlalu dini untuk dikatakan hilang. Bisa saja, orang karena panik sembunyi. Jakarta ini adalah kota metropolis. Setiap sudut itu ada CCTV.” (via Kompas)",340,1756,0,192236,https://x.com/IndoPopBase/status/1968180771035943138,2096
2025-09-17 03:26:43+00:00,IndoPopBase,"Thousands of ojol drivers are set to take to the streets of Jakarta today, demanding clearer rules for ride-hailing apps.",54,2704,0,347795,https://x.com/IndoPopBase/status/1968154625602883754,2758
2025-09-17 03:10:00+00:00,IndoPopBase,‘50 Tahun’ by Warna is featured on ‘Ratu Ratu Queens: The Series.’,26,75,0,35859,https://x.com/IndoPopBase/status/1968150417008996616,101
2025-09-16 07:59:46+00:00,IndoPopBase,"KPU has officially revoked Decision No. 731/2025, which made presidential and VP candidate requirement docs confidential.

(
cnnindonesia.com/nasional/20250
…)",97,983,0,532224,https://x.com/IndoPopBase/status/1967860951321080218,1080
2025-09-16 06:55:31+00:00,IndoPopBase,"Happy birthday to the legendary Chrisye, who would’ve turned 76 today.",40,179,0,35573,https://x.com/IndoPopBase/status/1967844781230530794,219
2025-09-16 06:46:16+00:00,IndoPopBase,Happy 44th birthday to the powerhouse Ariel Noah.,56,193,0,57194,https://x.com/IndoPopBase/status/1967842452821381459,249
2025-09-16 06:31:39+00:00,IndoPopBase,Happy 48th birthday to the iconic Najwa Shihab.,59,136,0,46264,https://x.com/IndoPopBase/status/1967838776459399649,195
2025-09-16 05:44:40+00:00,IndoPopBase,Dato’ Sri Rossa and Dato’ Sri Siti Nurhaliza stun at the #AIM24.,48,115,0,42710,https://x.com/IndoPopBase/status/1967826950808015020,163
2025-09-16 05:20:28+00:00,IndoPopBase,Novia Bachmid sings ‘We Found Love’ by Rihanna in new TikTok.,111,301,0,237249,https://x.com/IndoPopBase/status/1967820861026803887,412
2025-09-16 04:38:59+00:00,IndoPopBase,"13 years ago today, NOAH dropped their first post-rebrand album, ‘Seperti Seharusnya.’",29,113,0,26498,https://x.com/IndoPopBase/status/1967810422570127503,142
2025-09-15 12:40:28+00:00,IndoPopBase,"Deputy Minister of Communication and Digital Affairs Nezar Patria says the one-account-one-person social media policy is under review:

“Kita lagi review itu, karena itu terkait juga dengan program Satu Data Indonesia. Itu salah satu solusi (mengurangi hoax) dan kita lagi kaji",140,403,0,97834,https://x.com/IndoPopBase/status/1967569203726373335,543
2025-09-15 00:33:05+00:00,IndoPopBase,Tasya Farasya announces she’s taking a break from social media.,327,902,0,3179827,https://x.com/IndoPopBase/status/1967386151683252297,1229
2025-09-14 10:19:45+00:00,IndoPopBase,Rossa extends her record as the most-awarded Indonesian artist at Malaysia’s AIM Awards with 4 wins.,40,42,0,36646,https://x.com/IndoPopBase/status/1967171402764857365,82
2025-09-14 08:20:15+00:00,IndoPopBase,‘lowkey’ by NIKI has surpassed 600 million streams on Spotify.,48,179,0,70792,https://x.com/IndoPopBase/status/1967141329005408700,227
2025-09-14 07:54:58+00:00,IndoPopBase,‘fábula’ by Mahalini re-enters this week's Top 10 of the Spotify Indonesia weekly albums chart at #10.,21,14,0,23664,https://x.com/IndoPopBase/status/1967134968460853368,35
2025-09-14 07:40:08+00:00,IndoPopBase,"Most streamed Indonesian artists on Spotify this week:

#1. Hindia 
#2. .Feast
#3. Sheila On 7
#4. Nadin Amizah
#5. Silet Open Up
#6. For Revenge
#7. Tulus 
#8. Tenxi 
#9. Pamungkas
#10. Juicy Luicy",224,1028,0,425612,https://x.com/IndoPopBase/status/1967131233319838102,1252
2025-09-14 07:39:51+00:00,IndoPopBase,"The Top 10 of this week’s Spotify Indonesia:

#1. Silet Open Up, Jacson Seran, Juan Reza, & Diva Aurel — TABOLA BALE
#2. Pamungkas — Monolog
#3. .Feast — Tarot
#4. Nadhif Basalamah — bergema sampai selamanya 
#5. Raim Laode — Lesung Pipi
#6. Fourtwnty, Charita Utami — Mangu
#7.",26,70,0,49224,https://x.com/IndoPopBase/status/1967131161458888835,96
2025-09-14 07:30:27+00:00,IndoPopBase,Lucinta Luna stuns on Car Free Day.,589,1972,0,1382275,https://x.com/IndoPopBase/status/1967128795904938469,2561
2025-09-14 03:41:30+00:00,IndoPopBase,"7 years ago today, Kunto Aji released ‘Mantra Mantra.’",179,2237,0,1194991,https://x.com/IndoPopBase/status/1967071182097899569,2416
2025-09-14 03:20:42+00:00,IndoPopBase,"15 years ago today, SM*SH released ‘I Heart You.’",97,462,0,90760,https://x.com/IndoPopBase/status/1967065944884387866,559
2025-09-13 12:33:09+00:00,IndoPopBase,"Susi Pudjiastuti slams the continuation of nickel mining on Gag Island, Raja Ampat, after Bahlil Lahadalia greenlights operations:

“Bila keindahan dan keutuhan wilayah laut Raja Ampat rusak tercemar. Kita menyesalinya dan anak cucu kita tidak akan memaafkan kita. Mohon hentikan",50,551,0,57170,https://x.com/IndoPopBase/status/1966842585709986255,601
2025-09-13 11:08:35+00:00,IndoPopBase,A photo of 17-year-old Titi DJ and 21-year-old Michelle Yeoh from Miss World 1983 has surfaced online.,123,2368,0,755599,https://x.com/IndoPopBase/status/1966821306449776956,2491
2025-09-13 08:29:52+00:00,IndoPopBase,Happy 24th birthday to the talented Esther of no na.,53,634,0,104718,https://x.com/IndoPopBase/status/1966781362834112966,687
2025-09-13 07:25:08+00:00,IndoPopBase,"Satelit Nusantara Lima has been launched into space.

With a capacity of 160 Gbps, SNL will orbit at the 113° East golden spot, providing coverage across Southeast Asia.",26,96,0,28924,https://x.com/IndoPopBase/status/1966765071604085107,122
2025-09-12 05:42:55+00:00,IndoPopBase,"Around 15,000 foreigners in Bali are now enrolled in the National Health Insurance (JKN) program, according to BPJS.",338,1444,0,575577,https://x.com/IndoPopBase/status/1966376961271599607,1782
2025-09-11 16:53:15+00:00,IndoPopBase,"Fariz RM has been sentenced to 10 months in prison on drug abuse charges, with a subsidiary penalty of IDR 800 million or two months in jail.",55,108,0,70950,https://x.com/IndoPopBase/status/1966183268090523954,163
2025-09-11 14:08:37+00:00,IndoPopBase,27th September is now officially recognized as National Comedy Day in honor of Bing Slamet.,47,201,0,72996,https://x.com/IndoPopBase/status/1966141834939478294,248
2025-09-11 13:02:01+00:00,IndoPopBase,The Ministry of Defense has filed a report against TEMPO magazine to the Press Council over allegations of martial law plans during the Jakarta protests.,510,4728,0,782564,https://x.com/IndoPopBase/status/1966125073456312594,5238
2025-09-11 07:36:45+00:00,IndoPopBase,"no na has released the music video for ‘sad face :(’

Watch: 
youtu.be/A7W4TQsToa0?si
…",26,390,0,83065,https://x.com/IndoPopBase/status/1966043220481368206,416
2025-09-11 04:28:29+00:00,IndoPopBase,"426 years ago today, Keumalahayati killed Cornelis de Houtman in a 1v1 at the Battle of Aceh.",424,12371,0,3799334,https://x.com/IndoPopBase/status/1965995840771862868,12795
2025-09-11 03:18:13+00:00,IndoPopBase,2026 is 111 days away.,196,2323,0,385882,https://x.com/IndoPopBase/status/1965978156583759986,2519
2025-09-10 17:44:31+00:00,IndoPopBase,BNPB has declared a one-week disaster emergency in Bali following major floods.,12,155,0,39949,https://x.com/IndoPopBase/status/1965833781522346341,167
2025-09-10 17:26:48+00:00,IndoPopBase,"Comedian and actor Sule has been hospitalized due to typhoid fever and anemia, VIVA reports.",124,313,0,1251507,https://x.com/IndoPopBase/status/1965829321291083863,437
2025-09-10 14:44:50+00:00,IndoPopBase,Harum Manis has been dropped from LaMunai Records following Sulthon Kamil’s underage grooming scandal.,334,2608,0,3349323,https://x.com/IndoPopBase/status/1965788564320555346,2942
2025-09-10 13:16:53+00:00,IndoPopBase,Today is World Suicide Prevention Day.,622,18679,0,2889315,https://x.com/IndoPopBase/status/1965766430177329506,19301
2025-09-10 13:05:53+00:00,IndoPopBase,Prabowo’s niece Rahayu Saraswati has stepped down as a member of the DPR RI.,557,1926,0,1746844,https://x.com/IndoPopBase/status/1965763662200934863,2483
2025-09-09 06:30:19+00:00,IndoPopBase,Sri Mulyani breaks down in tears as the crowd performs ‘Bahasa Kalbu’ by Titi DJ.,1011,4477,0,10459623,https://x.com/IndoPopBase/status/1965301726548033855,5488
2025-09-09 06:04:28+00:00,IndoPopBase,"no na will release the ‘sad face :(’ music video this Wednesday, September 10th.",9,21,0,14933,https://x.com/IndoPopBase/status/1965295220490469620,30
2025-09-09 05:49:06+00:00,IndoPopBase,"“Saya pamit undur diri pagi hari ini, dan mohon mulai saat ini untuk kami dihormati ruang privacy kami atau ruang pribadi saya sebagai warga negara biasa.”

— Sri Mulyani during her farewell speech as Finance Minister.",182,953,0,258396,https://x.com/IndoPopBase/status/1965291354155827388,1135
2025-09-09 04:41:15+00:00,IndoPopBase,Indomie was launched 55 years ago today.,140,1773,0,3242528,https://x.com/IndoPopBase/status/1965274277688869246,1913
2025-09-09 04:16:04+00:00,IndoPopBase,Former Minister of Cooperatives Budi Arie Setiadi has unfollowed Prabowo Subianto on Instagram following the cabinet reshuffle.,2627,8755,0,3577387,https://x.com/IndoPopBase/status/1965267941785829723,11382
2025-09-08 13:37:36+00:00,IndoPopBase,:,5,16,0,72689,https://x.com/IndoPopBase/status/1965046865344577705,21
2025-09-08 13:37:35+00:00,IndoPopBase,Purbaya Yudhi says he learned he’d be Finance Minister just 3.5 hours before the inauguration.,413,2513,0,828111,https://x.com/IndoPopBase/status/1965046861838102998,2926
2025-09-08 13:19:19+00:00,IndoPopBase,"Finance Minister Purbaya Yudhi Sadewa addresses the 17+8 People’s Demands:

“Itu kan suara sebagian kecil rakyat kita. Kenapa mungkin sebagian ngerasa keganggu, hidupnya masih kurang. Once saya ciptakan pertumbuhan ekonomi 6 persen, 7 persen itu akan hilang dengan otomatis.",911,6543,0,1791622,https://x.com/IndoPopBase/status/1965042266029924402,7454
2025-09-08 10:23:02+00:00,IndoPopBase,Sri Mulyani Indrawati has officially ended her 13-year run as Finance Minister.,273,1289,0,2065758,https://x.com/IndoPopBase/status/1964997901605834885,1562
2025-09-08 09:47:03+00:00,IndoPopBase,"Sri Mulyani reportedly asked to step down as Finance Minister, according to Liputan6.",150,726,0,7325566,https://x.com/IndoPopBase/status/1964988848422916185,876
2025-09-08 09:23:28+00:00,IndoPopBase,Purbaya Yudhi Sadewa has replaced Sri Mulyani as Finance Minister.,374,2522,0,5815708,https://x.com/IndoPopBase/status/1964982913679892510,2896
2025-09-07 06:06:17+00:00,IndoPopBase,The Blood Moon eclipse begins tonight at 23.27 WIB.,435,10580,0,2292239,https://x.com/IndoPopBase/status/1964570900088668630,11015
2025-09-07 05:03:13+00:00,IndoPopBase,ST12 debuted 20 years ago today.,36,58,0,54068,https://x.com/IndoPopBase/status/1964555029932888564,94
2025-09-07 04:33:38+00:00,IndoPopBase,"20 years ago today, Ungu released ‘Demi Waktu.’",81,254,0,99597,https://x.com/IndoPopBase/status/1964547583977934979,335
2025-09-06 10:55:32+00:00,IndoPopBase,"Slank calls out Freeport, Listyo Sigit, Puan Maharani, and Prabowo Subianto during their performance at Pestapora.",583,1326,0,1812385,https://x.com/IndoPopBase/status/1964281304695894043,1909
2025-09-06 04:23:43+00:00,IndoPopBase,"Performers who have pulled out of this year’s Pestapora:

• Bilal Indrajaya
• Centra
• Cloudburst
• Durga
• .Feast
• Filler
• Hindia
• Keep It Real
• Kelelawar Malam
• Kenya
• Leipzig
• Morad
• Navicula
• Negatifa
• Ornament
• Pelteras
• Petra Sihombing
• Poris",272,2168,0,607758,https://x.com/IndoPopBase/status/1964182703663911179,2440
2025-09-05 17:56:11+00:00,IndoPopBase,Pestapora issued a statement following backlash over including PT Freeport as one of its sponsors.,141,925,0,921233,https://x.com/IndoPopBase/status/1964024776978288910,1066
2025-09-05 17:30:31+00:00,IndoPopBase,"According to a fan DM, Sukatani confirms Freeport was kicked out of Pestapora following performers’ demands.",110,1019,0,3216854,https://x.com/IndoPopBase/status/1964018319100711314,1129
2025-09-05 16:56:08+00:00,IndoPopBase,Pestapora has faced backlash for including Freeport as one of its sponsors.,736,2906,0,1754284,https://x.com/IndoPopBase/status/1964009665114886314,3642
2025-09-05 15:56:49+00:00,IndoPopBase,"Say their names. Remember their names.

Affan Kurniawan
Andika Lutfi Falah
Septinus Sesa
Saiful Akbar
Muhammad Akbar Basri
Sarinawati
Rusmadiansyah
Rheza Sendy Pratama
Sumari
Iko Juliant Junior",19,10925,0,362534,https://x.com/IndoPopBase/status/1963994738408690110,10944
2025-09-05 14:03:19+00:00,IndoPopBase,DPR members’ monthly net pay officially drops to Rp65.5M as housing allowance ends.,567,4034,0,1713292,https://x.com/IndoPopBase/status/1963966176729678066,4601
2025-09-05 13:47:38+00:00,IndoPopBase,"Nadin Amizah urges fans to speak up amid the national crisis:

“Jangan lupa menyuarakan apa yang bisa kamu suarakan. Apapun yang bisa kamu perjuangkan, perjuangkan. Hakmu sedang dirampas oleh orang-orang yang sangat rakus di sana.”",48,1761,0,88501,https://x.com/IndoPopBase/status/1963962226659700964,1809
2025-09-05 13:01:40+00:00,IndoPopBase,Nadiem Makarim’s mugshot has been released.,434,1983,0,2815049,https://x.com/IndoPopBase/status/1963950661294494070,2417
2025-09-04 16:36:59+00:00,IndoPopBase,Tonight is Jumat Kliwon.,61,252,0,63001,https://x.com/IndoPopBase/status/1963642458740592884,313
2025-09-04 09:27:44+00:00,IndoPopBase,Kejaksaan Agung has ruled former Education Minister Nadiem Makarim a suspect in Chromebook corruption case.,215,1183,0,443586,https://x.com/IndoPopBase/status/1963534435040858446,1398
2025-09-04 08:54:48+00:00,IndoPopBase,The 17+8 People’s Demands have officially been submitted to Parliament.,738,27619,0,5145039,https://x.com/IndoPopBase/status/1963526147398144323,28357
2025-09-04 07:09:17+00:00,IndoPopBase,Japan’s national newspaper The Yomiuri Shimbun cropped Prabowo Subianto out of its front page photo.,1073,13130,0,2884887,https://x.com/IndoPopBase/status/1963499591694733673,14203
2025-09-04 05:59:20+00:00,IndoPopBase,"DPR to hold meeting with factions today following nationwide protests over 17+8 demands.

(
cnnindonesia.com/nasional/20250
…)",237,6749,0,528515,https://x.com/IndoPopBase/status/1963481988507340806,6986
2025-09-04 03:50:18+00:00,IndoPopBase,First look at Lutesha for ‘Lavender Marriage.’,36,78,0,44532,https://x.com/IndoPopBase/status/1963449515358425327,114
2025-09-04 03:37:32+00:00,IndoPopBase,Happy 25th birthday to the talented Christy of no na.,89,665,0,128135,https://x.com/IndoPopBase/status/1963446302114812118,754
2025-09-04 02:40:18+00:00,IndoPopBase,The 17 Tuntutan Rakyat deadline ends tomorrow.,171,13860,0,1039052,https://x.com/IndoPopBase/status/1963431901479534728,14031
