date,username,content,reply_count,retweet_count,like_count,view_count,tweet_url,reply_to,total_engagement
2025-10-10 08:40:37+00:00,Twittysweetie_,"Kalau kayak Gini kek orang bener si Ariel, bukan kek Asih yang ngrebut suami majikan

Duhh....yang ngide Ariel jadi pengasuh siapa sih?!",1,0,0,61,https://x.com/Twittysweetie_/status/1976568541920026946,https://x.com/IndoPopBase/status/1976564048780234777,1
2025-10-10 08:23:53+00:00,scardolescent,need her,0,0,0,103,https://x.com/scardolescent/status/1976564330629038565,https://x.com/IndoPopBase/status/1976564048780234777,0
2025-10-10 08:30:20+00:00,OynRetriever,MOTHER is serving........,0,0,0,76,https://x.com/OynRetriever/status/1976565953820492134,https://x.com/IndoPopBase/status/1976564048780234777,0
2025-10-10 08:30:43+00:00,sugar_6378,waduhhh ariellll,0,0,0,80,https://x.com/sugar_6378/status/1976566049148752373,https://x.com/IndoPopBase/status/1976564048780234777,0
2025-10-10 08:44:16+00:00,ursteulyNaveen,Big move for Ariel Tatum  she’s everywhere lately ,0,0,0,27,https://x.com/ursteulyNaveen/status/1976569458417185078,https://x.com/IndoPopBase/status/1976564048780234777,0
2025-10-10 08:23:24+00:00,calmdownhunny,ended garuda indonesia,0,0,0,92,https://x.com/calmdownhunny/status/1976564208516071587,https://x.com/IndoPopBase/status/1976564048780234777,0
2025-10-09 11:04:39+00:00,xNortromx,The artist:                      The Art:,238,3241,0,838158,https://x.com/xNortromx/status/1976242398083588583,https://x.com/IndoPopBase/status/1976564048780234777,3479
2025-10-10 00:14:53+00:00,ngalamfess,#tipudayajanda,155,299,0,182860,https://x.com/ngalamfess/status/1976441270118838524,https://x.com/IndoPopBase/status/1976564048780234777,454
2025-10-09 05:36:59+00:00,mhwnk_,the outfit:                      the scent:,164,1520,0,320177,https://x.com/mhwnk_/status/1976159937651933484,https://x.com/IndoPopBase/status/1976564048780234777,1684
2025-10-10 05:16:13+00:00,indahkus,Why drugs bro we have indomie,122,977,0,235866,https://x.com/indahkus/status/1976517099188294132,https://x.com/IndoPopBase/status/1976564048780234777,1099
2025-10-10 08:29:29+00:00,PROSPERDEGREAT,"Finally, a reason to actually check my playlist next Friday. You think this one’s gonna top her last banger or nah?",0,0,0,12,https://x.com/PROSPERDEGREAT/status/1976565737818038533,https://x.com/IndoPopBase/status/1976553753785532724,0
2025-10-10 08:28:43+00:00,PROSPERDEGREAT,Sheryl dropping ‘Lepas Kendali’ next Friday? Bet this one’s going to be stuck in my head all weekend. Who else already has it on repeat in their head?,0,0,0,12,https://x.com/PROSPERDEGREAT/status/1976565546867990564,https://x.com/IndoPopBase/status/1976553753785532724,0
2025-10-10 07:48:26+00:00,Seung_ha_,"Sheryl Sheinafia has announced her new single ‘Lepas Kendali’, set for release next Friday. 

Are you excited for her comeback?",0,0,0,35,https://x.com/Seung_ha_/status/1976555407809368101,https://x.com/IndoPopBase/status/1976553753785532724,0
2025-10-09 13:13:25+00:00,IndoPopBase,Isyana Sarasvati debuts a wolfcut.,71,402,0,60782,https://x.com/IndoPopBase/status/1976274804446810358,https://x.com/IndoPopBase/status/1976553753785532724,473
2025-10-10 08:30:12+00:00,PROSPERDEGREAT,"Afgan really knows how to make you feel the vibes. Yuki Kato is stealing the spotlight, too. Who wrote this casting?",1,0,0,37,https://x.com/PROSPERDEGREAT/status/1976565918454137091,https://x.com/IndoPopBase/status/1976551164960440600,1
2025-10-10 07:43:04+00:00,shakesapear,Yuki Kato OMFG??? ,0,0,0,117,https://x.com/shakesapear/status/1976554057105133683,https://x.com/IndoPopBase/status/1976551164960440600,0
2025-10-10 07:51:16+00:00,CitaStarstories,keren Afgan & Yuki,0,0,0,106,https://x.com/CitaStarstories/status/1976556122250305934,https://x.com/IndoPopBase/status/1976551164960440600,0
2025-10-10 07:32:40+00:00,Seung_ha_,"Afgan just dropped the official music video for ‘Kacamata’, featuring Yuki Kato now streaming on YouTube! 
Have you watched it yet? 
@grok",1,0,0,152,https://x.com/Seung_ha_/status/1976551438873670070,https://x.com/IndoPopBase/status/1976551164960440600,1
2025-10-10 08:29:02+00:00,eunolaeunoia,pantesan doi pake kacamata lagi,0,0,0,27,https://x.com/eunolaeunoia/status/1976565625255493832,https://x.com/IndoPopBase/status/1976551164960440600,0
2025-10-09 09:27:44+00:00,QUEERAUSAHAAN,ammar zoni is the best anti-drug ad cause WTF HAPPENED like oh my god…..,105,729,0,450983,https://x.com/QUEERAUSAHAAN/status/1976218010957512842,https://x.com/IndoPopBase/status/1976551164960440600,834
2025-10-09 17:10:30+00:00,so1air,,177,3226,0,798502,https://x.com/so1air/status/1976334468966486062,https://x.com/IndoPopBase/status/1976551164960440600,3403
2025-10-09 06:42:03+00:00,Keangae_Mk2,,235,53408,0,6814676,https://x.com/Keangae_Mk2/status/1976176315322728818,https://x.com/IndoPopBase/status/1976551164960440600,53643
2025-10-09 14:34:33+00:00,findormeme,bunch of elementary school kids revealing their exam passing status while slipping through my fingers is playing on the background meryl streep tidak lulus anak sd nangis dramatic hasil ujian nangis,352,2044,0,1300834,https://x.com/findormeme/status/1976295222960427487,https://x.com/IndoPopBase/status/1976551164960440600,2396
2025-10-10 06:34:24+00:00,punkdidikan,Party In Bali will be song of the year,1,0,0,191,https://x.com/punkdidikan/status/1976536775515672791,https://x.com/IndoPopBase/status/1976536268361380248,1
2025-10-10 07:26:22+00:00,VornoxBlayze,"they seriously need to air this on TV again  ever since it went off air, the quality’s been downhill — like what happened to the stage, lighting, and sound?? Bring back the real award show era",0,0,0,102,https://x.com/VornoxBlayze/status/1976549855054184612,https://x.com/IndoPopBase/status/1976536268361380248,0
2025-10-10 08:49:41+00:00,dhityoz,Same as usual,0,0,0,4,https://x.com/dhityoz/status/1976570820316340725,https://x.com/IndoPopBase/status/1976536268361380248,0
2025-10-10 07:14:47+00:00,seethekey_,"Perunggu, Barasuara, Tenxi",0,0,0,96,https://x.com/seethekey_/status/1976546938863616475,https://x.com/IndoPopBase/status/1976536268361380248,0
2025-10-10 06:42:55+00:00,jaehyunreceipt,tenxii sweep,0,0,0,125,https://x.com/jaehyunreceipt/status/1976538919043993617,https://x.com/IndoPopBase/status/1976536268361380248,0
2025-10-10 07:01:21+00:00,Seung_ha_,"Which artists or albums do you think will lead the 23rd #AMIAwards nominations this year? 
@grok",1,0,0,112,https://x.com/Seung_ha_/status/1976543560720908650,https://x.com/IndoPopBase/status/1976536268361380248,1
2025-10-10 07:55:03+00:00,JorahMo,Selalu ada di nadimu,0,0,0,50,https://x.com/JorahMo/status/1976557073380016439,https://x.com/IndoPopBase/status/1976536268361380248,0
2025-10-10 06:46:00+00:00,ztrevahiaks,Barasuara dan Perunggu,0,0,0,114,https://x.com/ztrevahiaks/status/1976539696600899658,https://x.com/IndoPopBase/status/1976536268361380248,0
2025-10-09 14:34:47+00:00,favsalma,"Salma membuka jalan rezeki buat banyak orang yaa termasuk fansnyaaa masyaAllahh, semoga kamu sehat² ya sall rezekimu juga mengalir derass Aamiin",1,50,0,19085,https://x.com/favsalma/status/1976295280925659484,https://x.com/IndoPopBase/status/1976536268361380248,51
2025-10-09 09:21:27+00:00,Rames___,Nah kl gini kn mantul Salma smoga konsisten. Krn psti ada yg ga follow salmine & ada yg cm follow igmu / medsosmu aja Silmi Silsibil. Kl dirimu repost event yg ada hub denganmu kemungkinan jangkauan informasiny bs lbh meluas lagi ,1,6,0,3871,https://x.com/Rames___/status/1976216428350144821,https://x.com/IndoPopBase/status/1976536268361380248,7
2025-10-09 15:17:12+00:00,Crybby23,"Kok bsa sma dgn apa yg di alami saat ini ya  sal kalo dlu aku gk ngikutin kamu mungkin sekrang aku gk hoby ngedit, berkat itu juga hoby itu skrng di byr sal   makasih bnyak ya sal,nnti deh aku traktir bakso ",2,2,0,1781,https://x.com/Crybby23/status/1976305956721246215,https://x.com/IndoPopBase/status/1976536268361380248,4
2025-10-09 23:41:05+00:00,fyhslm,,0,0,0,1264,https://x.com/fyhslm/status/1976432762665250889,https://x.com/IndoPopBase/status/1976536268361380248,0
2025-10-10 07:36:50+00:00,DatoSriRossa,"Congratulations Diva 
@mynameisrossa",0,0,0,15,https://x.com/DatoSriRossa/status/1976552490461204731,https://x.com/IndoPopBase/status/1976525653005779369,0
2025-10-10 05:54:18+00:00,Seung_ha_,What’s your favorite track from Rossa’s new EP ‘Asmara Dansa’? ,0,0,0,53,https://x.com/Seung_ha_/status/1976526687149097419,https://x.com/IndoPopBase/status/1976525653005779369,0
2025-10-09 13:13:25+00:00,IndoPopBase,Isyana Sarasvati debuts a wolfcut.,71,402,0,60804,https://x.com/IndoPopBase/status/1976274804446810358,https://x.com/IndoPopBase/status/1976525653005779369,473
2025-10-09 07:43:02+00:00,·,"She'll be in jail for only 2 years, and after that she'll buzz around social media again and join election in 2029 as parliament.

We been knew baby...",3,66,0,25556,https://x.com/asibhoney/status/1976191661949714838,https://x.com/IndoPopBase/status/1976188365889470543,69
2025-10-09 07:46:55+00:00,Twittysweetie_,Kok mukanya jadi mirip Ariel Tatum sih,4,0,0,25632,https://x.com/Twittysweetie_/status/1976192639260356664,https://x.com/IndoPopBase/status/1976188365889470543,4
2025-10-09 07:44:48+00:00,urbackburner21,tired of this untalented bitch,2,31,0,11666,https://x.com/urbackburner21/status/1976192104801108399,https://x.com/IndoPopBase/status/1976188365889470543,33
2025-10-09 10:09:35+00:00,karufakembala,"gais gen ask, kalo contoh didakwa 11 tahun penjara dan bayar 2 miliar, itu pilih salah satu apa dua duanya wajib ? tolong jangan salty ya",3,0,0,17584,https://x.com/karufakembala/status/1976228542053765504,https://x.com/IndoPopBase/status/1976188365889470543,3
2025-10-09 07:33:14+00:00,SaddamWeb3,yakin nikmir divonis bebas.,0,0,0,5403,https://x.com/SaddamWeb3/status/1976189193668919503,https://x.com/IndoPopBase/status/1976188365889470543,0
2025-10-09 21:43:53+00:00,B4n6_H4n5,"Nah, kena batunya kan....",0,0,0,1058,https://x.com/B4n6_H4n5/status/1976403267572859021,https://x.com/IndoPopBase/status/1976188365889470543,0
2025-10-09 07:31:16+00:00,ursteulyNaveen,Things just went from drama to downright serious real quick ,0,0,0,7627,https://x.com/ursteulyNaveen/status/1976188700007493874,https://x.com/IndoPopBase/status/1976188365889470543,0
2025-10-09 07:57:38+00:00,ubiqutovus,ini tuh dia kasus apa bjir,2,0,0,5799,https://x.com/ubiqutovus/status/1976195334297747651,https://x.com/IndoPopBase/status/1976188365889470543,2
2025-10-09 10:28:53+00:00,yayaaa10_,"dia kok gak kasian ya sama anak2 nya masih pada kecil tapi dia terus2an nyari musuh berujung keluar masuk penjara, semua anaknya punya memori ditinggal ibunya masik penjara pas kecil dah mau kapan berentinya sih",1,1,0,10409,https://x.com/yayaaa10_/status/1976233399942848936,https://x.com/IndoPopBase/status/1976188365889470543,2
2025-10-09 07:53:21+00:00,tippanul,udh final bgt y ini?,1,0,0,11393,https://x.com/tippanul/status/1976194256277733738,https://x.com/IndoPopBase/status/1976188365889470543,1
2025-10-09 07:34:51+00:00,Seung_ha_,"What led to the extortion and threat charges now faced by Nikita Mirzani, and how might this case impact her public image? 
@grok",1,0,0,6988,https://x.com/Seung_ha_/status/1976189602739224977,https://x.com/IndoPopBase/status/1976188365889470543,1
2025-10-09 10:47:43+00:00,guerillach,"11 years of peaceful internet world?!
That's good.",0,5,0,3835,https://x.com/guerillach/status/1976238139070157022,https://x.com/IndoPopBase/status/1976188365889470543,5
2025-10-09 14:33:58+00:00,mimiwkoceng,"Smenjak nikmir vakum, dunia artis adem ayem yah wwkw",0,0,0,1245,https://x.com/mimiwkoceng/status/1976295077686411650,https://x.com/IndoPopBase/status/1976188365889470543,0
2025-10-09 08:18:58+00:00,yaelahte,way longer than her calon mantu dong kalo gitu,0,2,0,11140,https://x.com/yaelahte/status/1976200705515155545,https://x.com/IndoPopBase/status/1976188365889470543,2
2025-10-09 20:35:39+00:00,aro2n_kim10,Well deserve semoga gak keluar2 kalau ada doi somehow internet toxic bgt,0,0,0,133,https://x.com/aro2n_kim10/status/1976386098235633707,https://x.com/IndoPopBase/status/1976188365889470543,0
2025-10-09 13:19:28+00:00,misbah_sputra,,0,0,0,487,https://x.com/misbah_sputra/status/1976276325238452422,https://x.com/IndoPopBase/status/1976188365889470543,0
2025-10-09 08:35:03+00:00,jogja_alif,Itulah buah dari mulut nya yg suka julidin n ikut campur urusan org. Kena batunya .,0,0,0,1742,https://x.com/jogja_alif/status/1976204750074065004,https://x.com/IndoPopBase/status/1976188365889470543,0
2025-10-09 07:55:13+00:00,culturalizion,World peace incoming,0,0,0,2525,https://x.com/culturalizion/status/1976194725972672602,https://x.com/IndoPopBase/status/1976188365889470543,0
2025-10-10 03:12:56+00:00,endiiiel,"Harusnya lolos atau gak minimal di penjaranya cuman sebentar, soalnya kemaren kan doi ikut jilatin pantat wowo.",0,0,0,56,https://x.com/endiiiel/status/1976486075838386248,https://x.com/IndoPopBase/status/1976188365889470543,0
2025-10-09 15:56:21+00:00,anginmalammmmmm,"dia sahabat rezim, yakali ga dibantu",0,0,0,214,https://x.com/anginmalammmmmm/status/1976315809644548421,https://x.com/IndoPopBase/status/1976188365889470543,0
2025-10-09 12:14:16+00:00,snowywishwife,Coba kalo dulu kiki the potters ga ambil dia wkwk,0,0,0,513,https://x.com/snowywishwife/status/1976259917762658559,https://x.com/IndoPopBase/status/1976188365889470543,0
2025-10-10 07:45:34+00:00,yvdi_X,Lolly knowing this news,0,0,0,8,https://x.com/yvdi_X/status/1976554688473596358,https://x.com/IndoPopBase/status/1976188365889470543,0
2025-10-10 02:00:38+00:00,Ryukenzi2,Wkwkwk,0,0,0,29,https://x.com/Ryukenzi2/status/1976467879219597611,https://x.com/IndoPopBase/status/1976188365889470543,0
2025-10-09 07:44:57+00:00,yuualll,amazing,0,0,0,660,https://x.com/yuualll/status/1976192142017167675,https://x.com/IndoPopBase/status/1976188365889470543,0
2025-10-10 00:20:06+00:00,yudibasudagar,"Berat ya hukumannya, dia ga sopan sih di persidangan hakim juga kyanya eneg ngelihat sikapnya dipersidangan",0,0,0,115,https://x.com/yudibasudagar/status/1976442580297712096,https://x.com/IndoPopBase/status/1976188365889470543,0
2025-10-09 07:31:07+00:00,WOLF_of_IHSG,Something in the way …. Uuuu u uuu *nyanyi pake nada Kurt Cobain,0,0,0,4573,https://x.com/WOLF_of_IHSG/status/1976188661554381288,https://x.com/IndoPopBase/status/1976188365889470543,0
2025-10-09 13:44:48+00:00,twntyfourseven_,"Cape bgt sama nih orang problematik, di semua sosmed udah gw blok biar ga pernah fyp. Kapan tobatnya nih orang",0,0,0,117,https://x.com/twntyfourseven_/status/1976282701150970047,https://x.com/IndoPopBase/status/1976188365889470543,0
2025-10-10 01:10:17+00:00,sharkitty____,"ada yg ngerangkum ga, si nikmir ni dah brp kasus dan brp kali masuk penjara dan krn apa",0,0,0,107,https://x.com/sharkitty____/status/1976455210819256342,https://x.com/IndoPopBase/status/1976188365889470543,0
2025-10-10 02:45:31+00:00,nunm0renunl3ss,Oot tp dia 02 garis keras kan?,0,0,0,20,https://x.com/nunm0renunl3ss/status/1976479175012909222,https://x.com/IndoPopBase/status/1976188365889470543,0
2025-10-09 10:10:02+00:00,feliciaaaaa99,depe lngsng party ,0,0,0,382,https://x.com/feliciaaaaa99/status/1976228654293319802,https://x.com/IndoPopBase/status/1976188365889470543,0
2025-10-09 08:46:17+00:00,vvictorizz,Good news.,0,0,0,935,https://x.com/vvictorizz/status/1976207579211759636,https://x.com/IndoPopBase/status/1976188365889470543,0
2025-10-09 15:37:02+00:00,·,mau membusuk di penjara pun gua ga peduli jing,0,0,0,113,https://x.com/pengremas/status/1976310948882424144,https://x.com/IndoPopBase/status/1976188365889470543,0
2025-10-09 11:23:55+00:00,doraislut,a winning today,0,0,0,57,https://x.com/doraislut/status/1976247247030583437,https://x.com/IndoPopBase/status/1976188365889470543,0
2025-10-09 11:10:16+00:00,DrianFritz,Cek ombak Mulu nih obaba,0,0,0,50,https://x.com/DrianFritz/status/1976243814668042295,https://x.com/IndoPopBase/status/1976188365889470543,0
2025-10-09 08:10:34+00:00,3usri,bisa tu ketemu fadel bajideh,0,0,0,503,https://x.com/3usri/status/1976198591191679140,https://x.com/IndoPopBase/status/1976188365889470543,0
2025-10-09 10:48:08+00:00,dianindra888,11 tahun subsider 6 bulan atau denda 2 milyar untuk 6 bulannya,0,0,0,1947,https://x.com/dianindra888/status/1976238241566413037,https://x.com/IndoPopBase/status/1976188365889470543,0
2025-10-09 08:16:38+00:00,GhhopesHi,We want more,0,0,0,382,https://x.com/GhhopesHi/status/1976200117058404364,https://x.com/IndoPopBase/status/1976188365889470543,0
2025-10-09 07:34:19+00:00,PROSPERDEGREAT,That’s wild. She’s been in more legal drama than most TV shows have seasons,0,0,0,16659,https://x.com/PROSPERDEGREAT/status/1976189465484808702,https://x.com/IndoPopBase/status/1976188365889470543,0
2025-10-10 02:38:24+00:00,baeecedes,Ini masalah awalnya kena apa sih wkwkwk,0,0,0,17,https://x.com/baeecedes/status/1976477387224465788,https://x.com/IndoPopBase/status/1976188365889470543,0
2025-10-09 17:42:23+00:00,veneerate,Kasus apaan lagi sih ini? ,0,0,0,67,https://x.com/veneerate/status/1976342491994726585,https://x.com/IndoPopBase/status/1976188365889470543,0
2025-10-09 07:54:02+00:00,rezkiamda62,Let's goo,0,0,0,635,https://x.com/rezkiamda62/status/1976194430853071072,https://x.com/IndoPopBase/status/1976188365889470543,0
2025-10-09 09:29:16+00:00,lavenderswift93,Wdc about her,0,0,0,85,https://x.com/lavenderswift93/status/1976218393750667611,https://x.com/IndoPopBase/status/1976188365889470543,0
2025-10-09 15:15:19+00:00,WEchoes14067,Malaysia can claim tbh,0,0,0,39,https://x.com/WEchoes14067/status/1976305481502331070,https://x.com/IndoPopBase/status/1976188365889470543,0
2025-10-09 09:42:47+00:00,360BYXCX,keep her locked in forever pls,0,0,0,769,https://x.com/360BYXCX/status/1976221796081991886,https://x.com/IndoPopBase/status/1976188365889470543,0
2025-10-09 14:51:46+00:00,n3v3rdoes3xist,"ini belom sidang akhir loh min, stop share yg belom hasil final kali.",0,0,0,226,https://x.com/n3v3rdoes3xist/status/1976299554623586331,https://x.com/IndoPopBase/status/1976188365889470543,0
2025-10-09 08:08:04+00:00,indahwelwelz,Dewi perssik:,0,0,0,1571,https://x.com/indahwelwelz/status/1976197961521693071,https://x.com/IndoPopBase/status/1976188365889470543,0
2025-10-09 08:36:51+00:00,Dodoaldodoz,Syitttt,0,0,0,300,https://x.com/Dodoaldodoz/status/1976205206372352460,https://x.com/IndoPopBase/status/1976188365889470543,0
2025-10-10 03:26:36+00:00,lactamases,baguslah drpd ribut aj kerjaan pusinh,0,0,0,26,https://x.com/lactamases/status/1976489516715401457,https://x.com/IndoPopBase/status/1976188365889470543,0
2025-10-09 10:05:52+00:00,mingyukuuu,WE SMILED,0,0,0,105,https://x.com/mingyukuuu/status/1976227606157479979,https://x.com/IndoPopBase/status/1976188365889470543,0
2025-10-09 14:48:16+00:00,notursyl,watdehell kasian bgt:( anaknya masih pada kecil loh apaa emang pasalnya kaya gt yahh,0,0,0,211,https://x.com/notursyl/status/1976298674142708022,https://x.com/IndoPopBase/status/1976188365889470543,0
2025-10-09 06:41:10+00:00,Seung_ha_,"How has Rossa managed to stay one of Indonesia’s most successful and beloved artists for nearly three decades? 
@grok",1,0,0,199,https://x.com/Seung_ha_/status/1976176092450033820,https://x.com/IndoPopBase/status/1976174511029662051,1
2025-10-09 06:52:53+00:00,bobby001_eth,"Happy 47th to Rossa! A true icon, 12M albums sold and hits like ‘Tegar’ and ‘Hati Yang Kau Sakiti’ show why she’s a legend in Indonesian music.",0,0,0,258,https://x.com/bobby001_eth/status/1976179039397388761,https://x.com/IndoPopBase/status/1976174511029662051,0
2025-10-09 06:41:17+00:00,sugar_6378,rossa!,0,0,0,261,https://x.com/sugar_6378/status/1976176118999941172,https://x.com/IndoPopBase/status/1976174511029662051,0
2025-10-09 06:53:17+00:00,bobby001_eth,12M albums sold proves she’s a true Indonesian legend.,0,0,0,241,https://x.com/bobby001_eth/status/1976179139284762824,https://x.com/IndoPopBase/status/1976174511029662051,0
2025-10-09 06:40:10+00:00,CitaStarstories,Happy Birthday teh Rossa,0,0,0,365,https://x.com/CitaStarstories/status/1976175839617351830,https://x.com/IndoPopBase/status/1976174511029662051,0
2025-10-09 12:28:24+00:00,johanlesmana911,Happy birthday legend,0,0,0,86,https://x.com/johanlesmana911/status/1976263476906688983,https://x.com/IndoPopBase/status/1976174511029662051,0
2025-10-09 06:37:07+00:00,ursteulyNaveen,An absolute legend  Rossa’s voice has defined generations — 47 and still reigning as Indonesia’s queen of pop! ,0,0,0,260,https://x.com/ursteulyNaveen/status/1976175071615221961,https://x.com/IndoPopBase/status/1976174511029662051,0
2025-10-09 07:31:41+00:00,firzafp,"Bunga Lestari salah satu rival resmi Rossa, ya karena namanya ""tanaman"".
Debut mulai 1988, popularitas sebagai bintang pada 1997.",1,0,0,199,https://x.com/firzafp/status/1976188804693430407,https://x.com/IndoPopBase/status/1976174511029662051,1
2025-10-09 07:55:23+00:00,culturalizion,Oh GODsa,0,0,0,169,https://x.com/culturalizion/status/1976194769966809163,https://x.com/IndoPopBase/status/1976174511029662051,0
2025-10-10 06:11:40+00:00,mimi_enaz,Happy Besday Ocha ,0,0,0,11,https://x.com/mimi_enaz/status/1976531053675495713,https://x.com/IndoPopBase/status/1976174511029662051,0
2025-10-09 06:47:19+00:00,hrgila,"Foto kiri atas, kek Katniss.",0,0,0,332,https://x.com/hrgila/status/1976177639003128042,https://x.com/IndoPopBase/status/1976174511029662051,0
2025-10-10 02:47:36+00:00,harimingguuu,"LIBRA ITU CAKEP-CAKEP (TERMASUK SAYA ), KECUALI FUFUFAFA ANJJJJIIIING",0,0,0,37,https://x.com/harimingguuu/status/1976479698663461121,https://x.com/IndoPopBase/status/1976174511029662051,0
2025-10-09 15:04:02+00:00,arieelfa,The real diva,0,0,0,59,https://x.com/arieelfa/status/1976302643011309772,https://x.com/IndoPopBase/status/1976174511029662051,0
2025-10-09 10:40:09+00:00,KurniawanRicho,Hbd teh oca,0,0,0,83,https://x.com/KurniawanRicho/status/1976236234390503464,https://x.com/IndoPopBase/status/1976174511029662051,0
2025-10-09 08:29:17+00:00,Yeni_Puu,"Teh ocaa 
@mynameisrossa
 happy birthday",0,0,0,126,https://x.com/Yeni_Puu/status/1976203301835411499,https://x.com/IndoPopBase/status/1976174511029662051,0
2025-10-09 10:58:51+00:00,VVYND,TEGAR will always be THAT girl,0,0,0,163,https://x.com/VVYND/status/1976240939078386023,https://x.com/IndoPopBase/status/1976174511029662051,0
2025-10-09 16:02:48+00:00,kitty_gandalf,"masih inget gimana anak-anak sd jaman gue dulu hyping lagu ""Pudar""

meskipun liriknya begono ",0,0,0,92,https://x.com/kitty_gandalf/status/1976317431820980386,https://x.com/IndoPopBase/status/1976174511029662051,0
2025-10-09 06:45:21+00:00,senorjoey,The only teh ocha yang semanis madu ,0,0,0,182,https://x.com/senorjoey/status/1976177144398323777,https://x.com/IndoPopBase/status/1976174511029662051,0
2025-10-08 19:26:26+00:00,PEDRllll,2 pens and red card for KSA yet still flopping like agnezmo's entire discography oh NUGUnesia,5,2,0,4793,https://x.com/PEDRllll/status/1976006290876096748,https://x.com/IndoPopBase/status/1976005680743186483,7
2025-10-08 19:44:33+00:00,idnewcastle_,"plsss karena Indo kalah, boleh ga jangan post pake capt stan stun selama 2 hari?",8,0,0,2631,https://x.com/idnewcastle_/status/1976010846859112457,https://x.com/IndoPopBase/status/1976005680743186483,8
2025-10-08 19:28:07+00:00,PEDRllll,,0,10,0,2317,https://x.com/PEDRllll/status/1976006715129868292,https://x.com/IndoPopBase/status/1976005680743186483,10
2025-10-08 19:31:35+00:00,skyrepmu,"ini kalo tempat netral bisa imbang ya 
@FIFAcom
 anjing!",2,0,0,1253,https://x.com/skyrepmu/status/1976007585276006405,https://x.com/IndoPopBase/status/1976005680743186483,2
2025-10-08 19:29:17+00:00,FarhanPratamaJ,,0,0,0,2825,https://x.com/FarhanPratamaJ/status/1976007007833555349,https://x.com/IndoPopBase/status/1976005680743186483,0
2025-10-08 19:59:27+00:00,keromessenger,"Indo itu dikutuk sama tragedi Kanjuruhan yg gak kelar². Selama itu kasus gak selesai, Timnas gak bakalan jadi apa²",1,0,0,1668,https://x.com/keromessenger/status/1976014598999548204,https://x.com/IndoPopBase/status/1976005680743186483,1
2025-10-08 19:24:30+00:00,irularr_,Saya menduga ada campur tangan pihak asing atas kekalahan Timnas kita. Kita ini bangsa yg besar tak pantas kalah dari Arab.,0,0,0,3242,https://x.com/irularr_/status/1976005801409233095,https://x.com/IndoPopBase/status/1976005680743186483,0
2025-10-08 19:40:04+00:00,msmarciadevana,#PatrickOut #KluivertOut,0,1,0,4672,https://x.com/msmarciadevana/status/1976009718654173522,https://x.com/IndoPopBase/status/1976005680743186483,1
2025-10-09 05:39:16+00:00,Siiierra16,"Udah kalah doa, pengurusnya dzolim pula ke pelatih lama, ke rakyatnya.",0,0,0,165,https://x.com/Siiierra16/status/1976160513987097021,https://x.com/IndoPopBase/status/1976005680743186483,0
2025-10-09 05:35:18+00:00,Utozee,Udah gak heran. Gak ngerti lagi apa juga faedahnya ngegemborin ni olahraga satu.,0,0,0,54,https://x.com/Utozee/status/1976159514627015043,https://x.com/IndoPopBase/status/1976005680743186483,0
2025-10-09 02:46:42+00:00,deemsumchilioil,gasalahkan kl gue bilang kangen zaman sty,0,0,0,175,https://x.com/deemsumchilioil/status/1976117085513318793,https://x.com/IndoPopBase/status/1976005680743186483,0
2025-10-08 19:27:59+00:00,srepetpettpet,"et tolol, pk dungu. kgn sty ball",0,0,0,499,https://x.com/srepetpettpet/status/1976006679100785055,https://x.com/IndoPopBase/status/1976005680743186483,0
2025-10-08 19:54:16+00:00,arcanelilyy,Bgst,0,0,0,264,https://x.com/arcanelilyy/status/1976013295044956651,https://x.com/IndoPopBase/status/1976005680743186483,0
2025-10-09 02:08:38+00:00,blurnote,Ini kayaknya masalah komunikasi ges,0,0,0,99,https://x.com/blurnote/status/1976107505035157812,https://x.com/IndoPopBase/status/1976005680743186483,0
2025-10-08 19:33:25+00:00,412Y00,,0,0,0,1659,https://x.com/412Y00/status/1976008044954911134,https://x.com/IndoPopBase/status/1976005680743186483,0
2025-10-08 23:20:17+00:00,lavenderswift93,LMAO,0,0,0,240,https://x.com/lavenderswift93/status/1976065141621084214,https://x.com/IndoPopBase/status/1976005680743186483,0
2025-10-08 20:18:34+00:00,lipglosslethal_,khianesia,0,0,0,438,https://x.com/lipglosslethal_/status/1976019408259776572,https://x.com/IndoPopBase/status/1976005680743186483,0
2025-10-08 19:42:56+00:00,MusuhPemerenta,Jemboooot,0,0,0,677,https://x.com/MusuhPemerenta/status/1976010442347872675,https://x.com/IndoPopBase/status/1976005680743186483,0
2025-10-09 01:51:16+00:00,minisuode,Sukurin,0,0,0,88,https://x.com/minisuode/status/1976103136847855643,https://x.com/IndoPopBase/status/1976005680743186483,0
2025-10-08 19:33:56+00:00,Hoshinoyumemi__,udah ambil pemain luar malah mainnya lemes semua,0,0,0,890,https://x.com/Hoshinoyumemi__/status/1976008178807746895,https://x.com/IndoPopBase/status/1976005680743186483,0
2025-10-09 07:19:26+00:00,Zelinirine,"1 2 3 

Mengapa harus shin tae yongg~~~",0,0,0,72,https://x.com/Zelinirine/status/1976185723457036579,https://x.com/IndoPopBase/status/1976005680743186483,0
2025-10-08 19:53:22+00:00,chvenawe,"dari imbang sampe menang, sekarang malah kalah",0,0,0,581,https://x.com/chvenawe/status/1976013066153361732,https://x.com/IndoPopBase/status/1976005680743186483,0
2025-10-08 19:43:03+00:00,Semutthony,Akibat pelatih penjas main longball gajelas,0,0,0,1619,https://x.com/Semutthony/status/1976010469497512013,https://x.com/IndoPopBase/status/1976005680743186483,0
2025-10-08 19:24:52+00:00,KSencou,"""tim kepelatihan terbaik""",0,0,0,2064,https://x.com/KSencou/status/1976005894925410546,https://x.com/IndoPopBase/status/1976005680743186483,0
2025-10-09 01:44:54+00:00,teukumi,Alhamdulillah ,0,0,0,118,https://x.com/teukumi/status/1976101533436739784,https://x.com/IndoPopBase/status/1976005680743186483,0
2025-10-08 19:33:03+00:00,endsteinnn,STUNSNYA MANAAAA,0,0,0,375,https://x.com/endsteinnn/status/1976007952957149616,https://x.com/IndoPopBase/status/1976005680743186483,0
2025-10-09 03:16:54+00:00,JavaJimmyMaukar,wkwkwkwkwkkwkwkwkekeke,0,0,0,29,https://x.com/JavaJimmyMaukar/status/1976124688335073647,https://x.com/IndoPopBase/status/1976005680743186483,0
2025-10-08 19:29:09+00:00,KurniawanRicho,Emang pantes kalah,0,0,0,518,https://x.com/KurniawanRicho/status/1976006972580520230,https://x.com/IndoPopBase/status/1976005680743186483,0
2025-10-08 19:30:15+00:00,wildanp_,Klok setan gak guna gak berjuang bgt !!!!,0,0,0,558,https://x.com/wildanp_/status/1976007250230829211,https://x.com/IndoPopBase/status/1976005680743186483,0
2025-10-09 12:01:59+00:00,Atrheides,Sukurin.,0,0,0,52,https://x.com/Atrheides/status/1976256829756973122,https://x.com/IndoPopBase/status/1976005680743186483,0
2025-10-08 20:23:33+00:00,Jun__Dev,"Thanks, Saudi. ",0,0,0,184,https://x.com/Jun__Dev/status/1976020663271141458,https://x.com/IndoPopBase/status/1976005680743186483,0
2025-10-08 23:16:15+00:00,manghenme1,Congrats arab,0,0,0,176,https://x.com/manghenme1/status/1976064123243987157,https://x.com/IndoPopBase/status/1976005680743186483,0
2025-10-08 19:27:10+00:00,Raka_HI12,"Sulit dah lolos ke World Cup
Lewat Round 5 pun juga sangat sulit",0,0,0,582,https://x.com/Raka_HI12/status/1976006475635179707,https://x.com/IndoPopBase/status/1976005680743186483,0
2025-10-09 00:03:11+00:00,acilhae7,kanjuruhan tuh urusin bego,0,0,0,109,https://x.com/acilhae7/status/1976075934429319354,https://x.com/IndoPopBase/status/1976005680743186483,0
2025-10-08 19:26:19+00:00,manobiaaa,lgsg aja #KluivertOut,0,0,0,677,https://x.com/manobiaaa/status/1976006260144402917,https://x.com/IndoPopBase/status/1976005680743186483,0
2025-10-08 19:33:36+00:00,hajarban6,Eric tohir kentot.,0,0,0,223,https://x.com/hajarban6/status/1976008091163652607,https://x.com/IndoPopBase/status/1976005680743186483,0
2025-10-08 19:32:59+00:00,jackthegon,#KluivertOut pelatih tolol,0,0,0,245,https://x.com/jackthegon/status/1976007939254255908,https://x.com/IndoPopBase/status/1976005680743186483,0
2025-10-08 19:25:19+00:00,93TokyoDope,"Patrick abis dah di caci maki.
Jelas pemain yang gabisa ngimbangin laga ini malah dibiarin main.",2,0,0,501,https://x.com/93TokyoDope/status/1976006007580152297,https://x.com/IndoPopBase/status/1976005680743186483,2
2025-10-09 08:50:19+00:00,budakidealis,no surprise,0,0,0,60,https://x.com/budakidealis/status/1976208595210657820,https://x.com/IndoPopBase/status/1976005680743186483,0
2025-10-08 19:32:12+00:00,DBDBZDBGTDBS_0,"Fuc##@k off you Indonesians idiots you were toxic before the match on social media for no reason,  just because you won one time against us you thought you were on our level ? Netherlands b team can't save you",1,0,0,263,https://x.com/DBDBZDBGTDBS_0/status/1976007740817539485,https://x.com/IndoPopBase/status/1976005680743186483,1
2025-10-09 05:17:13+00:00,billllliiee,"Lama-lama X ini kayak bayi, baru ditinggal sehari udah kelewatan update terbaru. Ini tentang apaan btw?",2,0,0,1802,https://x.com/billllliiee/status/1976154964264354265,https://x.com/IndoPopBase/status/1975996654588432522,2
2025-10-08 19:04:50+00:00,preeittyy,"ga guna, beneran kaya Patrick di kartun yang ga punya otak",0,5,0,4576,https://x.com/preeittyy/status/1976000853183205684,https://x.com/IndoPopBase/status/1975996654588432522,5
2025-10-08 18:48:56+00:00,habibiws,Stuns ga min?,1,0,0,3233,https://x.com/habibiws/status/1975996850370142699,https://x.com/IndoPopBase/status/1975996654588432522,1
2025-10-08 18:51:51+00:00,OynRetriever,"sumpah tolol, yg ga perform siapa, yg diganti siapa…. petrik gblkkkkk #PatrickOut",0,0,0,4999,https://x.com/OynRetriever/status/1975997587963707392,https://x.com/IndoPopBase/status/1975996654588432522,0
2025-10-09 01:19:50+00:00,todayisrose_,GAK PUNYA OTAK EMANGG,1,0,0,682,https://x.com/todayisrose_/status/1976095225052582356,https://x.com/IndoPopBase/status/1975996654588432522,1
2025-10-09 04:09:28+00:00,joaobatal,IndoPopBase admin cooks in a new post,0,0,0,660,https://x.com/joaobatal/status/1976137916649963631,https://x.com/IndoPopBase/status/1975996654588432522,0
2025-10-08 19:31:02+00:00,alotsofweird,sama gobloknya kayak amorim suka ngide kagak jelas anjing,0,0,0,2603,https://x.com/alotsofweird/status/1976007445446299909,https://x.com/IndoPopBase/status/1975996654588432522,0
2025-10-08 19:32:47+00:00,ximpledump,,0,0,0,889,https://x.com/ximpledump/status/1976007889530785848,https://x.com/IndoPopBase/status/1975996654588432522,0
2025-10-08 18:50:53+00:00,_____gip,patrick kluivert stun indonesian supporters,0,0,0,1864,https://x.com/_____gip/status/1975997345084080620,https://x.com/IndoPopBase/status/1975996654588432522,0
2025-10-08 20:07:51+00:00,arpiasdfghjkl,HAHAHAHAHA,0,0,0,777,https://x.com/arpiasdfghjkl/status/1976016710877712642,https://x.com/IndoPopBase/status/1975996654588432522,0
2025-10-08 20:24:39+00:00,·,,0,0,0,1986,https://x.com/myoldaccountis_/status/1976020941034684647,https://x.com/IndoPopBase/status/1975996654588432522,0
2025-10-08 18:53:22+00:00,troublemaekers,Patrick dongo,0,0,0,1312,https://x.com/troublemaekers/status/1975997968684871758,https://x.com/IndoPopBase/status/1975996654588432522,0
2025-10-08 18:53:26+00:00,butterluigii,eh WKWKWKWKKW,0,0,0,1515,https://x.com/butterluigii/status/1975997985847902515,https://x.com/IndoPopBase/status/1975996654588432522,0
2025-10-08 23:56:37+00:00,canw3ll,gibran,0,0,0,191,https://x.com/canw3ll/status/1976074283177869359,https://x.com/IndoPopBase/status/1975996654588432522,0
2025-10-08 19:54:23+00:00,NickolasSHP,,0,0,0,646,https://x.com/NickolasSHP/status/1976013321666167035,https://x.com/IndoPopBase/status/1975996654588432522,0
2025-10-08 19:12:12+00:00,ezskyy_,indo out idc,0,0,0,447,https://x.com/ezskyy_/status/1976002707006861784,https://x.com/IndoPopBase/status/1975996654588432522,0
2025-10-09 00:47:41+00:00,mazrf24,,0,0,0,197,https://x.com/mazrf24/status/1976087133032251661,https://x.com/IndoPopBase/status/1975996654588432522,0
2025-10-08 18:49:06+00:00,jpremewwcoin,Gg,0,0,0,370,https://x.com/jpremewwcoin/status/1975996893147615501,https://x.com/IndoPopBase/status/1975996654588432522,0
2025-10-08 18:49:07+00:00,strelicax,patrick rn,0,0,0,750,https://x.com/strelicax/status/1975996899514876403,https://x.com/IndoPopBase/status/1975996654588432522,0
2025-10-08 18:50:50+00:00,EVM0x_nads,knp patrick,0,0,0,690,https://x.com/EVM0x_nads/status/1975997332123705522,https://x.com/IndoPopBase/status/1975996654588432522,0
2025-10-08 18:49:14+00:00,jpremewwcoin,Hahaha,0,0,0,576,https://x.com/jpremewwcoin/status/1975996925846618158,https://x.com/IndoPopBase/status/1975996654588432522,0
2025-10-09 00:07:57+00:00,jimbonski,,0,0,0,435,https://x.com/jimbonski/status/1976077137317941647,https://x.com/IndoPopBase/status/1975996654588432522,0
2025-10-08 18:57:03+00:00,GNET888,,0,0,0,453,https://x.com/GNET888/status/1975998896112533679,https://x.com/IndoPopBase/status/1975996654588432522,0
2025-10-09 08:15:28+00:00,Diky_blackjack,,0,0,0,166,https://x.com/Diky_blackjack/status/1976199821955682545,https://x.com/IndoPopBase/status/1975996654588432522,0
2025-10-09 05:40:55+00:00,surgaca,"@snopzie
 ",2,0,0,79,https://x.com/surgaca/status/1976160927511941240,https://x.com/IndoPopBase/status/1975996654588432522,2
2025-10-08 22:56:49+00:00,aswan21w,,0,0,0,135,https://x.com/aswan21w/status/1976059233184743706,https://x.com/IndoPopBase/status/1975996654588432522,0
2025-10-09 09:57:32+00:00,entongwewew,,0,0,0,18,https://x.com/entongwewew/status/1976225511023210838,https://x.com/IndoPopBase/status/1975996654588432522,0
2025-10-08 19:57:04+00:00,arda_galer,,0,0,0,178,https://x.com/arda_galer/status/1976013998245265664,https://x.com/IndoPopBase/status/1975996654588432522,0
2025-10-09 07:31:09+00:00,fajr_rio,"People who make ""hating something"" as their entire personality",0,0,0,9,https://x.com/fajr_rio/status/1976188671708848612,https://x.com/IndoPopBase/status/1975996654588432522,0
2025-10-08 16:20:05+00:00,Seung_ha_,"What caused the chaotic scene before the Indonesia vs. Saudi Arabia World Cup Qualifier, with fans facing gate changes, seat mix-ups, and even fainting incidents outside the stadium?  
@grok",1,0,0,8894,https://x.com/Seung_ha_/status/1975959392572088551,https://x.com/IndoPopBase/status/1975959048869781896,1
2025-10-08 16:35:13+00:00,BolaBolaAja,kacauu,1,0,0,4859,https://x.com/BolaBolaAja/status/1975963203260858390,https://x.com/IndoPopBase/status/1975959048869781896,1
2025-10-08 16:21:52+00:00,ursteulyNaveen,Total chaos before kickoff  Fans deserve better organization than this.,2,0,0,6869,https://x.com/ursteulyNaveen/status/1975959840901177489,https://x.com/IndoPopBase/status/1975959048869781896,2
2025-10-08 17:06:33+00:00,stobelices,Arab jahiliyah comeback,2,2,0,3262,https://x.com/stobelices/status/1975971088724262977,https://x.com/IndoPopBase/status/1975959048869781896,4
2025-10-08 16:20:14+00:00,ultramenoo,perang kurma vs kelengkeng kah,1,0,0,7407,https://x.com/ultramenoo/status/1975959428806688901,https://x.com/IndoPopBase/status/1975959048869781896,1
2025-10-08 16:50:30+00:00,wannabewithyuuu,wkwkw dikerjain arab jahiliyah,0,0,0,6196,https://x.com/wannabewithyuuu/status/1975967048082857988,https://x.com/IndoPopBase/status/1975959048869781896,0
2025-10-08 18:18:49+00:00,msultanalikhan,Kacau ini panitia,0,2,0,1651,https://x.com/msultanalikhan/status/1975989274064646308,https://x.com/IndoPopBase/status/1975959048869781896,2
2025-10-09 02:11:28+00:00,arissroslan,Mentality kampung HAHAHAH,1,0,0,329,https://x.com/arissroslan/status/1976108221313188190,https://x.com/IndoPopBase/status/1975959048869781896,1
2025-10-08 16:31:09+00:00,abikaara,"Ayo, lempar jumrah aja di dalem stadionnya.",0,0,0,7345,https://x.com/abikaara/status/1975962177250136367,https://x.com/IndoPopBase/status/1975959048869781896,0
2025-10-08 17:00:45+00:00,hiwitasw,arab b nya apa,1,0,0,2914,https://x.com/hiwitasw/status/1975969626510311622,https://x.com/IndoPopBase/status/1975959048869781896,1
2025-10-08 21:04:28+00:00,dimsummacaroni,tanah saudi vs tanah abang,1,0,0,2493,https://x.com/dimsummacaroni/status/1976030962292228285,https://x.com/IndoPopBase/status/1975959048869781896,1
2025-10-08 18:14:14+00:00,·,"Tidak yakin kalo 
@afcasiancup
 bakal kasih sanksi ke tuan rumah, mustahil.",3,0,0,2130,https://x.com/love_cookiessss/status/1975988119234384184,https://x.com/IndoPopBase/status/1975959048869781896,3
2025-10-08 17:26:06+00:00,DeradPersian,Memang bangsa jahiliyah.. makanya nabi-nabi diturunkan disana.,0,0,0,1079,https://x.com/DeradPersian/status/1975976005606207663,https://x.com/IndoPopBase/status/1975959048869781896,0
2025-10-09 06:32:23+00:00,JgnPanggilOm,"Orang arab emang gateli, makanya nabi turunnya disono ",0,0,0,70,https://x.com/JgnPanggilOm/status/1976173880193712184,https://x.com/IndoPopBase/status/1975959048869781896,0
2025-10-08 16:44:29+00:00,NasiAking234,As expected,0,0,0,2883,https://x.com/NasiAking234/status/1975965531489624520,https://x.com/IndoPopBase/status/1975959048869781896,0
2025-10-08 18:26:43+00:00,hypocrispyindo,Alasan nabi Muhammad diturunkan di Makkah,0,0,0,463,https://x.com/hypocrispyindo/status/1975991261657169998,https://x.com/IndoPopBase/status/1975959048869781896,0
2025-10-08 18:28:25+00:00,dmwsdq,is this abu lahab behavior? ,0,0,0,1894,https://x.com/dmwsdq/status/1975991687408505060,https://x.com/IndoPopBase/status/1975959048869781896,0
2025-10-08 17:37:31+00:00,rfadhilaaaa,waduh bisa bisanya arab kaya gini,0,0,0,936,https://x.com/rfadhilaaaa/status/1975978878389846050,https://x.com/IndoPopBase/status/1975959048869781896,0
2025-10-09 00:51:12+00:00,briannugroho,They try everything to win and they did with no honour,0,0,0,540,https://x.com/briannugroho/status/1976088021570306133,https://x.com/IndoPopBase/status/1975959048869781896,0
2025-10-08 18:17:54+00:00,esteh4you,arab gokil is back,0,0,0,652,https://x.com/esteh4you/status/1975989043617059016,https://x.com/IndoPopBase/status/1975959048869781896,0
2025-10-08 16:51:54+00:00,matbrekai,Jahiliyah ball,0,0,0,2358,https://x.com/matbrekai/status/1975967401276752277,https://x.com/IndoPopBase/status/1975959048869781896,0
2025-10-08 17:20:35+00:00,haipanjiishere,wkwkwk dikerjain didalam dan diluar lapangan ,0,0,0,1052,https://x.com/haipanjiishere/status/1975974618419912960,https://x.com/IndoPopBase/status/1975959048869781896,0
2025-10-08 16:59:56+00:00,ABayuTama,Bau amisssss,0,0,0,1086,https://x.com/ABayuTama/status/1975969419970171101,https://x.com/IndoPopBase/status/1975959048869781896,0
2025-10-08 23:44:25+00:00,armstrong_jeje,"Udah dibodohin ttg dogma,bolapun jg dipekokk in sama arab jg ???",0,0,0,340,https://x.com/armstrong_jeje/status/1976071213396132333,https://x.com/IndoPopBase/status/1975959048869781896,0
2025-10-08 16:24:41+00:00,ferizast,oh c'mon,0,0,0,3111,https://x.com/ferizast/status/1975960551642845454,https://x.com/IndoPopBase/status/1975959048869781896,0
2025-10-08 16:44:46+00:00,RKinashi,"Ayo rusuh, biar kena sanksi fifa",0,0,0,1447,https://x.com/RKinashi/status/1975965604575314091,https://x.com/IndoPopBase/status/1975959048869781896,0
2025-10-08 18:04:17+00:00,·,"man :""",0,0,0,497,https://x.com/courtescy/status/1975985617256448345,https://x.com/IndoPopBase/status/1975959048869781896,0
2025-10-08 17:17:58+00:00,ccrmlmchiato,Arab tai,0,0,0,634,https://x.com/ccrmlmchiato/status/1975973961080221977,https://x.com/IndoPopBase/status/1975959048869781896,0
2025-10-08 17:09:09+00:00,LightAfterThis,Saudi menolak pagar dibuka jadinya dipaksa masuk ama fans,0,0,0,1545,https://x.com/LightAfterThis/status/1975971742540824695,https://x.com/IndoPopBase/status/1975959048869781896,0
2025-10-08 17:07:57+00:00,horandogslovers,arab babi,0,0,0,660,https://x.com/horandogslovers/status/1975971440341160347,https://x.com/IndoPopBase/status/1975959048869781896,0
2025-10-08 17:03:05+00:00,aaggr355iv3,Baik2 indonesia pernah ada kes mati beramai2 di stadium,0,0,0,1179,https://x.com/aaggr355iv3/status/1975970215394672722,https://x.com/IndoPopBase/status/1975959048869781896,0
2025-10-08 19:22:19+00:00,Lm_002Mx,Barbaric Indonesians,0,0,0,335,https://x.com/Lm_002Mx/status/1976005251514925287,https://x.com/IndoPopBase/status/1975959048869781896,0
2025-10-08 16:43:04+00:00,Matto_D_guy,"Inilah akibatnya karena pak anies gk jadi presiden. 

Arab jadi menganggap kita musuh.",2,1,0,1407,https://x.com/Matto_D_guy/status/1975965177284841830,https://x.com/IndoPopBase/status/1975959048869781896,3
2025-10-09 00:32:38+00:00,BaeEvelyn24,Fuck arab,0,0,0,90,https://x.com/BaeEvelyn24/status/1976083345290502650,https://x.com/IndoPopBase/status/1975959048869781896,0
2025-10-09 02:27:34+00:00,mdyjkp61677,"fuck 
@theafcdotcom
  and 
@saff_wfd",0,0,0,63,https://x.com/mdyjkp61677/status/1976112270439772282,https://x.com/IndoPopBase/status/1975959048869781896,0
2025-10-08 16:21:01+00:00,0xeSasuke,were there any official statements from organizers about what caused the chaos?,1,0,0,10277,https://x.com/0xeSasuke/status/1975959627922878572,https://x.com/IndoPopBase/status/1975959048869781896,1
2025-10-08 22:43:50+00:00,aswan21w,,0,0,0,130,https://x.com/aswan21w/status/1976055968246157581,https://x.com/IndoPopBase/status/1975959048869781896,0
2025-10-09 06:39:43+00:00,pongpingdash,Laknat,0,0,0,15,https://x.com/pongpingdash/status/1976175727268831550,https://x.com/IndoPopBase/status/1975959048869781896,0
2025-10-08 19:08:24+00:00,RDump732771,"Arab itu cinta duit, mana ada mikirin hidup negara lain ngapainn",0,0,0,217,https://x.com/RDump732771/status/1976001751758274781,https://x.com/IndoPopBase/status/1975959048869781896,0
2025-10-08 17:05:23+00:00,iknowmyfeel,"Serius tanya, ini kalau Indonesia menang bakal lolos ke pildun ya?",0,0,0,526,https://x.com/iknowmyfeel/status/1975970792375726533,https://x.com/IndoPopBase/status/1975959048869781896,0
2025-10-08 16:20:39+00:00,Prime___TV,This is wrong . They should be proper arrangements before the match,0,0,0,1402,https://x.com/Prime___TV/status/1975959535904051668,https://x.com/IndoPopBase/status/1975959048869781896,0
2025-10-08 16:56:53+00:00,baerizzz,We blame anis yaman baswedan for this!,1,0,0,824,https://x.com/baerizzz/status/1975968655335882864,https://x.com/IndoPopBase/status/1975959048869781896,1
2025-10-08 13:08:36+00:00,bobby001_eth,Rossa teasing a collab with MK K-Clique? Friday’s release just jumped to the top of my playlist already.,0,0,0,490,https://x.com/bobby001_eth/status/1975911204850966963,https://x.com/IndoPopBase/status/1975902499031973927,0
2025-10-08 12:34:33+00:00,ursteulyNaveen,Rossa x MK? That’s a collab I didn’t know I needed  can’t wait for Friday!,0,0,0,563,https://x.com/ursteulyNaveen/status/1975902634344419536,https://x.com/IndoPopBase/status/1975902499031973927,0
2025-10-08 13:08:57+00:00,bobby001_eth,"Rossa’s dropping collabs now? Curious to see how MK K-Clique vibes with her style, Friday can’t come fast enough.",0,0,0,507,https://x.com/bobby001_eth/status/1975911294252532041,https://x.com/IndoPopBase/status/1975902499031973927,0
2025-10-08 23:25:43+00:00,txtorangjualan,"Wiih lagu ""centil"" nih",0,0,0,104,https://x.com/txtorangjualan/status/1976066506694983969,https://x.com/IndoPopBase/status/1975902499031973927,0
2025-10-08 12:35:53+00:00,T3RIP4NG,im not hungry,0,0,0,94,https://x.com/T3RIP4NG/status/1975902970538807459,https://x.com/IndoPopBase/status/1975902499031973927,0
2025-10-08 15:03:02+00:00,zhayus_,Enak. Versi rumpies ft laleilmanino juga bagus,0,0,0,321,https://x.com/zhayus_/status/1975940001511936319,https://x.com/IndoPopBase/status/1975902499031973927,0
2025-10-08 14:26:26+00:00,roweeasley,I lobe I laikeu,0,0,0,283,https://x.com/roweeasley/status/1975930790048579844,https://x.com/IndoPopBase/status/1975902499031973927,0
2025-10-08 13:39:54+00:00,mintzyrinae,yassh back to centil era,0,0,0,399,https://x.com/mintzyrinae/status/1975919079946092566,https://x.com/IndoPopBase/status/1975902499031973927,0
2025-10-08 12:40:46+00:00,SwiftieBoy0410,Recycle hmm.,0,0,0,352,https://x.com/SwiftieBoy0410/status/1975904201730556320,https://x.com/IndoPopBase/status/1975902499031973927,0
2025-10-08 13:56:16+00:00,inouciance,And my mother Sheila Majid?,0,0,0,253,https://x.com/inouciance/status/1975923198454616196,https://x.com/IndoPopBase/status/1975902499031973927,0
2025-10-08 13:00:46+00:00,DatoSriRossa,Finally city of pop ,0,0,0,439,https://x.com/DatoSriRossa/status/1975909232789848306,https://x.com/IndoPopBase/status/1975902499031973927,0
2025-10-08 12:47:31+00:00,baefroz,Indo 90s era >>>,0,0,0,527,https://x.com/baefroz/status/1975905899316441444,https://x.com/IndoPopBase/status/1975902499031973927,0
2025-10-08 12:35:32+00:00,Seung_ha_,"Exciting collab!  What are your thoughts on Rossa teaming up with MK from K-Clique for ‘Sinaran’?
@grok",0,0,0,333,https://x.com/Seung_ha_/status/1975902884861747576,https://x.com/IndoPopBase/status/1975902499031973927,0
2025-10-09 09:27:44+00:00,QUEERAUSAHAAN,ammar zoni is the best anti-drug ad cause WTF HAPPENED like oh my god…..,107,740,0,460673,https://x.com/QUEERAUSAHAAN/status/1976218010957512842,https://x.com/IndoPopBase/status/1975902499031973927,847
2025-10-09 14:34:33+00:00,findormeme,bunch of elementary school kids revealing their exam passing status while slipping through my fingers is playing on the background meryl streep tidak lulus anak sd nangis dramatic hasil ujian nangis,350,2054,0,1311080,https://x.com/findormeme/status/1976295222960427487,https://x.com/IndoPopBase/status/1975902499031973927,2404
2025-10-09 11:04:39+00:00,xNortromx,The artist:                      The Art:,239,3249,0,842732,https://x.com/xNortromx/status/1976242398083588583,https://x.com/IndoPopBase/status/1975902499031973927,3488
2025-10-09 11:03:25+00:00,serenataloka,rangga & cinta after three years of dating,86,2393,0,456936,https://x.com/serenataloka/status/1976242091127685585,https://x.com/IndoPopBase/status/1975902499031973927,2479
2025-10-08 08:41:51+00:00,jawaberat,NO TENXI???? We tunning in,1,16,0,8646,https://x.com/jawaberat/status/1975844075397079259,https://x.com/IndoPopBase/status/1975836321026613482,17
2025-10-08 08:23:28+00:00,dontolicious_,PinkPantheress and her are collaborating on this EP,0,0,0,7303,https://x.com/dontolicious_/status/1975839450417832064,https://x.com/IndoPopBase/status/1975836321026613482,0
2025-10-08 10:23:10+00:00,funkyhokkaido,2 of my works in a week on indopopbase? I can’t. I really can’t. Y’all got taste tysm. And yeah Nay ate the house down.,2,2,0,7127,https://x.com/funkyhokkaido/status/1975869572709548086,https://x.com/IndoPopBase/status/1975836321026613482,4
2025-10-08 08:29:28+00:00,weyezblod,coming to end jkt48,2,6,0,9407,https://x.com/weyezblod/status/1975840959448723933,https://x.com/IndoPopBase/status/1975836321026613482,8
2025-10-08 12:10:04+00:00,fadilast48,The title “So Asu”,0,0,0,4389,https://x.com/fadilast48/status/1975896472538558713,https://x.com/IndoPopBase/status/1975836321026613482,0
2025-10-08 08:57:55+00:00,uhatuka,semoga beneran lagu centil pake b indo. inggris boleh tapi dikit aja ia,1,3,0,9423,https://x.com/uhatuka/status/1975848118941036612,https://x.com/IndoPopBase/status/1975836321026613482,4
2025-10-08 08:18:21+00:00,madanabhasma,FUTURE POPGIRL,0,0,0,8191,https://x.com/madanabhasma/status/1975838160983867859,https://x.com/IndoPopBase/status/1975836321026613482,0
2025-10-08 08:21:29+00:00,piduto,Bukannya tgl 10? Kmren dia bilang tgl 10,1,0,0,5681,https://x.com/piduto/status/1975838948837790194,https://x.com/IndoPopBase/status/1975836321026613482,1
2025-10-08 10:32:21+00:00,furburg3rr,POP GURLL DIVA,1,0,0,2620,https://x.com/furburg3rr/status/1975871882709938673,https://x.com/IndoPopBase/status/1975836321026613482,1
2025-10-08 09:43:43+00:00,Phoebe_woopsie,ended jkflop fourtwink eightank,0,1,0,1724,https://x.com/Phoebe_woopsie/status/1975859642686374273,https://x.com/IndoPopBase/status/1975836321026613482,1
2025-10-08 10:30:36+00:00,twinkiewingky,itu Megan katseye kah?,0,0,0,1380,https://x.com/twinkiewingky/status/1975871442240893051,https://x.com/IndoPopBase/status/1975836321026613482,0
2025-10-08 09:16:22+00:00,hardhene,posing like a fidget spinner oh im seated!,0,0,0,4425,https://x.com/hardhene/status/1975852763033846016,https://x.com/IndoPopBase/status/1975836321026613482,0
2025-10-10 01:59:00+00:00,cupang_fish,Apakah akan membawa kembali vibes aura kasih era?,0,0,0,221,https://x.com/cupang_fish/status/1976467469796856025,https://x.com/IndoPopBase/status/1975836321026613482,0
2025-10-08 14:23:57+00:00,katehakayyy,"Emang lg rezekinya si Naykilla bjir tahun² ini, dulu sempet rame karena musically, skrg jadi penyanyi, kerennn!!!",0,0,0,2091,https://x.com/katehakayyy/status/1975930167068594290,https://x.com/IndoPopBase/status/1975836321026613482,0
2025-10-08 10:02:17+00:00,balanceshxxt,ATE,0,0,0,393,https://x.com/balanceshxxt/status/1975864316734882266,https://x.com/IndoPopBase/status/1975836321026613482,0
2025-10-10 02:02:24+00:00,apidfortwitt,Cap kaki 3 vibe for ep cover,0,0,0,139,https://x.com/apidfortwitt/status/1976468325300597047,https://x.com/IndoPopBase/status/1975836321026613482,0
2025-10-08 08:33:45+00:00,ijustlostmymain,Time to lock in,0,0,0,4868,https://x.com/ijustlostmymain/status/1975842037003162075,https://x.com/IndoPopBase/status/1975836321026613482,0
2025-10-08 08:37:07+00:00,febchingREBORN,wait im gagging,0,0,0,903,https://x.com/febchingREBORN/status/1975842885724709304,https://x.com/IndoPopBase/status/1975836321026613482,0
2025-10-08 09:43:49+00:00,matamantra,ended jkflop48,0,0,0,342,https://x.com/matamantra/status/1975859670926643536,https://x.com/IndoPopBase/status/1975836321026613482,0
2025-10-08 13:47:09+00:00,elfvido,jemsii on the beat,0,0,0,350,https://x.com/elfvido/status/1975920905042931982,https://x.com/IndoPopBase/status/1975836321026613482,0
2025-10-08 08:35:16+00:00,your_icecube,"cocok 
@ueautie",0,0,0,726,https://x.com/your_icecube/status/1975842417380348282,https://x.com/IndoPopBase/status/1975836321026613482,0
2025-10-08 08:25:03+00:00,PROSPERDEGREAT,"Finally, Naykilla is hitting us with the heat. Who else is ready to stream this on repeat before October 17?",0,0,0,598,https://x.com/PROSPERDEGREAT/status/1975839846288794038,https://x.com/IndoPopBase/status/1975836321026613482,0
2025-10-08 08:57:25+00:00,nalya,GO GO NAYKILLA,0,0,0,383,https://x.com/nalya/status/1975847992629596517,https://x.com/IndoPopBase/status/1975836321026613482,0
2025-10-08 15:03:36+00:00,B4n6_H4n5,Dan centil pun kembali....,0,0,0,399,https://x.com/B4n6_H4n5/status/1975940146379030593,https://x.com/IndoPopBase/status/1975836321026613482,0
2025-10-08 08:46:28+00:00,akuiyagak,im sat,0,0,0,1319,https://x.com/akuiyagak/status/1975845237655531668,https://x.com/IndoPopBase/status/1975836321026613482,0
2025-10-09 07:11:23+00:00,jsuhmanis,GURLLLL ,0,0,0,155,https://x.com/jsuhmanis/status/1976183694088872133,https://x.com/IndoPopBase/status/1975836321026613482,0
2025-10-08 12:51:35+00:00,alayneesnow,love this cover,0,0,0,497,https://x.com/alayneesnow/status/1975906920809799736,https://x.com/IndoPopBase/status/1975836321026613482,0
2025-10-08 09:12:37+00:00,marshinegun,"LETS GOOO QUEEENNNNN 
@Beribere12",0,0,0,1013,https://x.com/marshinegun/status/1975851818724016552,https://x.com/IndoPopBase/status/1975836321026613482,0
2025-10-08 08:42:31+00:00,abayisasi,SEATEDDDD,0,0,0,737,https://x.com/abayisasi/status/1975844241319555576,https://x.com/IndoPopBase/status/1975836321026613482,0
2025-10-08 08:46:59+00:00,alexademure,I’M SEATEDDDDDDDD,0,0,0,635,https://x.com/alexademure/status/1975845365862809775,https://x.com/IndoPopBase/status/1975836321026613482,0
2025-10-08 09:11:37+00:00,chanif_gaga,ended ramengvrl,0,0,0,665,https://x.com/chanif_gaga/status/1975851563882312139,https://x.com/IndoPopBase/status/1975836321026613482,0
2025-10-08 08:12:21+00:00,0xHarryry,naykilla kill it,0,0,0,850,https://x.com/0xHarryry/status/1975836652863168583,https://x.com/IndoPopBase/status/1975836321026613482,0
2025-10-08 09:01:33+00:00,sk8ergun,Seated,0,0,0,706,https://x.com/sk8ergun/status/1975849031034401189,https://x.com/IndoPopBase/status/1975836321026613482,0
2025-10-08 10:00:58+00:00,jazzandbleus,OH THE COVER ATE DOWNNNN,0,0,0,955,https://x.com/jazzandbleus/status/1975863984529224131,https://x.com/IndoPopBase/status/1975836321026613482,0
2025-10-08 11:29:17+00:00,_denjul,"""Centil Era"" is back??? ",0,0,0,1833,https://x.com/_denjul/status/1975886211396100221,https://x.com/IndoPopBase/status/1975836321026613482,0
2025-10-09 10:39:14+00:00,sara_fajira,My princess ,0,0,0,382,https://x.com/sara_fajira/status/1976236003238215907,https://x.com/IndoPopBase/status/1975836321026613482,0
2025-10-08 11:07:27+00:00,younevahevah,Rrrrrrr Indonesia centilita era is back,0,0,0,1245,https://x.com/younevahevah/status/1975880717898051902,https://x.com/IndoPopBase/status/1975836321026613482,0
2025-10-08 10:45:10+00:00,OynRetriever,"oh my Chapell Roan 
@sakuneck",0,0,0,208,https://x.com/OynRetriever/status/1975875109190783335,https://x.com/IndoPopBase/status/1975836321026613482,0
2025-10-08 09:51:50+00:00,·,ohh the cover,0,0,0,302,https://x.com/myngchacco/status/1975861688206573642,https://x.com/IndoPopBase/status/1975836321026613482,0
2025-10-08 08:47:27+00:00,thisismuwgi,YESS GIRRLL,0,0,0,455,https://x.com/thisismuwgi/status/1975845485509541920,https://x.com/IndoPopBase/status/1975836321026613482,0
2025-10-08 09:13:24+00:00,oomyjod,And we need a new boygroup named Saudadewa,0,0,0,864,https://x.com/oomyjod/status/1975852012668637621,https://x.com/IndoPopBase/status/1975836321026613482,0
2025-10-08 08:20:49+00:00,·,why i’m seated wait,0,0,0,1203,https://x.com/ohhhwhoisyou/status/1975838780952355331,https://x.com/IndoPopBase/status/1975836321026613482,0
2025-10-08 11:00:03+00:00,fariztweet,Ready to end Indonesian Idol alumni!!!,0,0,0,1295,https://x.com/fariztweet/status/1975878852867162396,https://x.com/IndoPopBase/status/1975836321026613482,0
2025-10-08 13:41:18+00:00,·,Letsgaurrrrr,0,0,0,216,https://x.com/T4KUT/status/1975919435576938644,https://x.com/IndoPopBase/status/1975836321026613482,0
2025-10-08 08:54:57+00:00,luovtz,i’m in,0,0,0,279,https://x.com/luovtz/status/1975847372753346908,https://x.com/IndoPopBase/status/1975836321026613482,0
2025-10-08 22:34:11+00:00,sipaling_kull,Jumat skrng dia keluarin lagu baru ya,0,0,0,769,https://x.com/sipaling_kull/status/1976053537709953420,https://x.com/IndoPopBase/status/1975836321026613482,0
2025-10-08 18:36:42+00:00,·,OH WE’RE SAT,0,0,0,113,https://x.com/PlNKAVENUE/status/1975993773277745289,https://x.com/IndoPopBase/status/1975836321026613482,0
2025-10-08 08:43:46+00:00,seafairly,IM SEATED,0,0,0,769,https://x.com/seafairly/status/1975844558153167289,https://x.com/IndoPopBase/status/1975836321026613482,0
2025-10-08 08:11:47+00:00,JAKT1M,recession indicator,0,0,0,1141,https://x.com/JAKT1M/status/1975836508230984006,https://x.com/IndoPopBase/status/1975836321026613482,0
2025-10-08 09:12:03+00:00,bandarantariksa,cant wait,0,0,0,907,https://x.com/bandarantariksa/status/1975851676243509424,https://x.com/IndoPopBase/status/1975836321026613482,0
2025-10-08 07:23:35+00:00,Seung_ha_,"GIGI just dropped their 14th studio album ‘Forever In The Air’! 
Which track are you checking out first?
@grok",1,0,0,1217,https://x.com/Seung_ha_/status/1975824377309745433,https://x.com/IndoPopBase/status/1975823896046936326,1
2025-10-08 07:22:35+00:00,ursteulyNaveen,Legendary band still going strong  can’t wait to dive into this new era ,0,0,0,1162,https://x.com/ursteulyNaveen/status/1975824127677374708,https://x.com/IndoPopBase/status/1975823896046936326,0
2025-10-08 07:50:54+00:00,0xgasm,Legends,0,0,0,1060,https://x.com/0xgasm/status/1975831250750562467,https://x.com/IndoPopBase/status/1975823896046936326,0
2025-10-08 11:12:10+00:00,wisnupu,and Dewa Budjana is 62 years old this year,0,0,0,546,https://x.com/wisnupu/status/1975881901568324033,https://x.com/IndoPopBase/status/1975823896046936326,0
2025-10-08 07:40:11+00:00,shakesapear,this album cover? ate,0,0,0,768,https://x.com/shakesapear/status/1975828555209842812,https://x.com/IndoPopBase/status/1975823896046936326,0
2025-10-08 08:41:09+00:00,wewenk,"But seriously, why aren't their old albums on streaming platforms? Huffft",0,0,0,923,https://x.com/wewenk/status/1975843898208714854,https://x.com/IndoPopBase/status/1975823896046936326,0
2025-10-09 02:57:28+00:00,cupang_fish,"Agak kurang presisi sebelah kiri ya? Jadi personel kurang nengah.
Gua liatnya gatel ",0,0,0,494,https://x.com/cupang_fish/status/1976119795415384445,https://x.com/IndoPopBase/status/1975823896046936326,0
2025-10-08 07:23:10+00:00,wasbrat,end midgita slavepemerintahna for me,0,0,0,783,https://x.com/wasbrat/status/1975824272317948164,https://x.com/IndoPopBase/status/1975823896046936326,0
2025-10-08 08:57:18+00:00,firzafp,"1 dekade kemudian, sbh band rock alternatif definitif 1990an hingga 2000an -> rival DeWA 19 dan Slank, Gigi rilis album baru.",0,0,0,673,https://x.com/firzafp/status/1975847961314918524,https://x.com/IndoPopBase/status/1975823896046936326,0
2025-10-08 09:58:17+00:00,Pawangmagang,Ramean sekarang Gigi,0,0,0,448,https://x.com/Pawangmagang/status/1975863310148116854,https://x.com/IndoPopBase/status/1975823896046936326,0
2025-10-09 16:43:39+00:00,hasbiatmaja,Samot nyentrik abis,0,0,0,78,https://x.com/hasbiatmaja/status/1976327711691079766,https://x.com/IndoPopBase/status/1975823896046936326,0
2025-10-08 11:06:59+00:00,mimpianeh,eating up the trend,0,0,0,490,https://x.com/mimpianeh/status/1975880598435873182,https://x.com/IndoPopBase/status/1975823896046936326,0
2025-10-08 09:17:57+00:00,operaoblivia_,Ended acab baik hati,0,0,0,560,https://x.com/operaoblivia_/status/1975853159026454871,https://x.com/IndoPopBase/status/1975823896046936326,0
2025-10-09 11:23:08+00:00,jkt48baba,the title and cover is IMMACULATE,34,829,0,93593,https://x.com/jkt48baba/status/1976247051785761270,https://x.com/IndoPopBase/status/1975823896046936326,863
2025-10-09 11:04:39+00:00,xNortromx,The artist:                      The Art:,241,3253,0,844254,https://x.com/xNortromx/status/1976242398083588583,https://x.com/IndoPopBase/status/1975823896046936326,3494
2025-10-09 05:36:59+00:00,mhwnk_,the outfit:                      the scent:,166,1540,0,327057,https://x.com/mhwnk_/status/1976159937651933484,https://x.com/IndoPopBase/status/1975823896046936326,1706
2025-10-09 22:56:07+00:00,AlwiJo,,397,1350,0,368897,https://x.com/AlwiJo/status/1976421444893692123,https://x.com/IndoPopBase/status/1975823896046936326,1747
2025-10-08 08:25:43+00:00,3usri,"She actually don’t have Indonesian blood whatsoever. So, she's actually German, Japanese and Chinese, she was just born in Indonesia and she's also Christian, which is in Indonesia the majority there are Muslim.",7,0,0,2034,https://x.com/3usri/status/1975840015126307178,https://x.com/IndoPopBase/status/1975815782849520044,7
2025-10-08 06:56:42+00:00,PROSPERDEGREAT,She started as a popstar 22 years ago and still runs the game. Who else can flex that long without a single “retirement tour”?,1,0,0,2798,https://x.com/PROSPERDEGREAT/status/1975817612463374817,https://x.com/IndoPopBase/status/1975815782849520044,1
2025-10-08 07:08:41+00:00,firzafp,"Asal Mula Agnes Monica naik kelas dari ""artis anak"" ke ""bintang pop"":
- Pernikahan Dini sbg. asal mula
- Kontrak AQM pada 2003 -> booming",3,4,0,2728,https://x.com/firzafp/status/1975820627400614320,https://x.com/IndoPopBase/status/1975815782849520044,7
2025-10-08 07:01:05+00:00,AgnezMoVortex,22 years later and she’s still eating every stage alive  the definition of longevity fr,0,6,0,2522,https://x.com/AgnezMoVortex/status/1975818717847298192,https://x.com/IndoPopBase/status/1975815782849520044,6
2025-10-08 06:56:26+00:00,PROSPERDEGREAT,"22 years later and still stealing the spotlight, who else has that kind of glow-up energy?",0,1,0,1884,https://x.com/PROSPERDEGREAT/status/1975817547867181370,https://x.com/IndoPopBase/status/1975815782849520044,1
2025-10-08 06:51:13+00:00,Seung_ha_,"Can you believe it’s been 22 years since Agnes Monica began her journey as a popstar?  What’s your favorite era or song from her career? 
@grok",0,2,0,921,https://x.com/Seung_ha_/status/1975816232999002548,https://x.com/IndoPopBase/status/1975815782849520044,2
2025-10-08 06:52:08+00:00,ursteulyNaveen,"22 years of talent, evolution, and unstoppable energy  Agnes truly paved the way ",0,2,0,1435,https://x.com/ursteulyNaveen/status/1975816465489272973,https://x.com/IndoPopBase/status/1975815782849520044,2
2025-10-08 07:02:38+00:00,NotSeblakEater,"shouldn't be agnezmo, cause everyone miss agnes monica so much",0,2,0,1485,https://x.com/NotSeblakEater/status/1975819105753337911,https://x.com/IndoPopBase/status/1975815782849520044,2
2025-10-08 09:44:22+00:00,univrs__,More like 22000 years ago when dinosaurs were alive,1,0,0,1061,https://x.com/univrs__/status/1975859808785015245,https://x.com/IndoPopBase/status/1975815782849520044,1
2025-10-08 07:10:14+00:00,FabHakim,Sebelum berseteru,0,0,0,2305,https://x.com/FabHakim/status/1975821018800529692,https://x.com/IndoPopBase/status/1975815782849520044,0
2025-10-08 12:24:03+00:00,Thecarter7771,Satu2nya pop star yang takut konser tunggal,1,0,0,668,https://x.com/Thecarter7771/status/1975899992910086201,https://x.com/IndoPopBase/status/1975815782849520044,1
2025-10-09 02:34:51+00:00,culturalizion,Her peak era,0,0,0,89,https://x.com/culturalizion/status/1976114105057681757,https://x.com/IndoPopBase/status/1975815782849520044,0
2025-10-08 13:12:34+00:00,syifayuu,Cantikkkk,0,0,0,303,https://x.com/syifayuu/status/1975912203086885032,https://x.com/IndoPopBase/status/1975815782849520044,0
2025-10-08 06:57:30+00:00,Leonaderune,hagnez mo can only wish,0,0,0,751,https://x.com/Leonaderune/status/1975817812905238606,https://x.com/IndoPopBase/status/1975815782849520044,0
2025-10-09 03:59:04+00:00,ssvnnxx,WE NEED YOU BACK,0,0,0,74,https://x.com/ssvnnxx/status/1976135298401915272,https://x.com/IndoPopBase/status/1975815782849520044,0
2025-10-08 08:47:01+00:00,Alexx1992xx,Mother,0,0,0,465,https://x.com/Alexx1992xx/status/1975845375056757178,https://x.com/IndoPopBase/status/1975815782849520044,0
2025-10-08 15:26:38+00:00,A1nz0oalGown07,And flop,0,0,0,144,https://x.com/A1nz0oalGown07/status/1975945940512206950,https://x.com/IndoPopBase/status/1975815782849520044,0
2025-10-08 14:24:01+00:00,introkamvret,i miss Cici Agnes,0,0,0,260,https://x.com/introkamvret/status/1975930183862673695,https://x.com/IndoPopBase/status/1975815782849520044,0
2025-10-08 11:52:27+00:00,younevahevah,Heh mirip Yoonchae,0,0,0,314,https://x.com/younevahevah/status/1975892040287453585,https://x.com/IndoPopBase/status/1975815782849520044,0
2025-10-08 16:44:29+00:00,diandhany21,Definisi absolut seorang it girl pada jamannya,0,0,0,180,https://x.com/diandhany21/status/1975965535088300450,https://x.com/IndoPopBase/status/1975815782849520044,0
2025-10-10 04:59:18+00:00,AsWindAndFire,Now she's still in America acting all gangsta... Jesus it's been a good decade...,0,0,0,3,https://x.com/AsWindAndFire/status/1976512842053374080,https://x.com/IndoPopBase/status/1975815782849520044,0
2025-10-08 11:29:39+00:00,achiavellian,ended Agnez Mo,0,0,0,290,https://x.com/achiavellian/status/1975886304568373401,https://x.com/IndoPopBase/status/1975815782849520044,0
2025-10-08 08:08:50+00:00,Phoebe_woopsie,and lyodra? still an embrio,0,0,0,1327,https://x.com/Phoebe_woopsie/status/1975835764979343471,https://x.com/IndoPopBase/status/1975815782849520044,0
2025-10-08 23:09:54+00:00,aswan21w,masih energik,0,0,0,61,https://x.com/aswan21w/status/1976062527030296784,https://x.com/IndoPopBase/status/1975815782849520044,0
2025-10-08 06:57:58+00:00,jackthegon,Stunn agnes monika,0,1,0,465,https://x.com/jackthegon/status/1975817933332111864,https://x.com/IndoPopBase/status/1975815782849520044,1
2025-10-08 12:27:12+00:00,ridwan_syam12,"Agnez Mo Sudah Melalui 3 Fase menuju 4 

1. 1992 s/d 2002 (Bintang Cilik)
2. 2002 s/d 2012 (Pop Star)
3. 2012 s/d 2022 (Go International)
4. 2022 s/d 2032 (Bintang International) Aamiin...",0,2,0,207,https://x.com/ridwan_syam12/status/1975900784966656264,https://x.com/IndoPopBase/status/1975815782849520044,2
2025-10-08 13:46:58+00:00,Razziizzar,She really tired hard to be A Beyonce omg,0,0,0,126,https://x.com/Razziizzar/status/1975920860948304376,https://x.com/IndoPopBase/status/1975815782849520044,0
2025-10-08 05:44:25+00:00,sorakluka,Masih tidak bisa melupakan laki-laki yang sangat-sangat super duper mega attractive ini.,2,22,0,2534,https://x.com/sorakluka/status/1975799423834988702,https://x.com/IndoPopBase/status/1975730125808504964,24
2025-10-08 01:52:59+00:00,BearryBlush,penulis filmnya henricus pria yang kena kasus pelecehan seksual masih bekerja di industri perfilman,2,6,0,4775,https://x.com/BearryBlush/status/1975741181306012023,https://x.com/IndoPopBase/status/1975730125808504964,8
2025-10-08 01:46:29+00:00,HiraAmayu,"Aku gak akan lupakan manusia anjing ini karena aktingnya bagus makanya aku masukkin ""bounty list"" wkwkwk",1,2,0,3338,https://x.com/HiraAmayu/status/1975739542654361744,https://x.com/IndoPopBase/status/1975730125808504964,3
2025-10-08 01:11:00+00:00,PROSPERDEGREAT,Hard to believe it’s been 4 years. That film hit like a gut punch,0,0,0,2073,https://x.com/PROSPERDEGREAT/status/1975730612976918791,https://x.com/IndoPopBase/status/1975730125808504964,0
2025-10-08 01:13:53+00:00,0xgasm,never seen this before,0,0,0,1637,https://x.com/0xgasm/status/1975731341682745389,https://x.com/IndoPopBase/status/1975730125808504964,0
2025-10-08 04:19:00+00:00,haikarrll85,"Well, filmnya padahal bagus, menceritakan tentang sexual harrasment, apalagi di film ini juga, membuktikan kalau sexual harrasment bisa terjadi terhadap laki-laki. 

Cuma sayang, kenapa salah 
satu crew-nya aja kek tai..!!",1,3,0,2612,https://x.com/haikarrll85/status/1975777926219170131,https://x.com/IndoPopBase/status/1975730125808504964,4
2025-10-08 01:10:34+00:00,PROSPERDEGREAT,Still one of the boldest Indonesian films to hit streaming. Wild how fresh it still feels,0,0,0,2780,https://x.com/PROSPERDEGREAT/status/1975730507246936454,https://x.com/IndoPopBase/status/1975730125808504964,0
2025-10-08 01:10:23+00:00,Seung_ha_,"How did ‘Penyalin Cahaya’ change the landscape of Indonesian cinema when it premiered 4 years ago today? 
@grok",1,0,0,1233,https://x.com/Seung_ha_/status/1975730457456300110,https://x.com/IndoPopBase/status/1975730125808504964,1
2025-10-08 06:55:57+00:00,keboydayaan,"Henricus Pria udah cabul masih pengen menguasai narasi pula. Terus kawannya dokem aja. Kalo gak ada tekanan paling doi selon aja.

Spiritually israeli film. Cuih!",2,0,0,1238,https://x.com/keboydayaan/status/1975817424349151317,https://x.com/IndoPopBase/status/1975730125808504964,2
2025-10-08 05:18:33+00:00,yhoxcendolz,Masih terngiang ngiang adegan foggingnya. Penuh simbolisme,1,0,0,759,https://x.com/yhoxcendolz/status/1975792912186347685,https://x.com/IndoPopBase/status/1975730125808504964,1
2025-10-08 02:24:35+00:00,fdmncfdmnc,Peak jerome kurnia sebelum film film kelas b menyerang,0,2,0,2528,https://x.com/fdmncfdmnc/status/1975749130862445050,https://x.com/IndoPopBase/status/1975730125808504964,2
2025-10-08 01:34:26+00:00,salo_120hari,Shame on you yg ga nonton panyalin cahaya di layar lebar!!! (Begitulah kata akun gede yg ngeviralin Film Wahyu juga),0,0,0,2871,https://x.com/salo_120hari/status/1975736510302626119,https://x.com/IndoPopBase/status/1975730125808504964,0
2025-10-08 03:48:14+00:00,·,"> penyalin cahaya rilis
> bang gopay kena kasus",0,0,0,1199,https://x.com/imseeksicksix/status/1975770185706660238,https://x.com/IndoPopBase/status/1975730125808504964,0
2025-10-08 02:02:05+00:00,aliyyaraa,Pertama kali liat shenina di film ini ,0,0,0,1199,https://x.com/aliyyaraa/status/1975743469764194368,https://x.com/IndoPopBase/status/1975730125808504964,0
2025-10-08 07:17:04+00:00,olvinnnnn,Film bagus ini,0,0,0,288,https://x.com/olvinnnnn/status/1975822740365156563,https://x.com/IndoPopBase/status/1975730125808504964,0
2025-10-08 07:57:21+00:00,wndptrnt,Still my fav indo movie,0,0,0,259,https://x.com/wndptrnt/status/1975832875468792149,https://x.com/IndoPopBase/status/1975730125808504964,0
2025-10-08 01:35:35+00:00,tembakansalvo,peak movie,0,0,0,1016,https://x.com/tembakansalvo/status/1975736799705403601,https://x.com/IndoPopBase/status/1975730125808504964,0
2025-10-08 03:54:33+00:00,soberswordsman,masterpiece,0,0,0,488,https://x.com/soberswordsman/status/1975771772114071561,https://x.com/IndoPopBase/status/1975730125808504964,0
2025-10-08 02:54:18+00:00,jak56palmerah,Best movie tp perna ada kasus ya sutradara atau penulisnya itu lupa,0,0,0,908,https://x.com/jak56palmerah/status/1975756610195657173,https://x.com/IndoPopBase/status/1975730125808504964,0
2025-10-09 02:34:17+00:00,culturalizion,THIS MOVIE SLAP,0,0,0,43,https://x.com/culturalizion/status/1976113962568778119,https://x.com/IndoPopBase/status/1975730125808504964,0
2025-10-08 01:13:21+00:00,onikatanyajawab,deserve oscar btw,0,0,0,1339,https://x.com/onikatanyajawab/status/1975731207683121219,https://x.com/IndoPopBase/status/1975730125808504964,0
2025-10-08 02:34:59+00:00,snshncmdclb,"Hari ini rilis di event BIFF, nah tayang di Netflix 13 Januari 2022",0,0,0,2159,https://x.com/snshncmdclb/status/1975751751853658463,https://x.com/IndoPopBase/status/1975730125808504964,0
2025-10-08 08:27:11+00:00,busdamri_,Whaa,0,0,0,247,https://x.com/busdamri_/status/1975840382836744577,https://x.com/IndoPopBase/status/1975730125808504964,0
2025-10-08 09:54:01+00:00,salsabbb7,chicco kurniawan kece parah di film ini,0,0,0,331,https://x.com/salsabbb7/status/1975862234992812520,https://x.com/IndoPopBase/status/1975730125808504964,0
2025-10-08 15:18:37+00:00,xvchive,bagus bgt filmnyaa,0,0,0,156,https://x.com/xvchive/status/1975943922783551885,https://x.com/IndoPopBase/status/1975730125808504964,0
2025-10-08 07:34:09+00:00,wijayaromi_,Film bagusss,0,0,0,286,https://x.com/wijayaromi_/status/1975827037387726948,https://x.com/IndoPopBase/status/1975730125808504964,0
2025-10-08 02:40:03+00:00,hafhifhuf,"Menguras, Menutup, Mengubur",0,0,0,768,https://x.com/hafhifhuf/status/1975753024732590564,https://x.com/IndoPopBase/status/1975730125808504964,0
2025-10-08 01:37:50+00:00,avrilazrim,pilem keren iki ,0,0,0,756,https://x.com/avrilazrim/status/1975737368406860290,https://x.com/IndoPopBase/status/1975730125808504964,0
2025-10-08 02:51:00+00:00,Love_3children,"""4 years of 'Penyalin Cahaya'! Such a powerful and thought-provoking film that resonates deeply. Still remember the impactful story and performances. Congratulations on its anniversary",0,0,0,458,https://x.com/Love_3children/status/1975755778553499776,https://x.com/IndoPopBase/status/1975730125808504964,0
2025-10-08 00:52:29+00:00,hrgila,Suaranya pas-pasan kalo live.,3,0,0,839,https://x.com/hrgila/status/1975725953855987790,https://x.com/IndoPopBase/status/1975724946543550817,3
2025-10-08 04:21:41+00:00,johanalfiant,dari dulu gw sllu gk tau cara manggil nama dia kyk mna,2,0,0,677,https://x.com/johanalfiant/status/1975778602907279613,https://x.com/IndoPopBase/status/1975724946543550817,2
2025-10-08 01:53:30+00:00,3usri,cara baca namanya gimana?,1,0,0,584,https://x.com/3usri/status/1975741310045987118,https://x.com/IndoPopBase/status/1975724946543550817,1
2025-10-08 01:57:21+00:00,shakesapear,stage name be like idgaf lmao,1,0,0,1244,https://x.com/shakesapear/status/1975742279999725690,https://x.com/IndoPopBase/status/1975724946543550817,1
2025-10-08 04:24:03+00:00,CostelloBryann,"Hahaha iya, gue juga mikir ‘loh ada kuyang lewat’  Idgitaf Kuyang.",0,0,0,89,https://x.com/CostelloBryann/status/1975779198360047976,https://x.com/IndoPopBase/status/1975724946543550817,0
2025-10-08 04:23:41+00:00,CherieSisiel,"Sumpah, lagu ini ngajarin pentingnya jeda  Idgitaf Kuyang.",0,0,0,84,https://x.com/CherieSisiel/status/1975779104487321661,https://x.com/IndoPopBase/status/1975724946543550817,0
2025-10-08 13:19:45+00:00,T3RIP4NG,Visinema wrote this,0,0,0,85,https://x.com/T3RIP4NG/status/1975914010790019375,https://x.com/IndoPopBase/status/1975724946543550817,0
2025-10-08 06:37:51+00:00,lPosumA0209,"Lagu Baru Idgitaf :
Sedia Payung Sebelum Hujan
Sedia Aku Sebelum Hujan",0,0,0,512,https://x.com/lPosumA0209/status/1975812869309796772,https://x.com/IndoPopBase/status/1975724946543550817,0
2025-10-08 00:51:00+00:00,PROSPERDEGREAT,Idgitaf never misses. Her songs always feel like getting hit by feelings you thought you dodged,0,0,0,942,https://x.com/PROSPERDEGREAT/status/1975725582001246641,https://x.com/IndoPopBase/status/1975724946543550817,0
2025-10-08 04:24:30+00:00,Girbdanke,"Pas reff tuh auto halu, tapi tetep pengen senyum  Idgitaf Kuyang.",0,0,0,79,https://x.com/Girbdanke/status/1975779309953732960,https://x.com/IndoPopBase/status/1975724946543550817,0
2025-10-08 01:05:53+00:00,Phoebe_woopsie,i thought she's my twin davina karamoy,0,0,0,585,https://x.com/Phoebe_woopsie/status/1975729324973326770,https://x.com/IndoPopBase/status/1975724946543550817,0
2025-10-08 04:23:17+00:00,JasonMedinith,"Wkwk iya, kuping auto fokus, refleks siapin senter  Idgitaf Kuyang.",0,0,0,86,https://x.com/JasonMedinith/status/1975779005484965984,https://x.com/IndoPopBase/status/1975724946543550817,0
2025-10-08 01:46:57+00:00,roweeasley,"sedia aqua sebelum hujan

aqu, a?",0,0,0,918,https://x.com/roweeasley/status/1975739661399302216,https://x.com/IndoPopBase/status/1975724946543550817,0
2025-10-08 02:21:55+00:00,bukanverdonk,"straight to the playlist 
cocok didengarkan untuk yg sudah mulai lelah mendengarkan ""kalau adaaaa""",0,0,0,626,https://x.com/bukanverdonk/status/1975748461094936938,https://x.com/IndoPopBase/status/1975724946543550817,0
2025-10-08 02:33:38+00:00,radian1990,Swifties hates her,0,0,0,278,https://x.com/radian1990/status/1975751409950662772,https://x.com/IndoPopBase/status/1975724946543550817,0
2025-10-08 04:31:20+00:00,dimaswaraha,Lucu yoooh,0,0,0,210,https://x.com/dimaswaraha/status/1975781029760934072,https://x.com/IndoPopBase/status/1975724946543550817,0
2025-10-08 03:10:12+00:00,ursteulyNaveen,Beautiful title  can’t wait to hear what emotion she’s captured this time ,0,0,0,224,https://x.com/ursteulyNaveen/status/1975760610966262143,https://x.com/IndoPopBase/status/1975724946543550817,0
2025-10-08 11:20:59+00:00,younevahevah,Idgitaf's outfit is my outfit in rich,0,0,0,130,https://x.com/younevahevah/status/1975884120728445381,https://x.com/IndoPopBase/status/1975724946543550817,0
2025-10-08 04:59:15+00:00,kaffeamericano,"Her new era, I’m in! ",0,0,0,172,https://x.com/kaffeamericano/status/1975788054108676457,https://x.com/IndoPopBase/status/1975724946543550817,0
2025-10-08 16:51:34+00:00,arsipsinuy,Ini baca nama beliau gimana sii?,0,0,0,82,https://x.com/arsipsinuy/status/1975967314223956216,https://x.com/IndoPopBase/status/1975724946543550817,0
2025-10-08 04:30:01+00:00,0xHarryry,haha susah banget baca namanya Idgaf,0,0,0,302,https://x.com/0xHarryry/status/1975780697949499673,https://x.com/IndoPopBase/status/1975724946543550817,0
2025-10-08 00:51:27+00:00,PROSPERDEGREAT,She never misses. Bet this one’s gonna ruin everyone’s playlist order in the best way,0,0,0,621,https://x.com/PROSPERDEGREAT/status/1975725695612633412,https://x.com/IndoPopBase/status/1975724946543550817,0
2025-10-08 01:01:01+00:00,0xgasm,semoga suka,0,0,0,381,https://x.com/0xgasm/status/1975728100903412190,https://x.com/IndoPopBase/status/1975724946543550817,0
2025-10-08 07:10:06+00:00,Leonaderune,idgaf abt idgitaf,0,0,0,358,https://x.com/Leonaderune/status/1975820984973464064,https://x.com/IndoPopBase/status/1975724946543550817,0
2025-10-08 08:51:29+00:00,fionapie12332,That lola young….,0,1,0,87,https://x.com/fionapie12332/status/1975846500157763923,https://x.com/IndoPopBase/status/1975724946543550817,1
2025-10-08 00:50:04+00:00,CitaStarstories,lagunya tentang payung?,0,0,0,693,https://x.com/CitaStarstories/status/1975725345744851223,https://x.com/IndoPopBase/status/1975724946543550817,0
2025-10-08 03:13:57+00:00,ursteulyNaveen,Judulnya indah banget  nggak sabar dengerin emosi yang dibawa Idgitaf kali ini ,0,0,0,327,https://x.com/ursteulyNaveen/status/1975761555074732135,https://x.com/IndoPopBase/status/1975724946543550817,0
2025-10-08 00:49:49+00:00,Seung_ha_,"What do you think of Idgitaf’s latest single ‘Sedia Aku Sebelum Hujan’ her most heartfelt release yet? 
@grok",1,0,0,403,https://x.com/Seung_ha_/status/1975725285170614494,https://x.com/IndoPopBase/status/1975724946543550817,1
2025-10-08 03:56:22+00:00,weyezblod,and IDGAF,0,0,0,633,https://x.com/weyezblod/status/1975772231793098834,https://x.com/IndoPopBase/status/1975724946543550817,0
2025-10-08 01:10:31+00:00,membayangkeun,Idgaf ahh name,0,0,0,387,https://x.com/membayangkeun/status/1975730491048468848,https://x.com/IndoPopBase/status/1975724946543550817,0
2025-10-08 06:21:53+00:00,akhirpekansans,Biar samaan payungnya kak,0,0,0,77,https://x.com/akhirpekansans/status/1975808852613616039,https://x.com/IndoPopBase/status/1975724946543550817,0
2025-10-08 04:24:54+00:00,fiorenziaay,"Wkwk iya, gue juga replay beberapa kali, takut salah denger  Idgitaf Kuyang.",0,0,0,86,https://x.com/fiorenziaay/status/1975779410600247784,https://x.com/IndoPopBase/status/1975724946543550817,0
2025-10-08 04:15:50+00:00,jelal_mystogan,,0,0,0,86,https://x.com/jelal_mystogan/status/1975777128567480788,https://x.com/IndoPopBase/status/1975724946543550817,0
2025-10-08 07:11:00+00:00,ramasarigadun,Hmmm..anu,0,0,0,132,https://x.com/ramasarigadun/status/1975821211499438510,https://x.com/IndoPopBase/status/1975724946543550817,0
2025-10-06 07:43:50+00:00,starmahisa,,1,4,0,1641,https://x.com/starmahisa/status/1975104697863422125,https://x.com/IndoPopBase/status/1975103213763490249,5
2025-10-06 07:39:39+00:00,Seung_ha_,"Can you believe it’s been 29 years since the first episode of Keluarga Cemara aired on RCTI? 
@grok",1,0,0,586,https://x.com/Seung_ha_/status/1975103645785129161,https://x.com/IndoPopBase/status/1975103213763490249,1
2025-10-06 07:42:26+00:00,PROSPERDEGREAT,"29 years later, and Abah is still the blueprint for Indonesian dads",0,0,0,1618,https://x.com/PROSPERDEGREAT/status/1975104347169329220,https://x.com/IndoPopBase/status/1975103213763490249,0
2025-10-06 07:52:14+00:00,bobby001_eth,29 years already? Feels like yesterday everyone was glued to the TV watching ‘Keluarga Cemara’. Timeless classic vibes.,0,0,0,894,https://x.com/bobby001_eth/status/1975106810983088292,https://x.com/IndoPopBase/status/1975103213763490249,0
2025-10-06 07:46:48+00:00,ursteulyNaveen,Effortless elegance and vocals that never miss ,0,0,0,613,https://x.com/ursteulyNaveen/status/1975105445149995449,https://x.com/IndoPopBase/status/1975103213763490249,0
2025-10-06 07:42:06+00:00,PROSPERDEGREAT,Wild that ‘Keluarga Cemara’ is almost 30 and still hits harder than half the family dramas on TV today,0,0,0,1324,https://x.com/PROSPERDEGREAT/status/1975104260473049109,https://x.com/IndoPopBase/status/1975103213763490249,0
2025-10-06 07:40:14+00:00,ursteulyNaveen,What a classic! Happy 29th anniversary! ,0,0,0,721,https://x.com/ursteulyNaveen/status/1975103794280301022,https://x.com/IndoPopBase/status/1975103213763490249,0
2025-10-06 07:48:38+00:00,pncsyh,"Itu yang main jadi emak, ibunya dante skipberat, yang kemarinan diminta foto bareng Iqbaal",1,0,0,1567,https://x.com/pncsyh/status/1975105905202172255,https://x.com/IndoPopBase/status/1975103213763490249,1
2025-10-06 07:51:47+00:00,bobby001_eth,"Wow, 29 years already? Some shows just never lose their charm, classic vibes all the way.",0,0,0,585,https://x.com/bobby001_eth/status/1975106701356593227,https://x.com/IndoPopBase/status/1975103213763490249,0
2025-10-06 10:12:59+00:00,MAIL99FIGHTER,"""matahari membagi rata sinarnyaa 
air laut membagi adil asinnyaa""",1,1,0,1000,https://x.com/MAIL99FIGHTER/status/1975142235512643960,https://x.com/IndoPopBase/status/1975103213763490249,2
2025-10-06 08:13:55+00:00,MarkNeu82295077,Beautiful series. One of the best ever.,0,0,0,314,https://x.com/MarkNeu82295077/status/1975112268355629392,https://x.com/IndoPopBase/status/1975103213763490249,0
2025-10-06 09:47:51+00:00,hannahbabibaker,,0,0,0,276,https://x.com/hannahbabibaker/status/1975135907734040878,https://x.com/IndoPopBase/status/1975103213763490249,0
2025-10-06 08:07:54+00:00,rekaanbelaka,eps memorable ketika becak abah ikut 17an dihias jadi helikopter,0,0,0,917,https://x.com/rekaanbelaka/status/1975110755461828961,https://x.com/IndoPopBase/status/1975103213763490249,0
2025-10-06 09:27:03+00:00,zenday4hat,Gaada lagi series2 berkelas kek gini lg yaaa,0,0,0,389,https://x.com/zenday4hat/status/1975130676069646759,https://x.com/IndoPopBase/status/1975103213763490249,0
2025-10-06 08:09:39+00:00,GhhopesHi,I was just an innocent kid when this aired in RCTI,0,0,0,435,https://x.com/GhhopesHi/status/1975111197604327666,https://x.com/IndoPopBase/status/1975103213763490249,0
2025-10-06 14:08:50+00:00,MarkNeu82295077,America had 'The Waltons'; Indonesia had 'Keluarga Cemara'.,0,0,0,271,https://x.com/MarkNeu82295077/status/1975201587573469274,https://x.com/IndoPopBase/status/1975103213763490249,0
2025-10-06 08:58:49+00:00,fridhodamora,Kenapa sekarang replies sectionnya banyak bot ya……,0,0,0,255,https://x.com/fridhodamora/status/1975123569886794187,https://x.com/IndoPopBase/status/1975103213763490249,0
2025-10-06 12:40:25+00:00,DaniManchild24,saking miskinnya. emaknya cerai sama abah dan Abah kawin lagi sama Novia Kolopaking,0,1,0,501,https://x.com/DaniManchild24/status/1975179337809768741,https://x.com/IndoPopBase/status/1975103213763490249,1
2025-10-06 09:02:27+00:00,yhoxcendolz,Peak cinema family drama,0,0,0,231,https://x.com/yhoxcendolz/status/1975124484802912262,https://x.com/IndoPopBase/status/1975103213763490249,0
2025-10-07 05:31:49+00:00,valangdika,Ada juga sinetron yg sama tapi tayang tiap jam 6 sore anmanya apa ya?,0,0,0,65,https://x.com/valangdika/status/1975433865461440809,https://x.com/IndoPopBase/status/1975103213763490249,0
2025-10-06 09:28:35+00:00,pak_oke1,Alam elok bercanda...,0,0,0,320,https://x.com/pak_oke1/status/1975131061261935088,https://x.com/IndoPopBase/status/1975103213763490249,0
2025-10-06 08:41:04+00:00,loenpiambaklien,and Keluarga Cendana?,0,0,0,804,https://x.com/loenpiambaklien/status/1975119101564735633,https://x.com/IndoPopBase/status/1975103213763490249,0
2025-10-06 11:04:06+00:00,Bembieno,"Season 1, tiap denger soundtracknya ada rasa sedih. Krn mengingatkan masa2 kecil nonton sinetron inu ketika masih tayang tiap hr minggu siang. 

Season 2 nya gw udh agak gedean dan tayang senin-jumat siang hari jam 2 kl g salah.",0,0,0,641,https://x.com/Bembieno/status/1975155098402824582,https://x.com/IndoPopBase/status/1975103213763490249,0
2025-10-06 07:48:33+00:00,duarebudah,Omg Zara Adhisty the old hag you are…,0,0,0,360,https://x.com/duarebudah/status/1975105887128940606,https://x.com/IndoPopBase/status/1975103213763490249,0
2025-10-06 08:01:20+00:00,qalam_reza,"Pertama Tau makanan opak dari sinetron ini
Terima kasih bang Arswendo Atmowiloto atas karya tentang keluarga harmonis ini",0,0,0,205,https://x.com/qalam_reza/status/1975109102847377759,https://x.com/IndoPopBase/status/1975103213763490249,0
2025-10-06 09:16:18+00:00,Love_3children,"""Nostalgia! 'Keluarga Cemara' is a classic! Still remember watching it on RCTI. Wishing continued success to the cast and crew!",0,0,0,158,https://x.com/Love_3children/status/1975127968273060135,https://x.com/IndoPopBase/status/1975103213763490249,0
2025-10-06 04:57:22+00:00,sugar_6378,"40 tahun gila, gak kliatan bangetttt. Awet muda kak andien kayak vampir",2,1,0,6005,https://x.com/sugar_6378/status/1975062805708742846,https://x.com/IndoPopBase/status/1975062358600056852,3
2025-10-06 04:59:56+00:00,·,,0,5,0,4886,https://x.com/kisya/status/1975063453380518392,https://x.com/IndoPopBase/status/1975062358600056852,5
2025-10-06 05:16:39+00:00,bobby001_eth,"Andien really owns the stage, who knew festival vibes could hit that hard?",0,0,0,2531,https://x.com/bobby001_eth/status/1975067660833673647,https://x.com/IndoPopBase/status/1975062358600056852,0
2025-10-06 05:45:05+00:00,freakihooman,inspo by zara larsson kh ini,0,0,0,2372,https://x.com/freakihooman/status/1975074812222722349,https://x.com/IndoPopBase/status/1975062358600056852,0
2025-10-06 08:08:52+00:00,saltybabyyyyy,gemec bgttt,0,0,0,2023,https://x.com/saltybabyyyyy/status/1975110998714708007,https://x.com/IndoPopBase/status/1975062358600056852,0
2025-10-06 05:16:28+00:00,bobby001_eth,"Andien really knows how to own a stage, who else left the festival thinking about that performance nonstop?",0,0,0,3777,https://x.com/bobby001_eth/status/1975067611072442645,https://x.com/IndoPopBase/status/1975062358600056852,0
2025-10-06 04:57:31+00:00,bareda,Bawa tamagotchi,0,0,0,2366,https://x.com/bareda/status/1975062841960071341,https://x.com/IndoPopBase/status/1975062358600056852,0
2025-10-06 09:06:39+00:00,cyanosist,,0,0,0,1345,https://x.com/cyanosist/status/1975125540576338357,https://x.com/IndoPopBase/status/1975062358600056852,0
2025-10-06 05:30:42+00:00,Seung_ha_,Andien lights up the stage at #SynchronizeFest with her timeless charm and powerful vocals. ,0,0,0,998,https://x.com/Seung_ha_/status/1975071193201008676,https://x.com/IndoPopBase/status/1975062358600056852,0
2025-10-06 04:56:15+00:00,ursteulyNaveen,Effortless elegance and vocals that never miss ,0,0,0,1635,https://x.com/ursteulyNaveen/status/1975062524472311979,https://x.com/IndoPopBase/status/1975062358600056852,0
2025-10-06 05:52:59+00:00,harlessance,Zara nachos,2,1,0,2667,https://x.com/harlessance/status/1975076801543352722,https://x.com/IndoPopBase/status/1975062358600056852,3
2025-10-06 13:57:59+00:00,kirarance,pas sama Diskoria juga bajunya cantik banget!,0,0,0,465,https://x.com/kirarance/status/1975198858490806485,https://x.com/IndoPopBase/status/1975062358600056852,0
2025-10-06 07:58:17+00:00,BANANAKAKUMEl,she’s about to sing a neverending midnight sun,0,0,0,531,https://x.com/BANANAKAKUMEl/status/1975108335121863035,https://x.com/IndoPopBase/status/1975062358600056852,0
2025-10-07 06:06:12+00:00,hopeforsafety,"The real ""put me anything, i can make it fabulous"" kinda person",0,0,0,52,https://x.com/hopeforsafety/status/1975442515676500380,https://x.com/IndoPopBase/status/1975062358600056852,0
2025-10-06 16:11:29+00:00,olraitbro,she's about to ngajorowok A NEVER ENDING MIDNIGHT SUUUUUUUUUN,0,0,0,324,https://x.com/olraitbro/status/1975232453557305405,https://x.com/IndoPopBase/status/1975062358600056852,0
2025-10-06 08:16:36+00:00,PuspitaKamil,"Ini mah 
@alwansyaah",1,0,0,130,https://x.com/PuspitaKamil/status/1975112943051448356,https://x.com/IndoPopBase/status/1975062358600056852,1
2025-10-06 05:28:15+00:00,ultrachezzzzze,anjay kek zara larsson,0,0,0,364,https://x.com/ultrachezzzzze/status/1975070576403419634,https://x.com/IndoPopBase/status/1975062358600056852,0
2025-10-06 07:19:56+00:00,jaegerawr,zara larsson the trendsetter yup,0,0,0,473,https://x.com/jaegerawr/status/1975098683093049598,https://x.com/IndoPopBase/status/1975062358600056852,0
2025-10-06 05:17:30+00:00,wobowobow,Kaya penjual mainan yg gacha narik benang depan SD wkwk,0,0,0,2596,https://x.com/wobowobow/status/1975067871891087830,https://x.com/IndoPopBase/status/1975062358600056852,0
2025-10-07 02:05:10+00:00,tikaprananda,It looks like pastel colors were alive,0,0,0,54,https://x.com/tikaprananda/status/1975381856708403442,https://x.com/IndoPopBase/status/1975062358600056852,0
2025-10-06 07:58:34+00:00,bslpst,Kaya masih umur 25an,0,0,0,237,https://x.com/bslpst/status/1975108407561711668,https://x.com/IndoPopBase/status/1975062358600056852,0
2025-10-06 12:34:47+00:00,Rosalinaaip,Lucuuu bangettttt ky temanya ky rasa stroberry milky gituuu,0,0,0,243,https://x.com/Rosalinaaip/status/1975177920256831831,https://x.com/IndoPopBase/status/1975062358600056852,0
2025-10-06 05:52:44+00:00,tapayy_lottok,ada lip balm juga hahaha,0,0,0,748,https://x.com/tapayy_lottok/status/1975076740507766879,https://x.com/IndoPopBase/status/1975062358600056852,0
2025-10-06 05:31:02+00:00,sunshinetally4,oh is she going to cover midnight sun,0,0,0,936,https://x.com/sunshinetally4/status/1975071277816873454,https://x.com/IndoPopBase/status/1975062358600056852,0
2025-10-06 06:00:08+00:00,CorenswetsSlut,Oh GODien  suddenly im into gurl...,0,0,0,696,https://x.com/CorenswetsSlut/status/1975078602522890728,https://x.com/IndoPopBase/status/1975062358600056852,0
2025-10-06 09:35:02+00:00,sunfloempire,lucuuuu dan gemasss,0,0,0,131,https://x.com/sunfloempire/status/1975132681206981071,https://x.com/IndoPopBase/status/1975062358600056852,0
2025-10-06 14:14:05+00:00,iSanChoi,Zara Larsson tersenyum melihat ini,0,0,0,76,https://x.com/iSanChoi/status/1975202906333999419,https://x.com/IndoPopBase/status/1975062358600056852,0
2025-10-06 15:52:48+00:00,Asspasiaa,Ril kalcer,0,0,0,98,https://x.com/Asspasiaa/status/1975227750316482652,https://x.com/IndoPopBase/status/1975062358600056852,0
2025-10-07 05:16:04+00:00,semanisracun,Mba andien kamu gak tua-tua,0,0,0,73,https://x.com/semanisracun/status/1975429900963352924,https://x.com/IndoPopBase/status/1975062358600056852,0
2025-10-06 14:22:35+00:00,Uretop1,Gen z,0,0,0,55,https://x.com/Uretop1/status/1975205045898784890,https://x.com/IndoPopBase/status/1975062358600056852,0
2025-10-06 04:58:01+00:00,fojiiq,Okay Rhode,0,0,0,618,https://x.com/fojiiq/status/1975062970893062650,https://x.com/IndoPopBase/status/1975062358600056852,0
2025-10-06 12:12:43+00:00,mediasetyadewi,Kurang ganci boneka2 yg dari oh some!,0,0,0,174,https://x.com/mediasetyadewi/status/1975172366574723249,https://x.com/IndoPopBase/status/1975062358600056852,0
2025-10-06 06:40:43+00:00,ciaimuppp,lucunyaaaa,0,0,0,194,https://x.com/ciaimuppp/status/1975088816802480597,https://x.com/IndoPopBase/status/1975062358600056852,0
2025-10-06 08:01:29+00:00,GiyantiSamudra,Lucu nget,0,0,0,96,https://x.com/GiyantiSamudra/status/1975109140537364537,https://x.com/IndoPopBase/status/1975062358600056852,0
2025-10-06 11:15:46+00:00,adawiyahriwan,Cantik banget,0,1,0,260,https://x.com/adawiyahriwan/status/1975158031643218395,https://x.com/IndoPopBase/status/1975062358600056852,1
2025-10-06 23:57:44+00:00,juneisweepy,aLucuuuu bgttt,0,0,0,42,https://x.com/juneisweepy/status/1975349788410572865,https://x.com/IndoPopBase/status/1975062358600056852,0
2025-10-06 10:18:42+00:00,·,zara larsson local,0,0,0,415,https://x.com/staghfirulah/status/1975143670962966743,https://x.com/IndoPopBase/status/1975062358600056852,0
2025-10-06 05:07:43+00:00,itsronyramdan,We love pop star with side hustle. go Andien.,0,0,0,466,https://x.com/itsronyramdan/status/1975065409180270703,https://x.com/IndoPopBase/status/1975062358600056852,0
2025-10-06 14:52:12+00:00,capeksihtpyauds,suka bgt,0,0,0,50,https://x.com/capeksihtpyauds/status/1975212500821110875,https://x.com/IndoPopBase/status/1975062358600056852,0
2025-10-06 05:16:34+00:00,KimDaebongie,outfitnya lucuu bgt...,0,0,0,267,https://x.com/KimDaebongie/status/1975067636292878370,https://x.com/IndoPopBase/status/1975062358600056852,0
2025-10-06 16:17:08+00:00,sensusmieayam,jangan sampe kacida tau,0,0,0,85,https://x.com/sensusmieayam/status/1975233874038075897,https://x.com/IndoPopBase/status/1975062358600056852,0
2025-10-06 23:19:29+00:00,horafla300,Shes reheating zara’s nachos,0,0,0,59,https://x.com/horafla300/status/1975340160842932506,https://x.com/IndoPopBase/status/1975062358600056852,0
2025-10-06 08:25:19+00:00,SalsaCosmetic,"colorful bgt, lucukk ",0,0,0,114,https://x.com/SalsaCosmetic/status/1975115138970878073,https://x.com/IndoPopBase/status/1975062358600056852,0
2025-10-06 06:20:51+00:00,OynRetriever,GODDESSdien,0,0,0,201,https://x.com/OynRetriever/status/1975083813941444996,https://x.com/IndoPopBase/status/1975062358600056852,0
2025-10-06 05:20:23+00:00,sunsflowa,mau nyomot tamagotchinya,0,0,0,2512,https://x.com/sunsflowa/status/1975068599854469529,https://x.com/IndoPopBase/status/1975062358600056852,0
2025-10-06 12:11:04+00:00,cosmocheis, RAKYAT JELITA ,0,0,0,49,https://x.com/cosmocheis/status/1975171950453702923,https://x.com/IndoPopBase/status/1975062358600056852,0
2025-10-06 10:04:23+00:00,terpamungkas,Uwaw,0,0,0,46,https://x.com/terpamungkas/status/1975140070974980203,https://x.com/IndoPopBase/status/1975062358600056852,0
2025-10-06 06:18:58+00:00,_NaCN__,Trinketssss,0,0,0,132,https://x.com/_NaCN__/status/1975083341717385622,https://x.com/IndoPopBase/status/1975062358600056852,0
2025-10-06 05:58:17+00:00,pikiranbulan,awet muda bgt ,0,0,0,118,https://x.com/pikiranbulan/status/1975078136921637149,https://x.com/IndoPopBase/status/1975062358600056852,0
2025-10-07 01:46:22+00:00,entforevah,rhode? amid this cancel culture is diabolical,1,0,0,93,https://x.com/entforevah/status/1975377128305922082,https://x.com/IndoPopBase/status/1975062358600056852,1
2025-10-06 04:48:49+00:00,brutaldoms,INDO SONG CENTIL ERA IS BACK,4,24,0,18919,https://x.com/brutaldoms/status/1975060653284196436,https://x.com/IndoPopBase/status/1975057772657115583,28
2025-10-06 04:44:51+00:00,pemerintahkota,mantep abis rumahnya dijarah tetep lanjut recording,36,17,0,36255,https://x.com/pemerintahkota/status/1975059656902123760,https://x.com/IndoPopBase/status/1975057772657115583,53
2025-10-06 05:51:54+00:00,akunfavoritmu,"kursinya ketinggian, dipendekin dikit kan bisa ituuuu",1,0,0,10031,https://x.com/akunfavoritmu/status/1975076528448041408,https://x.com/IndoPopBase/status/1975057772657115583,1
2025-10-06 04:40:01+00:00,andreaonchain,"all the slangs and hit words i used throughout my teenage years were from this queen

maju mundur syantikkk",1,0,0,29568,https://x.com/andreaonchain/status/1975058439157215572,https://x.com/IndoPopBase/status/1975057772657115583,1
2025-10-06 05:01:03+00:00,beautiaf,princess comeback!?!?!?,0,0,0,10322,https://x.com/beautiaf/status/1975063731697783149,https://x.com/IndoPopBase/status/1975057772657115583,0
2025-10-06 10:23:42+00:00,fnminine,ga sabarrrrr,0,0,0,3578,https://x.com/fnminine/status/1975144929430302810,https://x.com/IndoPopBase/status/1975057772657115583,0
2025-10-06 06:45:34+00:00,anjingdibulan,"to be fair, the right and suitable caption is:

syahrini is sitting on studio",0,0,0,17405,https://x.com/anjingdibulan/status/1975090037445578925,https://x.com/IndoPopBase/status/1975057772657115583,0
2025-10-06 08:57:54+00:00,Ariestanabirah,"Welcome back, Princess! Tadi kirain anak pramuka mana di foto ini ",0,0,0,19189,https://x.com/Ariestanabirah/status/1975123336159203374,https://x.com/IndoPopBase/status/1975057772657115583,0
2025-10-06 04:38:39+00:00,ursteulyNaveen,New era loading… ,0,0,0,4083,https://x.com/ursteulyNaveen/status/1975058096310648843,https://x.com/IndoPopBase/status/1975057772657115583,0
2025-10-06 04:45:47+00:00,0xgasm,Anang's legacy,0,0,0,2908,https://x.com/0xgasm/status/1975059891011395996,https://x.com/IndoPopBase/status/1975057772657115583,0
2025-10-06 04:54:48+00:00,Twittysweetie_,Nungguin banget gebrakan gebrakan manjahhhhhnya,0,0,0,5374,https://x.com/Twittysweetie_/status/1975062160549319110,https://x.com/IndoPopBase/status/1975057772657115583,0
2025-10-06 14:10:41+00:00,wilonaaa,maju mundur cantik reborn,0,0,0,6849,https://x.com/wilonaaa/status/1975202053904642141,https://x.com/IndoPopBase/status/1975057772657115583,0
2025-10-06 05:32:14+00:00,Seung_ha_,"Syahrini teases fans with a studio update, confirming she’s recording new music. Something big might be coming soon! ",0,0,0,3118,https://x.com/Seung_ha_/status/1975071581098619297,https://x.com/IndoPopBase/status/1975057772657115583,0
2025-10-06 04:42:44+00:00,0xKaleaa,let her cook,0,0,0,5447,https://x.com/0xKaleaa/status/1975059123986428164,https://x.com/IndoPopBase/status/1975057772657115583,0
2025-10-06 10:44:53+00:00,genoshide,emang lagunya ada yang enak apa? laku juga ga ,7,1,0,2273,https://x.com/genoshide/status/1975150260533235834,https://x.com/IndoPopBase/status/1975057772657115583,8
2025-10-06 05:19:32+00:00,lizziemylovey,grammy better watch out,0,1,0,17202,https://x.com/lizziemylovey/status/1975068384850223498,https://x.com/IndoPopBase/status/1975057772657115583,1
2025-10-06 07:30:35+00:00,Blackjingga09,Owh luna maya diss track incoming,0,0,0,6592,https://x.com/Blackjingga09/status/1975101363983106178,https://x.com/IndoPopBase/status/1975057772657115583,0
2025-10-06 05:36:59+00:00,1102s_k,very asian (lepas sepatu),0,0,0,1287,https://x.com/1102s_k/status/1975072777905606760,https://x.com/IndoPopBase/status/1975057772657115583,0
2025-10-06 11:49:14+00:00,ja_brahm,"dream big ... dream big ... dream big ... nothing can ever keep us down, nothing can ever stop us now",0,0,0,398,https://x.com/ja_brahm/status/1975166454673617285,https://x.com/IndoPopBase/status/1975057772657115583,0
2025-10-06 05:43:54+00:00,user_220599,Syahrini ate mixue,0,0,0,1324,https://x.com/user_220599/status/1975074516083814437,https://x.com/IndoPopBase/status/1975057772657115583,0
2025-10-06 10:35:12+00:00,plotecultm,kaos kaki sama kulit dia putihan kulit dia,0,0,0,5001,https://x.com/plotecultm/status/1975147824242434170,https://x.com/IndoPopBase/status/1975057772657115583,0
2025-10-06 07:46:00+00:00,·,Apa gak capek tuh posisi kakinya begitu? Turunin dulu kursinya buuu,0,0,0,1253,https://x.com/andindali/status/1975105245027213458,https://x.com/IndoPopBase/status/1975057772657115583,0
2025-10-06 10:29:15+00:00,XHumanMachineX,Masih butuh duit kah syahrini?,0,0,0,264,https://x.com/XHumanMachineX/status/1975146327274307791,https://x.com/IndoPopBase/status/1975057772657115583,0
2025-10-07 02:15:49+00:00,fIoIyn,minggu lalu krystal jung juga upload sedang rikording apakh akan ft syahrini,0,0,0,206,https://x.com/fIoIyn/status/1975384538860966003,https://x.com/IndoPopBase/status/1975057772657115583,0
2025-10-06 13:21:44+00:00,entforevah,"semoga bukan lagu islamiyah ya bun
kek yang shake shake shake boom aja",0,0,0,2049,https://x.com/entforevah/status/1975189732217979297,https://x.com/IndoPopBase/status/1975057772657115583,0
2025-10-06 07:49:16+00:00,iswaduimma1,"Oohh my bad, i read it as ""SYAHRONI"" ",0,0,0,402,https://x.com/iswaduimma1/status/1975106066263494668,https://x.com/IndoPopBase/status/1975057772657115583,0
2025-10-06 08:54:19+00:00,vamborebomb,"Gak sabar buat denger lagu yang tipenya shake shake shake boom, cetar membaha badai.",0,0,0,4905,https://x.com/vamborebomb/status/1975122436585930926,https://x.com/IndoPopBase/status/1975057772657115583,0
2025-10-06 05:58:43+00:00,idiotsandbeach,ended the life of a flopgirl,0,0,0,181,https://x.com/idiotsandbeach/status/1975078245944197587,https://x.com/IndoPopBase/status/1975057772657115583,0
2025-10-06 06:55:39+00:00,siap_disantap,Kursinya gak bisa diturunin kah?,0,0,0,377,https://x.com/siap_disantap/status/1975092571069403212,https://x.com/IndoPopBase/status/1975057772657115583,0
2025-10-06 05:19:52+00:00,ciperamanuk,sampe sekarang suka banget lagu lagu syahrini,0,0,0,256,https://x.com/ciperamanuk/status/1975068469529084236,https://x.com/IndoPopBase/status/1975057772657115583,0
2025-10-06 10:28:37+00:00,leamonnnn,Lagunya tentang rumahnya yg dijarah ga ya,0,0,0,614,https://x.com/leamonnnn/status/1975146166871597380,https://x.com/IndoPopBase/status/1975057772657115583,0
2025-10-06 04:40:36+00:00,masreyhaan,We needdd lagu2 centil khass Syahrini lagiii,0,0,0,442,https://x.com/masreyhaan/status/1975058586826162594,https://x.com/IndoPopBase/status/1975057772657115583,0
2025-10-06 12:01:58+00:00,Shevtian,Siapa tahu cuman lagi ngadem aja di studio sambil ngopi Golda.,0,0,0,111,https://x.com/Shevtian/status/1975169659143061616,https://x.com/IndoPopBase/status/1975057772657115583,0
2025-10-06 11:31:40+00:00,ExThar_ofc,For Satria Naga? lmao,0,0,0,412,https://x.com/ExThar_ofc/status/1975162033168699867,https://x.com/IndoPopBase/status/1975057772657115583,0
2025-10-06 06:01:19+00:00,kocakluh2018,"mungil banget ya ?
sampe jinjit gtu dari bangku",0,0,0,595,https://x.com/kocakluh2018/status/1975078899370598848,https://x.com/IndoPopBase/status/1975057772657115583,0
2025-10-06 05:27:36+00:00,utamaiqbal,Ready for obrak-abrik grammy stage,0,0,0,1976,https://x.com/utamaiqbal/status/1975070415967170764,https://x.com/IndoPopBase/status/1975057772657115583,0
2025-10-06 04:44:28+00:00,Washyourkiss,What music?,0,0,0,492,https://x.com/Washyourkiss/status/1975059559707525292,https://x.com/IndoPopBase/status/1975057772657115583,0
2025-10-07 11:12:27+00:00,risainnn,gebrakan apalagi yg bakal dia buat? hm,0,0,0,18,https://x.com/risainnn/status/1975519584980770948,https://x.com/IndoPopBase/status/1975057772657115583,0
2025-10-06 06:31:26+00:00,haikarrll85,"Cosplay mermaid again? ""Alhamdulillah yacht..""",0,0,0,6365,https://x.com/haikarrll85/status/1975086479362912524,https://x.com/IndoPopBase/status/1975057772657115583,0
2025-10-06 10:18:01+00:00,keustruckpdf,demn collab sma jisoo x zayn,0,0,0,160,https://x.com/keustruckpdf/status/1975143502104416597,https://x.com/IndoPopBase/status/1975057772657115583,0
2025-10-06 09:15:55+00:00,hardhene,she tryna reheating Jangan Memilih Aku nachos,0,0,0,838,https://x.com/hardhene/status/1975127872097697902,https://x.com/IndoPopBase/status/1975057772657115583,0
2025-10-06 14:46:20+00:00,2359wib,Ended Taylor Swift,0,0,0,196,https://x.com/2359wib/status/1975211023419503015,https://x.com/IndoPopBase/status/1975057772657115583,0
2025-10-06 07:01:54+00:00,dprfrzni,I kindly request that the recording be deleted and that no part of it be published or released,0,0,0,191,https://x.com/dprfrzni/status/1975094147485962552,https://x.com/IndoPopBase/status/1975057772657115583,0
2025-10-06 13:51:59+00:00,·,yazzzz queeennn,0,0,0,80,https://x.com/pinkyuberries/status/1975197346939175118,https://x.com/IndoPopBase/status/1975057772657115583,0
2025-10-06 08:32:18+00:00,ghfrrrr_,our trendsetter queen,0,0,0,243,https://x.com/ghfrrrr_/status/1975116895079817557,https://x.com/IndoPopBase/status/1975057772657115583,0
2025-10-06 09:41:17+00:00,menjalang,pasti DOOM,1,0,0,145,https://x.com/menjalang/status/1975134255639671042,https://x.com/IndoPopBase/status/1975057772657115583,1
2025-10-06 09:52:19+00:00,banafcha,badannya sekarang moengil ya,0,0,0,58,https://x.com/banafcha/status/1975137034634465686,https://x.com/IndoPopBase/status/1975057772657115583,0
2025-10-06 05:36:59+00:00,haxemeleh,kenapa gak diturunin kursinya,0,0,0,382,https://x.com/haxemeleh/status/1975072776919883938,https://x.com/IndoPopBase/status/1975057772657115583,0
2025-10-06 14:00:57+00:00,sukatehkotak,wow comeback,0,0,0,78,https://x.com/sukatehkotak/status/1975199604384858232,https://x.com/IndoPopBase/status/1975057772657115583,0
2025-10-06 08:18:49+00:00,catwoman1928,"@yuddby
 idola capa neh",0,0,0,47,https://x.com/catwoman1928/status/1975113503909577166,https://x.com/IndoPopBase/status/1975057772657115583,0
2025-10-06 05:35:22+00:00,Seung_ha_,"Can you believe ‘Album Vakansi’ by White Shoes & The Couples Company turns 15 today? 
@grok",0,0,0,802,https://x.com/Seung_ha_/status/1975072367249690669,https://x.com/IndoPopBase/status/1975057400010006584,0
2025-10-06 04:39:15+00:00,ursteulyNaveen,15 years later and it still feels like the perfect holiday soundtrack ,0,0,0,1671,https://x.com/ursteulyNaveen/status/1975058246600888390,https://x.com/IndoPopBase/status/1975057400010006584,0
2025-10-06 07:17:25+00:00,agunglaksnoo,"Unfortunately, not available on Spotify ",3,0,0,1184,https://x.com/agunglaksnoo/status/1975098051988754772,https://x.com/IndoPopBase/status/1975057400010006584,3
2025-10-06 04:38:41+00:00,0xgasm,I like their music,0,0,0,1074,https://x.com/0xgasm/status/1975058103302562259,https://x.com/IndoPopBase/status/1975057400010006584,0
2025-10-06 09:55:30+00:00,·,John Navid gantengnya abadi cok,0,0,0,23,https://x.com/nami_singkat/status/1975137835192914416,https://x.com/IndoPopBase/status/1975057400010006584,0
2025-10-06 08:09:41+00:00,leftiesdiefast,satu-satunya album wsatcc yg aku punya rilisannya,0,0,0,588,https://x.com/leftiesdiefast/status/1975111202587148522,https://x.com/IndoPopBase/status/1975057400010006584,0
2025-10-06 06:37:32+00:00,mengudarabebas,"Vintej parah  gak ngelawan dah sepuh bgt mereka.. kalo colab ama 
@davidbayu
 bakal kek apa lagunya yak ??",0,0,0,1217,https://x.com/mengudarabebas/status/1975088015598121330,https://x.com/IndoPopBase/status/1975057400010006584,0
2025-10-10 05:00:30+00:00,AsWindAndFire,Still one of the best bands,0,0,0,0,https://x.com/AsWindAndFire/status/1976513144714317903,https://x.com/IndoPopBase/status/1975057400010006584,0
2025-10-06 07:24:32+00:00,lemperayambakar,selamat 15 tahun,0,0,0,860,https://x.com/lemperayambakar/status/1975099842180624769,https://x.com/IndoPopBase/status/1975057400010006584,0
2025-10-06 09:17:27+00:00,good_cult,Tekke 15 tahun ,0,0,0,967,https://x.com/good_cult/status/1975128258510569898,https://x.com/IndoPopBase/status/1975057400010006584,0
2025-10-08 01:18:32+00:00,poisonrusalka,nice album ...,0,0,0,11,https://x.com/poisonrusalka/status/1975732509079171349,https://x.com/IndoPopBase/status/1975057400010006584,0
2025-10-06 12:37:47+00:00,kikidecoservice,Punya albumnya,0,0,0,373,https://x.com/kikidecoservice/status/1975178674988326921,https://x.com/IndoPopBase/status/1975057400010006584,0
2025-10-06 06:28:50+00:00,kokobuncit,one of my fav album,0,0,0,681,https://x.com/kokobuncit/status/1975085823604498584,https://x.com/IndoPopBase/status/1975057400010006584,0
2025-10-06 10:50:46+00:00,duddledudeduck,Just got the cd last week!,0,0,0,325,https://x.com/duddledudeduck/status/1975151740455657622,https://x.com/IndoPopBase/status/1975057400010006584,0
2025-10-07 03:27:59+00:00,cutemistakess,Love this album sm arrrgh,0,0,0,353,https://x.com/cutemistakess/status/1975402700222435440,https://x.com/IndoPopBase/status/1975057400010006584,0
2025-10-06 09:47:19+00:00,putriaun,teenager era,0,0,0,326,https://x.com/putriaun/status/1975135774594224407,https://x.com/IndoPopBase/status/1975057400010006584,0
2025-10-08 05:05:16+00:00,2ndbebytokyo,LOVE BGTTTTT MAMAMAAAAA,0,0,0,20,https://x.com/2ndbebytokyo/status/1975789571670692338,https://x.com/IndoPopBase/status/1975057400010006584,0
2025-10-06 07:41:05+00:00,feelwinter_,Timeless niii band,0,0,0,573,https://x.com/feelwinter_/status/1975104005908119602,https://x.com/IndoPopBase/status/1975057400010006584,0
2025-10-06 14:40:16+00:00,MRagustino,"Jika gundah tuan rasa, gulana harap sebuah makna
Ancam hamba kan disiksa, tak mengapa",0,0,0,310,https://x.com/MRagustino/status/1975209496063664378,https://x.com/IndoPopBase/status/1975057400010006584,0
2025-10-07 03:10:40+00:00,veneerate,Aku suka ,0,0,0,37,https://x.com/veneerate/status/1975398341912694958,https://x.com/IndoPopBase/status/1975057400010006584,0
2025-10-06 06:51:46+00:00,geeamalia5,Jd inget jaman pensi ini mah ,0,0,0,443,https://x.com/geeamalia5/status/1975091595012977087,https://x.com/IndoPopBase/status/1975057400010006584,0
2025-10-06 06:35:01+00:00,alaikazizi,Masih cukup sering ndengerin album ini. ,0,0,0,668,https://x.com/alaikazizi/status/1975087379531915321,https://x.com/IndoPopBase/status/1975057400010006584,0
2025-10-06 12:56:08+00:00,farhanskuy10,Timeless,0,0,0,224,https://x.com/farhanskuy10/status/1975183290576626036,https://x.com/IndoPopBase/status/1975057400010006584,0
2025-10-06 09:31:46+00:00,izinchicken,Apa???? 15 tahun??? Selamat,0,0,0,259,https://x.com/izinchicken/status/1975131860796936579,https://x.com/IndoPopBase/status/1975057400010006584,0
2025-10-06 06:09:53+00:00,Love_3children,"""Throwback to this masterpiece! 'Vakansi' is still one of the best albums in Indonesian music history. Congratulations on 15 years!",0,1,0,1363,https://x.com/Love_3children/status/1975081055125487971,https://x.com/IndoPopBase/status/1975057400010006584,1
2025-10-06 12:11:46+00:00,BipJr,"@wsatcc
 vakansi ke helsinki",0,0,0,215,https://x.com/BipJr/status/1975172127667188198,https://x.com/IndoPopBase/status/1975057400010006584,0
2025-10-06 06:59:34+00:00,aswan21w,jadul,0,0,0,307,https://x.com/aswan21w/status/1975093560111403490,https://x.com/IndoPopBase/status/1975057400010006584,0
2025-10-06 04:44:52+00:00,akhirpekansans,"Tshirt white shoes & couples company "" vakansi""",1,0,0,124,https://x.com/akhirpekansans/status/1975059660358164602,https://x.com/IndoPopBase/status/1975057400010006584,1
2025-10-06 07:53:50+00:00,SaddamWeb3,"majalah tempo pernah dibredel orba tahun 94 karena liputannya terlalu kritis

pak harto emang legend soal kontrol media di masanya.",1,6,0,5788,https://x.com/SaddamWeb3/status/1975107215012102552,https://x.com/IndoPopBase/status/1975053641322303817,7
2025-10-06 05:57:40+00:00,MunafAdi22,Di banned Gara gara merilis artikel yang berhubungan dengan tokoh intelektual kebanggaan warga Twitter/X hehehe .,4,0,0,4454,https://x.com/MunafAdi22/status/1975077979442254123,https://x.com/IndoPopBase/status/1975053641322303817,4
2025-10-06 04:44:08+00:00,bareda,The regime that legalize Porkas SDSB togel.,1,0,0,6446,https://x.com/bareda/status/1975059475536203800,https://x.com/IndoPopBase/status/1975053641322303817,1
2025-10-06 13:08:36+00:00,vanmierlo77,"Tempo kerja jadi oposan terus kecuali kalau pemenangnya PDI-P, baru dia meng elu2kan majikannya.. Liat aja 2 periode kemaren?? Malah bantu boneka majikannya bikin  populer?.. Skrg malah berbalik.. Hadew.. Nelen taee sendiri tempo ini dah",1,0,0,1169,https://x.com/vanmierlo77/status/1975186429069455856,https://x.com/IndoPopBase/status/1975053641322303817,1
2025-10-06 04:27:21+00:00,ursteulyNaveen,"A powerful reminder of press freedom’s resilience 27 years later, TEMPO still stands tall against silence.",1,10,0,8398,https://x.com/ursteulyNaveen/status/1975055251385573726,https://x.com/IndoPopBase/status/1975053641322303817,11
2025-10-06 09:37:33+00:00,belajarcuriga,"Kenapa Soeharto memblokir tempo waktu itu? 
@grok",1,0,0,1203,https://x.com/belajarcuriga/status/1975133315792535886,https://x.com/IndoPopBase/status/1975053641322303817,1
2025-10-06 13:44:56+00:00,_KonohaCity_,Ini foto memang ngeri,0,1,0,1848,https://x.com/_KonohaCity_/status/1975195573696549304,https://x.com/IndoPopBase/status/1975053641322303817,1
2025-10-06 15:18:06+00:00,ZiiGrimes,Weh tempo keren pernah di ban rupanya,1,0,0,772,https://x.com/ZiiGrimes/status/1975219018769510435,https://x.com/IndoPopBase/status/1975053641322303817,1
2025-10-06 09:17:36+00:00,calonmiliyuner,"Prabski be like : ""lho bisa gitu tah? Oalah yaudah gasken""",0,0,0,1850,https://x.com/calonmiliyuner/status/1975128295017730083,https://x.com/IndoPopBase/status/1975053641322303817,0
2025-10-06 10:42:45+00:00,Agdithoughts,"Welcome back, I mean the new order regime not tempo",0,0,0,1898,https://x.com/Agdithoughts/status/1975149724643819756,https://x.com/IndoPopBase/status/1975053641322303817,0
2025-10-06 12:32:58+00:00,txtdrhrdoet,Dosa TEMPO yg tidak bisa dimaafkan!,1,2,0,1925,https://x.com/txtdrhrdoet/status/1975177459734810953,https://x.com/IndoPopBase/status/1975053641322303817,3
2025-10-07 03:07:07+00:00,orangtawakal,"@tempodotco
 tetaplah kritis untuk kepengen rakyat dan demokrasi  !",0,0,0,233,https://x.com/orangtawakal/status/1975397449675292837,https://x.com/IndoPopBase/status/1975053641322303817,0
2025-10-06 11:03:31+00:00,furaitochickin,Memang sudah jadi sifat diktator untuk paranoid ya.,0,0,0,952,https://x.com/furaitochickin/status/1975154951082168481,https://x.com/IndoPopBase/status/1975053641322303817,0
2025-10-06 05:33:33+00:00,Seung_ha_,"Did you know TEMPO Magazine made its comeback 27 years ago today after a four-year ban under the New Order regime? 
@grok",0,0,0,2884,https://x.com/Seung_ha_/status/1975071911924338908,https://x.com/IndoPopBase/status/1975053641322303817,0
2025-10-06 07:17:07+00:00,LianCroft,Periodt... you can't silence Tempo,0,0,0,1768,https://x.com/LianCroft/status/1975097976680067194,https://x.com/IndoPopBase/status/1975053641322303817,0
2025-10-06 05:23:10+00:00,JavaJimmyMaukar,"@tempodotco
 ",0,0,0,2632,https://x.com/JavaJimmyMaukar/status/1975069298789089708,https://x.com/IndoPopBase/status/1975053641322303817,0
2025-10-06 05:18:32+00:00,jannahseeker99,Panjang umur tempo #nepalkan #patikan,0,0,0,1565,https://x.com/jannahseeker99/status/1975068132344754244,https://x.com/IndoPopBase/status/1975053641322303817,0
2025-10-06 18:12:54+00:00,valangdika,Daripada Kompas,0,0,0,279,https://x.com/valangdika/status/1975263010563473768,https://x.com/IndoPopBase/status/1975053641322303817,0
2025-10-06 17:39:46+00:00,riyan_gendut,Another ban is coming...the Order reigns eternal...,0,0,0,385,https://x.com/riyan_gendut/status/1975254670353596888,https://x.com/IndoPopBase/status/1975053641322303817,0
2025-10-06 06:50:43+00:00,aswan21w,enak jamanku to serba murah,0,0,0,1261,https://x.com/aswan21w/status/1975091330612351274,https://x.com/IndoPopBase/status/1975053641322303817,0
2025-10-06 06:08:16+00:00,Love_3children,"""Happy anniversary to TEMPO Magazine! Your dedication to press freedom and quality journalism is truly inspiring. Here's to many more years of insightful reporting!",0,0,0,1184,https://x.com/Love_3children/status/1975080650224103841,https://x.com/IndoPopBase/status/1975053641322303817,0
2025-10-05 15:48:52+00:00,IndoPopBase,Andika of Kangen Band wears a ‘We Should All Be Feminists’ shirt during their set at Synchronize Fest.,191,860,0,759010,https://x.com/IndoPopBase/status/1974864374952316950,https://x.com/IndoPopBase/status/1974864379939344457,1051
2025-10-05 15:48:54+00:00,IndoPopBase,": 
@halief",0,0,0,55926,https://x.com/IndoPopBase/status/1974864379939344457,https://x.com/IndoPopBase/status/1974864374952316950,0
2025-10-06 00:07:25+00:00,SoundOfYogi,Ini orang bukannya pernah punya istri underage?,16,2,0,21707,https://x.com/SoundOfYogi/status/1974989837561381312,https://x.com/IndoPopBase/status/1974864374952316950,18
2025-10-06 02:46:36+00:00,KentutaN,"gw bakal jadi feminist kalo mulai skr istri yg cari nafkah, bukan suami.",6,1,0,1944,https://x.com/KentutaN/status/1975029897908441303,https://x.com/IndoPopBase/status/1974864374952316950,7
2025-10-05 16:16:46+00:00,anastasiartn,The real perfomative male before anyone else,0,66,0,37060,https://x.com/anastasiartn/status/1974871394224914646,https://x.com/IndoPopBase/status/1974864374952316950,66
2025-10-05 17:56:01+00:00,andriekaryadi,"I don't think he understands what the statement means, but whatever as long as it served ",3,22,0,20444,https://x.com/andriekaryadi/status/1974896373163307056,https://x.com/IndoPopBase/status/1974864374952316950,25
2025-10-05 15:52:54+00:00,Seung_ha_,"Andika wore a We Should All Be Feminists shirt on stage at Synchronize Fest bold move or simple statement? 
@grok",1,0,0,6273,https://x.com/Seung_ha_/status/1974865390279987290,https://x.com/IndoPopBase/status/1974864374952316950,1
2025-10-05 15:55:13+00:00,PROSPERDEGREAT,Didn’t have Andika leading the feminist movement on my 2025 bingo card ,0,0,0,39344,https://x.com/PROSPERDEGREAT/status/1974865972369797123,https://x.com/IndoPopBase/status/1974864374952316950,0
2025-10-06 04:32:58+00:00,beautiaf,performative male final bos.,0,0,0,8813,https://x.com/beautiaf/status/1975056667575472424,https://x.com/IndoPopBase/status/1974864374952316950,0
2025-10-05 15:53:31+00:00,SaddamWeb3,iya lagi,0,2,0,5450,https://x.com/SaddamWeb3/status/1974865545649697119,https://x.com/IndoPopBase/status/1974864374952316950,2
2025-10-05 15:53:42+00:00,PROSPERDEGREAT,Never thought I’d see Andika mixing heartbreak songs with feminism merch ,0,1,0,31982,https://x.com/PROSPERDEGREAT/status/1974865588007960614,https://x.com/IndoPopBase/status/1974864374952316950,1
2025-10-05 16:09:34+00:00,Dara_metaX,Andika rocking a ‘We Should All Be Feminists’ tee at Synchronize Fest… didn’t see that coming but I’m here for it,0,0,0,14798,https://x.com/Dara_metaX/status/1974869584349126779,https://x.com/IndoPopBase/status/1974864374952316950,0
2025-10-05 16:10:11+00:00,Dara_metaX,Cool to see artists using the stage not just for music but to push messages that matter too,0,0,0,10882,https://x.com/Dara_metaX/status/1974869737877520610,https://x.com/IndoPopBase/status/1974864374952316950,0
2025-10-05 16:19:38+00:00,sunshinetally4,i mean yes! but coming from him...?,1,1,0,16403,https://x.com/sunshinetally4/status/1974872116425335258,https://x.com/IndoPopBase/status/1974864374952316950,2
2025-10-05 15:49:59+00:00,ursteulyNaveen,That’s a statement louder than the music ,0,0,0,11113,https://x.com/ursteulyNaveen/status/1974864656025198706,https://x.com/IndoPopBase/status/1974864374952316950,0
2025-10-06 14:02:14+00:00,Swanfukc,"Kaya beginian aja lorang wah weh woh, dari kapan hari dia ini di rebranding dibikin biar keliatan edgy, boro2 andika nya ngerti beginian, gak kapok apa ya di boongin sama begini2an org tuh belajar dari kasus jokowi jadi presiden, disuruh pake baju napalm death lah metallica lah",0,0,0,520,https://x.com/Swanfukc/status/1975199926197125263,https://x.com/IndoPopBase/status/1974864374952316950,0
2025-10-06 09:01:30+00:00,indienas,"Wearing a shirt means nothing if his actions don't reflect that. No need to glorify this. My ART used to wear a sweater with the writing 'Feminist' as well, but she knew nothing about it.",0,0,0,1491,https://x.com/indienas/status/1975124244976857251,https://x.com/IndoPopBase/status/1974864374952316950,0
2025-10-06 02:26:49+00:00,fluoxetan,"no, thanks",1,0,0,1251,https://x.com/fluoxetan/status/1975024918552318307,https://x.com/IndoPopBase/status/1974864374952316950,1
2025-10-05 17:17:24+00:00,cucunyasoekiman,"baca tot 
x.com/banan4y_/statu
…",0,0,0,12672,https://x.com/cucunyasoekiman/status/1974886652062646583,https://x.com/IndoPopBase/status/1974864374952316950,0
2025-10-06 10:45:17+00:00,alfadixnsyah,,0,0,0,341,https://x.com/alfadixnsyah/status/1975150360500338696,https://x.com/IndoPopBase/status/1974864374952316950,0
2025-10-05 17:42:57+00:00,terriblescape,"Problematik itu org jir, raja performative male",0,0,0,709,https://x.com/terriblescape/status/1974893085361668286,https://x.com/IndoPopBase/status/1974864374952316950,0
2025-10-05 23:25:00+00:00,arganheimer,terakhir cowo tertangkap layar ikut gerakan begituan pake masker lho biar ga ketahuan sifat ytta nya,0,0,0,3039,https://x.com/arganheimer/status/1974979163540144544,https://x.com/IndoPopBase/status/1974864374952316950,0
2025-10-05 16:37:23+00:00,arhfelix_,makin keluar aja dah tu itu kasus dia yg dulu dulu pastinya gegara enih ewkekw,0,0,0,5825,https://x.com/arhfelix_/status/1974876581131931931,https://x.com/IndoPopBase/status/1974864374952316950,0
2025-10-05 16:01:51+00:00,pivtapearce,ended baim flopwong,0,0,0,1393,https://x.com/pivtapearce/status/1974867642524836210,https://x.com/IndoPopBase/status/1974864374952316950,0
2025-10-06 06:23:12+00:00,kucilpung,Kalau semua wanita feminis ga bakal ada yg mau ama elo bang ,0,2,0,2537,https://x.com/kucilpung/status/1975084406688928228,https://x.com/IndoPopBase/status/1974864374952316950,2
2025-10-06 03:11:51+00:00,diorpurses,,0,0,0,312,https://x.com/diorpurses/status/1975036253402976524,https://x.com/IndoPopBase/status/1974864374952316950,0
2025-10-06 10:06:16+00:00,belajarcuriga,"Does he respect women? 
@grok",1,0,0,780,https://x.com/belajarcuriga/status/1975140541588525271,https://x.com/IndoPopBase/status/1974864374952316950,1
2025-10-06 00:40:36+00:00,yyyolie,Cuman lagi pake kaos Dior aja,0,0,0,7671,https://x.com/yyyolie/status/1974998188789760194,https://x.com/IndoPopBase/status/1974864374952316950,0
2025-10-06 00:14:18+00:00,lyhibs,"bhappppp, performative male final boss",0,0,0,8728,https://x.com/lyhibs/status/1974991571629359545,https://x.com/IndoPopBase/status/1974864374952316950,0
2025-10-05 23:43:13+00:00,meverneant,Peak performative male,0,0,0,801,https://x.com/meverneant/status/1974983746131755094,https://x.com/IndoPopBase/status/1974864374952316950,0
2025-10-06 11:40:57+00:00,dennymset,It's giving Dior by Maria Grazia Chiuri Spring Summer 2017,0,0,0,496,https://x.com/dennymset/status/1975164370175869367,https://x.com/IndoPopBase/status/1974864374952316950,0
2025-10-06 02:06:15+00:00,itsssdare,doi gak ngerti pake pake aja,0,2,0,159,https://x.com/itsssdare/status/1975019744744075491,https://x.com/IndoPopBase/status/1974864374952316950,2
2025-10-06 08:08:09+00:00,bajajmundur,Gue yakin dia sebenernya ga paham artinya apa,0,0,0,377,https://x.com/bajajmundur/status/1975110819018105108,https://x.com/IndoPopBase/status/1974864374952316950,0
2025-10-06 23:38:12+00:00,PenggunaPergi,"Oh damn , he’s chek ma part",0,0,0,25,https://x.com/PenggunaPergi/status/1975344874397610235,https://x.com/IndoPopBase/status/1974864374952316950,0
2025-10-06 08:59:07+00:00,bukanrizi23,Bodoamat,0,0,0,149,https://x.com/bukanrizi23/status/1975123644688093343,https://x.com/IndoPopBase/status/1974864374952316950,0
2025-10-06 04:22:38+00:00,rebelliondeutro,cuman kaos doang pengaruhnya apa sih,0,0,0,144,https://x.com/rebelliondeutro/status/1975054064070300014,https://x.com/IndoPopBase/status/1974864374952316950,0
2025-10-06 00:17:14+00:00,EndraSept,"Let him be, he has the right to say whatever he wants. ",0,0,0,289,https://x.com/EndraSept/status/1974992306542620950,https://x.com/IndoPopBase/status/1974864374952316950,0
2025-10-06 00:58:45+00:00,teluracak,,0,0,0,324,https://x.com/teluracak/status/1975002757707993433,https://x.com/IndoPopBase/status/1974864374952316950,0
2025-10-06 08:40:44+00:00,apaytalemponk,"Kek ngerti aja dia, wkwwkwk",0,0,0,69,https://x.com/apaytalemponk/status/1975119017456374206,https://x.com/IndoPopBase/status/1974864374952316950,0
2025-10-06 01:45:16+00:00,rifkaaji1,Jadi inget dia dulu pernah punya kasus.,0,0,0,252,https://x.com/rifkaaji1/status/1975014463322595375,https://x.com/IndoPopBase/status/1974864374952316950,0
2025-10-06 15:23:05+00:00,grummpykiddd,"jujurr ibarat mekdi pake baju ""we love vegan""",0,0,0,111,https://x.com/grummpykiddd/status/1975220272585392327,https://x.com/IndoPopBase/status/1974864374952316950,0
2025-10-05 21:21:50+00:00,udahgiting,"married 5 times, he get the struggle",0,0,0,1199,https://x.com/udahgiting/status/1974948166358503607,https://x.com/IndoPopBase/status/1974864374952316950,0
2025-10-05 22:04:05+00:00,cndkwn,I thought he only used the shirt with no reasons,0,0,0,472,https://x.com/cndkwn/status/1974958798411640960,https://x.com/IndoPopBase/status/1974864374952316950,0
2025-10-06 03:31:44+00:00,hannahbabibaker,I don't think he understands what that means,0,0,0,851,https://x.com/hannahbabibaker/status/1975041257429942638,https://x.com/IndoPopBase/status/1974864374952316950,0
2025-10-06 04:32:48+00:00,endouwed,"ems kl iy km feminis knp km dlu suka pkul mantan istri km, dsr pembohonk, jejankny msi ad y",0,0,0,268,https://x.com/endouwed/status/1975056621840855469,https://x.com/IndoPopBase/status/1974864374952316950,0
2025-10-05 16:04:32+00:00,jaegerawr,tell em,0,0,0,2875,https://x.com/jaegerawr/status/1974868315383476355,https://x.com/IndoPopBase/status/1974864374952316950,0
2025-10-06 03:20:21+00:00,pabianjingskuy,OG pervormative male,0,0,0,610,https://x.com/pabianjingskuy/status/1975038390891638988,https://x.com/IndoPopBase/status/1974864374952316950,0
2025-10-06 07:17:12+00:00,bremmafff,Awokwowkwowkk,0,0,0,108,https://x.com/bremmafff/status/1975097995260768560,https://x.com/IndoPopBase/status/1974864374952316950,0
2025-10-06 01:44:31+00:00,kesah_berkeluh,Mangsud?,0,0,0,78,https://x.com/kesah_berkeluh/status/1975014273035518269,https://x.com/IndoPopBase/status/1974864374952316950,0
2025-10-09 17:48:34+00:00,ta2ngsukucadang,"@nyanbare
 is this true",0,0,0,7,https://x.com/ta2ngsukucadang/status/1976344047926358448,https://x.com/IndoPopBase/status/1974864374952316950,0
2025-10-05 16:55:08+00:00,iullicious,Omg! Sorry for underesmating you mister ,0,0,0,789,https://x.com/iullicious/status/1974881048736764157,https://x.com/IndoPopBase/status/1974864374952316950,0
2025-10-05 15:53:37+00:00,Seung_ha_,"Prilly Latuconsina just debuted a chic bob cut  love it or miss her old look? 
@grok",1,0,0,8150,https://x.com/Seung_ha_/status/1974865568420475363,https://x.com/IndoPopBase/status/1974862659188363324,1
2025-10-06 01:03:34+00:00,aukseen,Tantiknaa,0,0,0,5738,https://x.com/aukseen/status/1975003966351261969,https://x.com/IndoPopBase/status/1974862659188363324,0
2025-10-06 07:28:59+00:00,itsufika,Tumben ga pake stuns min,0,0,0,6347,https://x.com/itsufika/status/1975100961585840136,https://x.com/IndoPopBase/status/1974862659188363324,0
2025-10-06 06:27:40+00:00,holayinn,duh cantik banget ,0,0,0,5199,https://x.com/holayinn/status/1975085528736514121,https://x.com/IndoPopBase/status/1974862659188363324,0
2025-10-05 15:42:54+00:00,ursteulyNaveen,She never misses  that bob cut suits her perfectly!,0,0,0,10623,https://x.com/ursteulyNaveen/status/1974862872674193560,https://x.com/IndoPopBase/status/1974862659188363324,0
2025-10-06 07:29:40+00:00,orang_miiskin,Ini yang pake LPG 3kg ya,2,0,0,2957,https://x.com/orang_miiskin/status/1975101132906344641,https://x.com/IndoPopBase/status/1974862659188363324,2
2025-10-06 23:12:12+00:00,raaaagaa_,"mirip 
@oceanmizt",1,0,0,312,https://x.com/raaaagaa_/status/1975338330222174321,https://x.com/IndoPopBase/status/1974862659188363324,1
2025-10-06 15:50:14+00:00,creamfie,Prilly lagi banyak pikiran ya.,0,0,0,42,https://x.com/creamfie/status/1975227106377576718,https://x.com/IndoPopBase/status/1974862659188363324,0
2025-10-06 12:34:15+00:00,Seven7chil,Mirip caca tengker,0,0,0,1147,https://x.com/Seven7chil/status/1975177786332713156,https://x.com/IndoPopBase/status/1974862659188363324,0
2025-10-05 23:17:26+00:00,vaughansdimple,"kenapa pada potong pendek sih, kemarin bcl  ttapiii emg cakepp cakeep banget, lebih fresh",0,0,0,5462,https://x.com/vaughansdimple/status/1974977260697645261,https://x.com/IndoPopBase/status/1974862659188363324,0
2025-10-06 06:01:13+00:00,elcapitano1O1,Tumben ga stun stan stun stan,0,0,0,1387,https://x.com/elcapitano1O1/status/1975078872724255115,https://x.com/IndoPopBase/status/1974862659188363324,0
2025-10-06 04:00:15+00:00,Ripalojinavi,"another bob, cakep emang bob tuh, macem-macemnya juga banyak, ada lyer, French, Italian, wavy bob",0,0,0,7291,https://x.com/Ripalojinavi/status/1975048433959678093,https://x.com/IndoPopBase/status/1974862659188363324,0
2025-10-06 08:09:01+00:00,niacincolay,Tetap tidak menarik,0,0,0,396,https://x.com/niacincolay/status/1975111035356160440,https://x.com/IndoPopBase/status/1974862659188363324,0
2025-10-07 09:58:33+00:00,fpngr_,oke sih,0,0,0,20,https://x.com/fpngr_/status/1975500987667525715,https://x.com/IndoPopBase/status/1974862659188363324,0
2025-10-05 16:05:36+00:00,bobby001_eth,"She really said “new era, who dis?”,  that bob is giving main character energy.",0,0,0,14661,https://x.com/bobby001_eth/status/1974868583974154715,https://x.com/IndoPopBase/status/1974862659188363324,0
2025-10-06 08:12:01+00:00,guust96,,0,1,0,3114,https://x.com/guust96/status/1975111792432201835,https://x.com/IndoPopBase/status/1974862659188363324,1
2025-10-06 00:25:32+00:00,ramasarigadun,"Luna maya juga potong rambut pendek.
Aroma bakal trend rambut pendek nih di dunia hiburan indo.",0,1,0,4186,https://x.com/ramasarigadun/status/1974994395192836605,https://x.com/IndoPopBase/status/1974862659188363324,1
2025-10-05 16:56:21+00:00,3usri,,0,0,0,1425,https://x.com/3usri/status/1974881357278187842,https://x.com/IndoPopBase/status/1974862659188363324,0
2025-10-06 04:39:27+00:00,blepvol2,Cakep bgt cewek Omara,0,0,0,240,https://x.com/blepvol2/status/1975058296668291234,https://x.com/IndoPopBase/status/1974862659188363324,0
2025-10-06 08:48:56+00:00,bybyje29,Cantik bgt prilly keliatan muda dan fresh,0,0,0,461,https://x.com/bybyje29/status/1975121079850119528,https://x.com/IndoPopBase/status/1974862659188363324,0
2025-10-06 07:49:17+00:00,everydayoungK,oh pantes dibilang hot sama omara wkwkwk,0,0,0,973,https://x.com/everydayoungK/status/1975106071422476359,https://x.com/IndoPopBase/status/1974862659188363324,0
2025-10-06 06:03:15+00:00,banknotebook,"Kelemahan prilli, doi cukup pendek...

Cantik pinter lucu mengesankan",0,0,0,1407,https://x.com/banknotebook/status/1975079384580297126,https://x.com/IndoPopBase/status/1974862659188363324,0
2025-10-05 23:45:07+00:00,Dreeblissa1005,Makin cantik,0,0,0,774,https://x.com/Dreeblissa1005/status/1974984224295047417,https://x.com/IndoPopBase/status/1974862659188363324,0
2025-10-06 15:44:06+00:00,Mara_mamarara,Cantikkk Prill.,0,0,0,93,https://x.com/Mara_mamarara/status/1975225561887965615,https://x.com/IndoPopBase/status/1974862659188363324,0
2025-10-06 10:07:30+00:00,kai_karis29952,Wanita paling sempurna. Titik.,0,0,0,366,https://x.com/kai_karis29952/status/1975140854785593727,https://x.com/IndoPopBase/status/1974862659188363324,0
2025-10-06 13:42:46+00:00,sukazupasoup,eh dimiapesiii cocok an gini rambutnyaa parah,0,0,0,446,https://x.com/sukazupasoup/status/1975195026042081370,https://x.com/IndoPopBase/status/1974862659188363324,0
2025-10-05 15:47:34+00:00,egirEborn,Kirain Wika,0,0,0,2199,https://x.com/egirEborn/status/1974864046332739851,https://x.com/IndoPopBase/status/1974862659188363324,0
2025-10-06 07:15:05+00:00,sahabattuhann,Then what ?,0,0,0,417,https://x.com/sahabattuhann/status/1975097463762718766,https://x.com/IndoPopBase/status/1974862659188363324,0
2025-10-06 08:44:01+00:00,tonpas75,Mantep...jadi mature,0,0,0,275,https://x.com/tonpas75/status/1975119845881761912,https://x.com/IndoPopBase/status/1974862659188363324,0
2025-10-06 05:23:55+00:00,thehot_man,kok kyok lunglit,0,0,0,274,https://x.com/thehot_man/status/1975069486358429707,https://x.com/IndoPopBase/status/1974862659188363324,0
2025-10-05 22:46:09+00:00,Nivlac2nd,Cantik Prilly Lactobacillus ,0,0,0,2594,https://x.com/Nivlac2nd/status/1974969386160288122,https://x.com/IndoPopBase/status/1974862659188363324,0
2025-10-06 14:35:18+00:00,endsteinnn,STUNS NYA MANAAA,0,0,0,68,https://x.com/endsteinnn/status/1975208248912515456,https://x.com/IndoPopBase/status/1974862659188363324,0
2025-10-06 02:08:43+00:00,flowstateeeetiy,cakep bgt buset,0,0,0,62,https://x.com/flowstateeeetiy/status/1975020362795725302,https://x.com/IndoPopBase/status/1974862659188363324,0
2025-10-05 16:33:22+00:00,alir_anxxx,Jgn di bandingin ma istri teman ya,0,0,0,1665,https://x.com/alir_anxxx/status/1974875570682073199,https://x.com/IndoPopBase/status/1974862659188363324,0
2025-10-06 19:36:10+00:00,picturesqueaff,cantik bgtttt sygg ku,0,0,0,33,https://x.com/picturesqueaff/status/1975283962793840742,https://x.com/IndoPopBase/status/1974862659188363324,0
2025-10-06 04:57:22+00:00,pancaa___,gak masuk akal,0,0,0,222,https://x.com/pancaa___/status/1975062806874800132,https://x.com/IndoPopBase/status/1974862659188363324,0
2025-10-06 06:54:22+00:00,minervsht,lucu bgttttt,0,0,0,519,https://x.com/minervsht/status/1975092249164943756,https://x.com/IndoPopBase/status/1974862659188363324,0
2025-10-06 04:44:37+00:00,heheyaterus,Cantiknyoo,0,0,0,162,https://x.com/heheyaterus/status/1975059598559346838,https://x.com/IndoPopBase/status/1974862659188363324,0
2025-10-05 16:47:40+00:00,rilanotkuma,aku banget,0,0,0,1322,https://x.com/rilanotkuma/status/1974879170166653374,https://x.com/IndoPopBase/status/1974862659188363324,0
2025-10-05 16:13:46+00:00,nnezukokawaii,stuns nya mana,0,0,0,1696,https://x.com/nnezukokawaii/status/1974870641527730303,https://x.com/IndoPopBase/status/1974862659188363324,0
2025-10-06 14:50:32+00:00,nezzaaaaaaaa,Potong gini aja kali yah,0,0,0,107,https://x.com/nezzaaaaaaaa/status/1975212081726345469,https://x.com/IndoPopBase/status/1974862659188363324,0
2025-10-06 02:01:48+00:00,·,"Liat bcl juga potong pendek, fresh bgt liatnya.. tp kembali ke muka masing2 si ya ",0,0,0,3040,https://x.com/alviaaa_/status/1975018623216628037,https://x.com/IndoPopBase/status/1974862659188363324,0
2025-10-06 09:08:25+00:00,MChijio,bob emg cakep parahh,0,0,0,121,https://x.com/MChijio/status/1975125983327064455,https://x.com/IndoPopBase/status/1974862659188363324,0
2025-10-05 22:52:55+00:00,harimingguuu,ke mane si entong?,0,0,0,689,https://x.com/harimingguuu/status/1974971087982318056,https://x.com/IndoPopBase/status/1974862659188363324,0
2025-10-05 16:55:14+00:00,kornetpedas,buset,0,0,0,1708,https://x.com/kornetpedas/status/1974881074099769817,https://x.com/IndoPopBase/status/1974862659188363324,0
2025-10-06 14:02:48+00:00,initehabdi,Kek boru naibaho,0,0,0,82,https://x.com/initehabdi/status/1975200069059248437,https://x.com/IndoPopBase/status/1974862659188363324,0
2025-10-06 00:46:05+00:00,Goodf3ll4s,Indonesian boring barbie,0,0,0,436,https://x.com/Goodf3ll4s/status/1974999569118458266,https://x.com/IndoPopBase/status/1974862659188363324,0
2025-10-06 05:15:02+00:00,cigarateszz,emang lagi era bondol,0,0,0,373,https://x.com/cigarateszz/status/1975067253310996952,https://x.com/IndoPopBase/status/1974862659188363324,0
2025-10-06 01:24:57+00:00,iyaankkkk,kaya wika salim,0,0,0,516,https://x.com/iyaankkkk/status/1975009351434903822,https://x.com/IndoPopBase/status/1974862659188363324,0
2025-10-06 13:55:41+00:00,ayrm1209,makin cantik bgt rambut pendek,0,0,0,102,https://x.com/ayrm1209/status/1975198276187201631,https://x.com/IndoPopBase/status/1974862659188363324,0
2025-10-06 00:19:23+00:00,hypmetalkid,Tim yang ga tau dia siapa ,42,2,0,29067,https://x.com/hypmetalkid/status/1974992850388672703,https://x.com/IndoPopBase/status/1974841709478793585,44
2025-10-05 14:27:00+00:00,IrulFadhilah,Ya Allah gusti beningeeee bojone wong,0,55,0,23420,https://x.com/IrulFadhilah/status/1974843773009219800,https://x.com/IndoPopBase/status/1974841709478793585,55
2025-10-05 14:19:15+00:00,PROSPERDEGREAT,"Angga Yunanda takes the chequered flag? Someone told the others that the race was real, not a TikTok challenge.",7,2,0,65169,https://x.com/PROSPERDEGREAT/status/1974841822552666251,https://x.com/IndoPopBase/status/1974841709478793585,9
2025-10-05 16:55:09+00:00,rohitsebastiian,motogp skrg butuh gimmick biar bisa bertahan,7,0,0,7493,https://x.com/rohitsebastiian/status/1974881055586066768,https://x.com/IndoPopBase/status/1974841709478793585,7
2025-10-05 16:13:28+00:00,Dhimasantasena,"Kadang banyak yang tanya kenapa dia sih?
Lahh, dia kan akamsi situ.",12,20,0,51322,https://x.com/Dhimasantasena/status/1974870563073179821,https://x.com/IndoPopBase/status/1974841709478793585,32
2025-10-06 01:17:39+00:00,tiniwinibitea,Marc jatoh juga kayaknya gegara silau sm pesonanya Angga,2,14,0,14724,https://x.com/tiniwinibitea/status/1975007511259525134,https://x.com/IndoPopBase/status/1974841709478793585,16
2025-10-05 14:19:50+00:00,Seung_ha_,"Angga Yunanda took part in the 2025 MotoGP Mandalika by waving the chequered flag who would you want to see do it next year? 
@grok",1,0,0,14244,https://x.com/Seung_ha_/status/1974841967986250105,https://x.com/IndoPopBase/status/1974841709478793585,1
2025-10-05 23:10:01+00:00,fmlver,"damn maaf bgt, tapi",1,7,0,29369,https://x.com/fmlver/status/1974975391682146742,https://x.com/IndoPopBase/status/1974841709478793585,8
2025-10-05 15:29:58+00:00,sirsakjuice,"Gw udah lama gk ngikutin GP, rossi udah pensiun?",4,0,0,11511,https://x.com/sirsakjuice/status/1974859618695401904,https://x.com/IndoPopBase/status/1974841709478793585,4
2025-10-05 14:19:43+00:00,PROSPERDEGREAT,Angga Yunanda didn’t just win. He made the whole track look slow,0,1,0,49387,https://x.com/PROSPERDEGREAT/status/1974841938613620894,https://x.com/IndoPopBase/status/1974841709478793585,1
2025-10-06 04:28:31+00:00,beautiaf,ganteng banget suami org.,0,0,0,17100,https://x.com/beautiaf/status/1975055546823979506,https://x.com/IndoPopBase/status/1974841709478793585,0
2025-10-05 14:47:07+00:00,wilonaaa,ganteng bgt suami org,0,0,0,34665,https://x.com/wilonaaa/status/1974848832786866416,https://x.com/IndoPopBase/status/1974841709478793585,0
2025-10-06 03:14:43+00:00,okapynn,Ganteng bgt anjrit anjrit,0,0,0,245,https://x.com/okapynn/status/1975036973434991096,https://x.com/IndoPopBase/status/1974841709478793585,0
2025-10-05 14:20:52+00:00,ursteulyNaveen,Now that’s a podium-level cameo  Angga really out there living the dream!,0,0,0,45588,https://x.com/ursteulyNaveen/status/1974842227517235396,https://x.com/IndoPopBase/status/1974841709478793585,0
2025-10-05 19:29:13+00:00,Dusatpatma,Harusnya bang Neo Japan lebih kerasa lokalnya.,2,0,0,3715,https://x.com/Dusatpatma/status/1974919825689645509,https://x.com/IndoPopBase/status/1974841709478793585,2
2025-10-05 23:13:24+00:00,nadaguller,istrinya bagian ngalungin medali. keren banget pasutri aatu iniii ,0,2,0,24479,https://x.com/nadaguller/status/1974976242970734742,https://x.com/IndoPopBase/status/1974841709478793585,2
2025-10-05 14:41:40+00:00,alifandri_di238,Saking semangatnya sampe robek tuh kemeja,2,0,0,28734,https://x.com/alifandri_di238/status/1974847461350121803,https://x.com/IndoPopBase/status/1974841709478793585,2
2025-10-05 15:27:06+00:00,blueskisss,"ganteng bgt pacar kita pls 
@heestoryz
 @v0rlskey",2,0,0,1732,https://x.com/blueskisss/status/1974858897338020140,https://x.com/IndoPopBase/status/1974841709478793585,2
2025-10-05 17:02:17+00:00,beeerbitch,suami orang ngapa ganteng bgt ya Allah,1,2,0,16055,https://x.com/beeerbitch/status/1974882848319705289,https://x.com/IndoPopBase/status/1974841709478793585,3
2025-10-06 07:55:21+00:00,flowsyswan,ganteng banget suami orang,0,0,0,4,https://x.com/flowsyswan/status/1975107597318636014,https://x.com/IndoPopBase/status/1974841709478793585,0
2025-10-05 14:35:14+00:00,myworldin_words,"And 
@marcmarquez93
 still didn't finish the race in Indonesia. Mandalika curse continues..",0,2,0,38039,https://x.com/myworldin_words/status/1974845841941881215,https://x.com/IndoPopBase/status/1974841709478793585,2
2025-10-06 05:32:08+00:00,BaiamCrispy,"oke angga kali ini cakep, ga kaya di dua garis biru yg kumuh itu",0,0,0,2231,https://x.com/BaiamCrispy/status/1975071557010800671,https://x.com/IndoPopBase/status/1974841709478793585,0
2025-10-05 16:27:31+00:00,winales,The only best thing that happened in #IndonesianGP : Angga with chequered flag on Sunday Grand Prix and his pretty wife Shenina gave the medals on Saturday Sprint ,0,1,0,14513,https://x.com/winales/status/1974874098817008040,https://x.com/IndoPopBase/status/1974841709478793585,1
2025-10-06 09:59:07+00:00,·,Kok ganteng?,0,0,0,1177,https://x.com/ore0blackpink/status/1975138742517260336,https://x.com/IndoPopBase/status/1974841709478793585,0
2025-10-06 05:29:16+00:00,bomslullaby,Si angga dha kaya es kelapa muda di siang hari sueger benerrrrrr,0,0,0,5111,https://x.com/bomslullaby/status/1975070833694634358,https://x.com/IndoPopBase/status/1974841709478793585,0
2025-10-05 16:45:46+00:00,kwek118,Ganteng bgt suami org ya اَللّهُ. Ganteng bgt,1,0,0,4783,https://x.com/kwek118/status/1974878693681246429,https://x.com/IndoPopBase/status/1974841709478793585,1
2025-10-05 15:16:50+00:00,unyelj,ganteng pol,2,0,0,4132,https://x.com/unyelj/status/1974856310610108702,https://x.com/IndoPopBase/status/1974841709478793585,2
2025-10-05 15:31:41+00:00,rutoarema,brooooo so fineee,0,0,0,215,https://x.com/rutoarema/status/1974860050201235669,https://x.com/IndoPopBase/status/1974841709478793585,0
2025-10-05 15:06:45+00:00,snafrez,ya Allah shenina amalannya apaan ya,1,0,0,11136,https://x.com/snafrez/status/1974853773978894458,https://x.com/IndoPopBase/status/1974841709478793585,1
2025-10-06 02:18:02+00:00,heiyoww,ganteng bgt buset,0,0,0,20,https://x.com/heiyoww/status/1975022706660880777,https://x.com/IndoPopBase/status/1974841709478793585,0
2025-10-06 04:29:00+00:00,inrettmi,Bening bangetttt suami kayu manis,0,0,0,4807,https://x.com/inrettmi/status/1975055666562961559,https://x.com/IndoPopBase/status/1974841709478793585,0
2025-10-06 02:05:45+00:00,ssindchoiii,"Gua pas nonton kemarin salpok sama dia, ganteng banget suami orang",0,0,0,2790,https://x.com/ssindchoiii/status/1975019615735664653,https://x.com/IndoPopBase/status/1974841709478793585,0
2025-10-05 22:35:46+00:00,anyaasmile,udah ganteng setia lagi masyallah,0,0,0,29,https://x.com/anyaasmile/status/1974966774946029843,https://x.com/IndoPopBase/status/1974841709478793585,0
2025-10-05 14:36:00+00:00,ursteulyNaveen,"From big screens to the racetrack, Angga Yunanda waving that chequered flag like a true champ!  #MotoGP #MandalikaGP",0,0,0,18842,https://x.com/ursteulyNaveen/status/1974846034997309747,https://x.com/IndoPopBase/status/1974841709478793585,0
2025-10-07 07:25:57+00:00,farissanyo,"@user42114120205
 jir",1,0,0,48,https://x.com/farissanyo/status/1975462584955642350,https://x.com/IndoPopBase/status/1974841709478793585,1
2025-10-06 09:56:03+00:00,indomigapenyet,gantenge bojone wong,0,0,0,74,https://x.com/indomigapenyet/status/1975137970631098488,https://x.com/IndoPopBase/status/1974841709478793585,0
2025-10-06 15:47:29+00:00,Nbilaadn,segerr bngt bang,0,0,0,81,https://x.com/Nbilaadn/status/1975226413826674973,https://x.com/IndoPopBase/status/1974841709478793585,0
2025-10-06 04:07:41+00:00,162kminlove,jujur gabisa ngebayangin pas dia main duyung duyungan ALIAS GANTENG BGT AMJINK SKRNG COK,0,0,0,755,https://x.com/162kminlove/status/1975050301943292018,https://x.com/IndoPopBase/status/1974841709478793585,0
2025-10-05 15:12:00+00:00,saands__,Cah NTB asli,0,0,0,1509,https://x.com/saands__/status/1974855094018699558,https://x.com/IndoPopBase/status/1974841709478793585,0
2025-10-06 05:14:00+00:00,anothermieee,kenapa vibes nya tu kek abis mandii gt ya SEGERRR BENER,0,0,0,424,https://x.com/anothermieee/status/1975066992299380995,https://x.com/IndoPopBase/status/1974841709478793585,0
2025-10-06 07:00:41+00:00,skybaby1504,"@ikehyun120925
 gimana gimana, suami orang inihh",1,0,0,510,https://x.com/skybaby1504/status/1975093839405920328,https://x.com/IndoPopBase/status/1974841709478793585,1
2025-10-05 15:51:28+00:00,aydeenvee,He can chequred my flagina with his angga stick,9,6,0,19432,https://x.com/aydeenvee/status/1974865029582450876,https://x.com/IndoPopBase/status/1974841709478793585,15
2025-10-06 05:39:13+00:00,prettygirlaave,"@hanaajihan
 yg tdnya cowo kita itu kul bgt ya mbak",1,0,0,200,https://x.com/prettygirlaave/status/1975073336133845361,https://x.com/IndoPopBase/status/1974841709478793585,1
2025-10-07 09:27:31+00:00,lanadelyeayy,"pdhl dulu pas jaman mermaid dia alay bgt deh, pas sama shenina jd ganteng bgt",0,0,0,68,https://x.com/lanadelyeayy/status/1975493178678780118,https://x.com/IndoPopBase/status/1974841709478793585,0
2025-10-05 16:30:44+00:00,justforcuap2,ajg ganteng bgt,1,0,0,819,https://x.com/justforcuap2/status/1974874910360309941,https://x.com/IndoPopBase/status/1974841709478793585,1
2025-10-06 04:39:00+00:00,cacoyslalala,yaelah ganteng bgt,1,0,0,536,https://x.com/cacoyslalala/status/1975058184676217187,https://x.com/IndoPopBase/status/1974841709478793585,1
2025-10-05 21:59:56+00:00,daniiixyz,"Semenjak nikah, auranya makin terpancar ya bjirrr",0,0,0,5418,https://x.com/daniiixyz/status/1974957757326619098,https://x.com/IndoPopBase/status/1974841709478793585,0
2025-10-06 06:33:18+00:00,rweeverok,"@9milesfromearth
 LIHAT LAH KECINTAANMU",1,0,0,359,https://x.com/rweeverok/status/1975086946348384499,https://x.com/IndoPopBase/status/1974841709478793585,1
2025-10-06 04:38:26+00:00,konyakukonjac,ganteng bgt anjrit??????,0,0,0,140,https://x.com/konyakukonjac/status/1975058041000391015,https://x.com/IndoPopBase/status/1974841709478793585,0
2025-10-06 04:22:18+00:00,nadiafebianti_,Cakep banget??????????? Shenina plis bagi amalannya apa bisa dapet suami begini,0,0,0,1529,https://x.com/nadiafebianti_/status/1975053980691775494,https://x.com/IndoPopBase/status/1974841709478793585,0
2025-10-05 13:43:38+00:00,aukseen,Mamah,0,0,0,4959,https://x.com/aukseen/status/1974832859451187693,https://x.com/IndoPopBase/status/1974821441347723347,0
2025-10-05 13:10:48+00:00,ursteulyNaveen,"That’s a duo nobody saw coming  whatever they’re cooking, it’s gonna be fire!",0,0,0,6288,https://x.com/ursteulyNaveen/status/1974824592624755111,https://x.com/IndoPopBase/status/1974821441347723347,0
2025-10-06 08:39:35+00:00,0xHarryry,Mommyyy ,0,0,0,1029,https://x.com/0xHarryry/status/1975118728724685244,https://x.com/IndoPopBase/status/1974821441347723347,0
2025-10-05 13:16:09+00:00,PROSPERDEGREAT,"Can we expect a banger, or are they keeping us on edge for now?",0,0,0,4376,https://x.com/PROSPERDEGREAT/status/1974825941701407141,https://x.com/IndoPopBase/status/1974821441347723347,0
2025-10-05 13:15:40+00:00,PROSPERDEGREAT,This collab just popped off my radar. I'm wondering if we’re getting a vibe that slaps or an instant banger,0,0,0,3560,https://x.com/PROSPERDEGREAT/status/1974825818766319763,https://x.com/IndoPopBase/status/1974821441347723347,0
2025-10-05 13:14:59+00:00,bobby001_eth,"That collab’s gonna be fire, studio vibes with those two always spark something catchy.",0,0,0,4813,https://x.com/bobby001_eth/status/1974825647240348023,https://x.com/IndoPopBase/status/1974821441347723347,0
2025-10-05 13:57:28+00:00,0xgasm,Gurls,0,0,0,3880,https://x.com/0xgasm/status/1974836339083505731,https://x.com/IndoPopBase/status/1974821441347723347,0
2025-10-05 13:15:17+00:00,bobby001_eth,"That collab’s got potential, studio vibes alone are already giving major hit energy.",0,0,0,3719,https://x.com/bobby001_eth/status/1974825724662923706,https://x.com/IndoPopBase/status/1974821441347723347,0
2025-10-05 14:14:26+00:00,B4n6_H4n5,"Dua orang yang exotic... 
Keren...",0,0,0,1524,https://x.com/B4n6_H4n5/status/1974840609660907899,https://x.com/IndoPopBase/status/1974821441347723347,0
2025-10-05 14:17:13+00:00,Dara_metaX,Marion Jola dan Valerie Thomas terhubung di studio... ini bisa menjadi sesuatu yang istimewa dalam karya.,0,0,0,1533,https://x.com/Dara_metaX/status/1974841308666573248,https://x.com/IndoPopBase/status/1974821441347723347,0
2025-10-05 14:16:43+00:00,Dara_metaX,Marion Jola and Valerie Thomas linking up in the studio… this could be something special in the works.,0,0,0,2115,https://x.com/Dara_metaX/status/1974841183634350237,https://x.com/IndoPopBase/status/1974821441347723347,0
2025-10-05 13:10:21+00:00,Flashworld321,Valerie thomas siapa?,4,0,0,2106,https://x.com/Flashworld321/status/1974824482025189808,https://x.com/IndoPopBase/status/1974821441347723347,4
2025-10-05 15:31:24+00:00,gelbinuy,GOKIL LALA CANTIK BGT ANJG.,0,0,0,28,https://x.com/gelbinuy/status/1974859979757904131,https://x.com/IndoPopBase/status/1974821441347723347,0
2025-10-05 13:07:13+00:00,cityleng,whoop !!!!! mommy,0,0,0,1571,https://x.com/cityleng/status/1974823690987798873,https://x.com/IndoPopBase/status/1974821441347723347,0
2025-10-05 15:40:02+00:00,richgoddessdin,"Vibenya berasa kaya jaman 90an, jaman suram",0,0,0,2113,https://x.com/richgoddessdin/status/1974862152529060090,https://x.com/IndoPopBase/status/1974821441347723347,0
2025-10-06 17:18:01+00:00,rosseaint,I CANT,0,0,0,48,https://x.com/rosseaint/status/1975249195394367519,https://x.com/IndoPopBase/status/1974821441347723347,0
2025-10-05 14:58:38+00:00,·,OH WOMEN.,0,0,0,700,https://x.com/delncate/status/1974851731256422459,https://x.com/IndoPopBase/status/1974821441347723347,0
2025-10-10 05:01:32+00:00,AsWindAndFire,Those two try to hard to look like white tiktok girls,0,0,0,2,https://x.com/AsWindAndFire/status/1976513404019044740,https://x.com/IndoPopBase/status/1974821441347723347,0
2025-10-06 01:39:41+00:00,w0lvesz,MAMAHHHHH,0,0,0,296,https://x.com/w0lvesz/status/1975013055626174794,https://x.com/IndoPopBase/status/1974821441347723347,0
2025-10-05 14:55:07+00:00,·,MY GIRLS,0,0,0,842,https://x.com/ceoce/status/1974850846275043804,https://x.com/IndoPopBase/status/1974821441347723347,0
2025-10-06 00:59:45+00:00,hiupembaik,momss,0,0,0,439,https://x.com/hiupembaik/status/1975003009726980262,https://x.com/IndoPopBase/status/1974821441347723347,0
2025-10-06 01:37:52+00:00,oasisoe,,0,0,0,245,https://x.com/oasisoe/status/1975012599852040505,https://x.com/IndoPopBase/status/1974821441347723347,0
2025-10-05 14:14:29+00:00,·,dazzling,0,0,0,930,https://x.com/ujisenberg/status/1974840621245628688,https://x.com/IndoPopBase/status/1974821441347723347,0
2025-10-07 09:00:43+00:00,iniakunrandomm_,Valerie penyanyi kah?,0,0,0,33,https://x.com/iniakunrandomm_/status/1975486436838408482,https://x.com/IndoPopBase/status/1974821441347723347,0
2025-10-05 15:36:10+00:00,persooinal,damn val is lookin like a young sophia latjuba here ,0,0,0,1697,https://x.com/persooinal/status/1974861179098177559,https://x.com/IndoPopBase/status/1974821441347723347,0
2025-10-06 04:15:19+00:00,joaobatal,pilar kehidupan,0,0,0,248,https://x.com/joaobatal/status/1975052224905777413,https://x.com/IndoPopBase/status/1974821441347723347,0
2025-10-05 17:08:52+00:00,Olinglingling,Would,0,0,0,355,https://x.com/Olinglingling/status/1974884505950605459,https://x.com/IndoPopBase/status/1974821441347723347,0
2025-10-05 12:59:20+00:00,criminalrumors,mamah,0,0,0,1036,https://x.com/criminalrumors/status/1974821709447618779,https://x.com/IndoPopBase/status/1974821441347723347,0
2025-10-06 02:17:06+00:00,herokyller,Women,0,0,0,269,https://x.com/herokyller/status/1975022472434155872,https://x.com/IndoPopBase/status/1974821441347723347,0
2025-10-06 16:01:34+00:00,pinisirinn,"Muka, ada kompetitor sherina munaf, ya valerie thomas ini, kalo liyat muka aja ya",0,0,0,80,https://x.com/pinisirinn/status/1975229957858337157,https://x.com/IndoPopBase/status/1974821441347723347,0
2025-10-05 13:05:19+00:00,Zulfamuu,terpukaauuuu,0,0,0,802,https://x.com/Zulfamuu/status/1974823212891639916,https://x.com/IndoPopBase/status/1974821441347723347,0
2025-10-05 22:29:11+00:00,JackDimie,Anya blanco?,0,0,0,289,https://x.com/JackDimie/status/1974965116409114691,https://x.com/IndoPopBase/status/1974821441347723347,0
2025-10-05 16:06:21+00:00,Udadolapdoll,Mana stun nya,0,0,0,436,https://x.com/Udadolapdoll/status/1974868774416453813,https://x.com/IndoPopBase/status/1974821441347723347,0
2025-10-05 13:28:12+00:00,izinchicken,Tercengang. Bersih kali ketiaknya,0,0,0,1041,https://x.com/izinchicken/status/1974828974862975309,https://x.com/IndoPopBase/status/1974821441347723347,0
2025-10-05 13:07:42+00:00,TheLilywhitesID,stun,0,0,0,690,https://x.com/TheLilywhitesID/status/1974823813058793838,https://x.com/IndoPopBase/status/1974821441347723347,0
2025-10-05 13:10:52+00:00,idhalftime,Fathia,0,0,0,569,https://x.com/idhalftime/status/1974824609905356814,https://x.com/IndoPopBase/status/1974821441347723347,0
2025-10-05 13:03:47+00:00,jackthegon,Stunnnn,0,0,0,619,https://x.com/jackthegon/status/1974822830635426178,https://x.com/IndoPopBase/status/1974821441347723347,0
2025-10-05 15:23:15+00:00,aswan21w,,0,0,0,268,https://x.com/aswan21w/status/1974857925706621079,https://x.com/IndoPopBase/status/1974821441347723347,0
2025-10-05 13:51:11+00:00,Love_3children,"""OMG, Marion Jola and Valerie Thomas in the studio together?! This collab is gonna be  Can't wait to hear what magic they're cooking up!",0,0,0,390,https://x.com/Love_3children/status/1974834758208418157,https://x.com/IndoPopBase/status/1974821441347723347,0
2025-10-05 09:49:57+00:00,romario_julius,'kalau ada sembilan nyawa' damn Im not cat,0,5,0,4014,https://x.com/romario_julius/status/1974774050879860973,https://x.com/IndoPopBase/status/1974754064627015925,5
2025-10-05 12:11:34+00:00,misuhmasyarakat,Kalau ada sembilan belas juta lapangan pekerjaan,0,4,0,695,https://x.com/misuhmasyarakat/status/1974809687934546408,https://x.com/IndoPopBase/status/1974754064627015925,4
2025-10-05 13:29:16+00:00,selerrktif,Adrian khalif bikin berwarna sih di semua lagu.,0,0,0,998,https://x.com/selerrktif/status/1974829241578713533,https://x.com/IndoPopBase/status/1974754064627015925,0
2025-10-05 14:23:36+00:00,sandyastina,"KALO ADAA SUMUR DILADANG
BOLEH KITA MENUMPANG MANDIIII",0,2,0,1338,https://x.com/sandyastina/status/1974842914007388475,https://x.com/IndoPopBase/status/1974754064627015925,2
2025-10-05 11:19:25+00:00,·,KALO ADA SEMBILAN NYAWAAAAA MAU SAMA MU SAJA (PRET),0,0,0,2230,https://x.com/kentangorengbv/status/1974796565207515621,https://x.com/IndoPopBase/status/1974754064627015925,0
2025-10-05 11:57:23+00:00,usalmafathin,"Tiap tap ig story hari-hari ini be like, 
""Kalau ada...""
Tap
""Kalau ada...""
Tap 
""Kalau ada...""
Tap
""Kalau ada...""",2,1,0,1071,https://x.com/usalmafathin/status/1974806118900846623,https://x.com/IndoPopBase/status/1974754064627015925,3
2025-10-05 09:29:08+00:00,klappertart_,Kalau ada sembilan naga,0,0,0,686,https://x.com/klappertart_/status/1974768811950911987,https://x.com/IndoPopBase/status/1974754064627015925,0
2025-10-05 09:49:08+00:00,mmjussX,The RNB AND POP BOYS RISING!,1,0,0,1977,https://x.com/mmjussX/status/1974773845291929735,https://x.com/IndoPopBase/status/1974754064627015925,1
2025-10-05 08:33:33+00:00,dudionline,"Kalau ada....
Sumur di ladang",0,0,0,979,https://x.com/dudionline/status/1974754820373590099,https://x.com/IndoPopBase/status/1974754064627015925,0
2025-10-05 09:38:48+00:00,lPosumA0209,"Mungkin Judul Lagunya begini?
Rizky Febian x Adrian Khalif - Alamak",0,0,0,803,https://x.com/lPosumA0209/status/1974771241308606902,https://x.com/IndoPopBase/status/1974754064627015925,0
2025-10-05 08:43:53+00:00,PROSPERDEGREAT,969k streams on day one and still not #1? Rizky Febian just flexed without breaking a sweat,0,0,0,3753,https://x.com/PROSPERDEGREAT/status/1974757421026541584,https://x.com/IndoPopBase/status/1974754064627015925,0
2025-10-05 15:32:41+00:00,uhmbeyyi,pertama dengar langsng mikir ' liriknya juicy luicy bgt' ternyata yg nulis lirik emang orang yg buatin lagu buat jusi lusi,0,0,0,781,https://x.com/uhmbeyyi/status/1974860300248817713,https://x.com/IndoPopBase/status/1974754064627015925,0
2025-10-06 08:04:19+00:00,tokopediacil,Bau2 bakal jd lagu overuse jg neh sepertinya,0,0,0,116,https://x.com/tokopediacil/status/1975109854781231261,https://x.com/IndoPopBase/status/1974754064627015925,0
2025-10-05 09:28:04+00:00,·,Deserved. Candu banget lagunyaaa,0,0,0,1236,https://x.com/CloverYeppeo/status/1974768542026453430,https://x.com/IndoPopBase/status/1974754064627015925,0
2025-10-06 10:35:45+00:00,cuntylanak_,Kalau ada makanan di meja,0,0,0,54,https://x.com/cuntylanak_/status/1975147962352406578,https://x.com/IndoPopBase/status/1974754064627015925,0
2025-10-06 05:11:32+00:00,beautiaf,"ini on repeat dr jumat wkwkw, candu",0,0,0,744,https://x.com/beautiaf/status/1975066369189425653,https://x.com/IndoPopBase/status/1974754064627015925,0
2025-10-05 08:46:48+00:00,CitaStarstories,"Baru dengerin lagunya kemarin, ternyata asik lagunya",0,0,0,2958,https://x.com/CitaStarstories/status/1974758158540398859,https://x.com/IndoPopBase/status/1974754064627015925,0
2025-10-05 11:53:57+00:00,Dara_metaX,"Jika menarik angka seperti ini pada hari pertama, mungkin akan naik lebih tinggi lagi di hari-hari mendatang. Nilai replaynya kuat",0,0,0,1983,https://x.com/Dara_metaX/status/1974805255435981235,https://x.com/IndoPopBase/status/1974754064627015925,0
2025-10-05 08:43:14+00:00,PROSPERDEGREAT,Almost a million streams and only #3? Someone tell #1 it’s getting embarrassed,0,0,0,4198,https://x.com/PROSPERDEGREAT/status/1974757257947775214,https://x.com/IndoPopBase/status/1974754064627015925,0
2025-10-05 11:49:01+00:00,T3RIP4NG,iznatgiving impact,1,0,0,55,https://x.com/T3RIP4NG/status/1974804012529529103,https://x.com/IndoPopBase/status/1974754064627015925,1
2025-10-05 17:41:29+00:00,idahnawriys,Kira-kira daily streamsnya monolog sama tabola bale berapa ya? Dapet 1jt kali ya?,0,0,0,465,https://x.com/idahnawriys/status/1974892712848740556,https://x.com/IndoPopBase/status/1974754064627015925,0
2025-10-05 10:01:53+00:00,cristhgrande,Not even 1M,1,0,0,1059,https://x.com/cristhgrande/status/1974777053795975322,https://x.com/IndoPopBase/status/1974754064627015925,1
2025-10-05 15:38:13+00:00,CaptainHwanhee,Adrian ini suaranya emang sengau2 ngondek gitu ya kalo nyanyi? Apa emang ciri khas nya gitu?,1,2,0,656,https://x.com/CaptainHwanhee/status/1974861694443954327,https://x.com/IndoPopBase/status/1974754064627015925,3
2025-10-05 08:51:58+00:00,kemangfav,Di tiktok udh banyak bgt ya pake lagu ini..,0,0,0,1616,https://x.com/kemangfav/status/1974759455175885033,https://x.com/IndoPopBase/status/1974754064627015925,0
2025-10-06 06:24:54+00:00,CaptainPeBe,Lebih suka versi “selina”,0,0,0,63,https://x.com/CaptainPeBe/status/1975084834986004777,https://x.com/IndoPopBase/status/1974754064627015925,0
2025-10-05 13:37:50+00:00,helloseakun,enak bgtttt emang diriku udh 10000x repeat satu hari,0,0,0,382,https://x.com/helloseakun/status/1974831399464231184,https://x.com/IndoPopBase/status/1974754064627015925,0
2025-10-05 08:40:46+00:00,heheheiyuU,wew ngeri,0,0,0,1451,https://x.com/heheheiyuU/status/1974756639594234355,https://x.com/IndoPopBase/status/1974754064627015925,0
2025-10-05 11:12:54+00:00,uhatuka,tapi emang enak banget JUJUR,0,0,0,549,https://x.com/uhatuka/status/1974794924198609045,https://x.com/IndoPopBase/status/1974754064627015925,0
2025-10-05 10:01:02+00:00,svadrlf,And where bernadkhia?,0,0,0,525,https://x.com/svadrlf/status/1974776838246568123,https://x.com/IndoPopBase/status/1974754064627015925,0
2025-10-05 08:32:01+00:00,Seung_ha_,"Alamak by Rizky Febian and Adrian Khalif just debuted at #3 on Spotify Indonesia  do you think it’ll hit #1 next week? 
@grok",1,0,0,1838,https://x.com/Seung_ha_/status/1974754436053697016,https://x.com/IndoPopBase/status/1974754064627015925,1
2025-10-05 11:53:20+00:00,Dara_metaX,"If it’s pulling numbers like this on day one, it might climb even higher in the coming days. The replay value is strong",0,0,0,2625,https://x.com/Dara_metaX/status/1974805100083237224,https://x.com/IndoPopBase/status/1974754064627015925,0
2025-10-05 08:31:03+00:00,ursteulyNaveen,Huge debut  Rizky and Adrian really dropped a hit with this one!,0,0,0,2658,https://x.com/ursteulyNaveen/status/1974754191525744731,https://x.com/IndoPopBase/status/1974754064627015925,0
2025-10-05 09:19:11+00:00,bobby001_eth,"Huge debut, Rizky and Adrian really caught lightning with this one, those numbers speak loud.",0,0,0,2296,https://x.com/bobby001_eth/status/1974766305711739059,https://x.com/IndoPopBase/status/1974754064627015925,0
2025-10-05 09:09:17+00:00,sugar_6378,Gak paham ini,0,1,0,1990,https://x.com/sugar_6378/status/1974763813418471662,https://x.com/IndoPopBase/status/1974754064627015925,1
2025-10-05 08:33:23+00:00,Petalscents,I read this tweet as i listen the song ,1,0,0,2535,https://x.com/Petalscents/status/1974754779571302746,https://x.com/IndoPopBase/status/1974754064627015925,1
2025-10-05 22:35:06+00:00,bocahgundu,pertama denger malah ngira lagu AI kayak suno begitu ,0,0,0,462,https://x.com/bocahgundu/status/1974966603780681885,https://x.com/IndoPopBase/status/1974754064627015925,0
2025-10-05 11:24:55+00:00,SINGKITMYLUV,WHAT???,0,0,0,612,https://x.com/SINGKITMYLUV/status/1974797946966430125,https://x.com/IndoPopBase/status/1974754064627015925,0
2025-10-05 08:40:41+00:00,Pjreex,alamak alhamdulilah,0,0,0,1223,https://x.com/Pjreex/status/1974756617540497588,https://x.com/IndoPopBase/status/1974754064627015925,0
2025-10-05 12:37:06+00:00,kuluromi,900rb-nya aku,0,0,0,384,https://x.com/kuluromi/status/1974816114522968162,https://x.com/IndoPopBase/status/1974754064627015925,0
2025-10-05 08:47:33+00:00,PJasonKleinn,well deserved ,0,0,0,636,https://x.com/PJasonKleinn/status/1974758346902434133,https://x.com/IndoPopBase/status/1974754064627015925,0
2025-10-05 16:35:57+00:00,terpamungkas,MAHALINI IMPACT ,0,0,0,135,https://x.com/terpamungkas/status/1974876222816719100,https://x.com/IndoPopBase/status/1974754064627015925,0
2025-10-06 06:53:39+00:00,dlguswingswing,Flopped & tanked,0,0,0,74,https://x.com/dlguswingswing/status/1975092068805685563,https://x.com/IndoPopBase/status/1974754064627015925,0
2025-10-05 15:31:05+00:00,aswan21w,,0,0,0,127,https://x.com/aswan21w/status/1974859897343979717,https://x.com/IndoPopBase/status/1974754064627015925,0
2025-10-05 09:27:01+00:00,BaeEvelyn24,Coming to end payola bole,0,0,0,392,https://x.com/BaeEvelyn24/status/1974768279265980785,https://x.com/IndoPopBase/status/1974754064627015925,0
2025-10-05 08:19:49+00:00,Grrrrr1230987,Disesuaiin sama kondisi hutan yang udah ditebang ya,180,2155,0,214349,https://x.com/Grrrrr1230987/status/1974751365705650431,https://x.com/IndoPopBase/status/1974750424734617996,2335
2025-10-05 08:27:57+00:00,chaechwe,asikkk pengadaan gede²an ,21,286,0,87762,https://x.com/chaechwe/status/1974753411792031968,https://x.com/IndoPopBase/status/1974750424734617996,307
2025-10-05 10:18:10+00:00,RWWReborn,"Kita bergeser ke corak MTP (multi-terrain pattern) setelah sekian lama menggunakan loreng malvinas/turunannya, sama halnya dengan militer di negara lain juga. Banyak yang asal tulis komentar seakan-akan medan pertempuran masa depan Indonesia hanya hutan hujan tropis saja .",52,175,0,143808,https://x.com/RWWReborn/status/1974781149416452395,https://x.com/IndoPopBase/status/1974750424734617996,227
2025-10-05 09:36:12+00:00,giojaifojsiada,"fyi. Loreng Baru dipilih dan didesain bukan karena Hutan kita makin gundul. tetapi karena loreng baru tergolong Multi Terrain Camouflage jadi dapat berkamuflase di berbagai medan
1. Loreng Lama 
2. Loreng Raider 
3. Loreng AD 
4. Loreng Baru 
5. Loreng SAMAR 
6. Loreng Habema",47,208,0,84949,https://x.com/giojaifojsiada/status/1974770587508818022,https://x.com/IndoPopBase/status/1974750424734617996,255
2025-10-05 09:11:59+00:00,bubuybulan,mirip hutan gundul,5,34,0,66522,https://x.com/bubuybulan/status/1974764495592730932,https://x.com/IndoPopBase/status/1974750424734617996,39
2025-10-05 08:27:31+00:00,louiseloil,"clearly its bcs our environmental its not green enough now look at to our forest, any thought?",7,41,0,30401,https://x.com/louiseloil/status/1974753303012770022,https://x.com/IndoPopBase/status/1974750424734617996,48
2025-10-05 10:33:42+00:00,vacuuvm,Well,33,103,0,37032,https://x.com/vacuuvm/status/1974785060957274123,https://x.com/IndoPopBase/status/1974750424734617996,136
2025-10-05 10:01:09+00:00,ValhallaKencana,"Nah ini motif ini Rada menyerap visual.. Lebih modern kalo pixel sih.. Loreng lama malah mencolok, bikin takut rakyat tapi jadi santapan visual musuh di hutan",0,0,0,1562,https://x.com/ValhallaKencana/status/1974776867283763473,https://x.com/IndoPopBase/status/1974750424734617996,0
2025-10-05 08:52:09+00:00,netixyenn,soalnya hutannya dah ga hijau kah buat kamuflase?,1,0,0,2027,https://x.com/netixyenn/status/1974759501850194333,https://x.com/IndoPopBase/status/1974750424734617996,1
2025-10-05 08:41:52+00:00,onikatanyajawab,change zionist president next,1,0,0,735,https://x.com/onikatanyajawab/status/1974756915323511062,https://x.com/IndoPopBase/status/1974750424734617996,1
2025-10-05 08:54:40+00:00,yan_lanes,"sekarang bukan hanya main di hutan lagi, mainnya di kantor2, di pertanian perkebunan, di ketahanan pangan, di makan bergizi dll",0,0,0,13150,https://x.com/yan_lanes/status/1974760135781441804,https://x.com/IndoPopBase/status/1974750424734617996,0
2025-10-05 08:23:20+00:00,chrono_joe,"New camouflage, new vision — soldiers ready for any terrain, not just where the green grows.

From tropical jungles to modern metropolises, the Indonesian Millitary adapts without ever losing its identity.",2,0,0,1422,https://x.com/chrono_joe/status/1974752250842206375,https://x.com/IndoPopBase/status/1974750424734617996,2
2025-10-05 18:22:18+00:00,dysrl1,duit menang ginian buat ganti seragam kali ya,0,0,0,940,https://x.com/dysrl1/status/1974902985043083353,https://x.com/IndoPopBase/status/1974750424734617996,0
2025-10-05 08:59:44+00:00,3usri,sange green,0,0,0,405,https://x.com/3usri/status/1974761412158460077,https://x.com/IndoPopBase/status/1974750424734617996,0
2025-10-05 08:39:10+00:00,DasCatipal,"'ular bisa bergonta ganti kulit, bisanya tetap saja beracun' ",0,0,0,2145,https://x.com/DasCatipal/status/1974756234546090349,https://x.com/IndoPopBase/status/1974750424734617996,0
2025-10-06 02:04:54+00:00,twitt_xyz,,0,0,0,352,https://x.com/twitt_xyz/status/1975019403743003004,https://x.com/IndoPopBase/status/1974750424734617996,0
2025-10-05 09:27:58+00:00,B4n6_H4n5,"Jangan cuma warnanya yang baru, Tapi juga Pola pikir harus baru. Sesuai dengan Perkembangan Jaman...",0,1,0,6560,https://x.com/B4n6_H4n5/status/1974768517850534107,https://x.com/IndoPopBase/status/1974750424734617996,1
2025-10-05 08:20:23+00:00,adepedia,Membantu industri tekstil,0,0,0,1423,https://x.com/adepedia/status/1974751508572012902,https://x.com/IndoPopBase/status/1974750424734617996,0
2025-10-05 09:19:34+00:00,fa_fifu,"mengikuti perkembangan zaman. ijo luntur karena hutan dibabat, coklat luntur karena tanah dikavling pejabat.",0,0,0,941,https://x.com/fa_fifu/status/1974766402407112850,https://x.com/IndoPopBase/status/1974750424734617996,0
2025-10-05 11:49:35+00:00,bluebinzeu,king bahlil impact ,0,0,0,7021,https://x.com/bluebinzeu/status/1974804156620702185,https://x.com/IndoPopBase/status/1974750424734617996,0
2025-10-06 00:05:26+00:00,faithfulpersonn,,0,0,0,385,https://x.com/faithfulpersonn/status/1974989340645429352,https://x.com/IndoPopBase/status/1974750424734617996,0
2025-10-05 08:44:25+00:00,PROSPERDEGREAT,Sage green? Looks like the army just got a glow-up for Instagram,0,0,0,83083,https://x.com/PROSPERDEGREAT/status/1974757556569641450,https://x.com/IndoPopBase/status/1974750424734617996,0
2025-10-05 09:05:09+00:00,GrnSlimey,"pls tell me im not the only one seein this pattern  , and instantly laughing my ass "" long live jokowi""",0,0,0,18233,https://x.com/GrnSlimey/status/1974762773239447720,https://x.com/IndoPopBase/status/1974750424734617996,0
2025-10-05 12:53:35+00:00,Userword_,"Kirain Tentara ga bisa upgrade skin juga
Coba kali kali pake skin ini dong.",0,1,0,834,https://x.com/Userword_/status/1974820261225812370,https://x.com/IndoPopBase/status/1974750424734617996,1
2025-10-05 12:45:48+00:00,fauz11ukman,Dari kamuflase hutan hujan ke perkebunan sawit dengan daun2 keringnya yg sangat menyatu~,0,2,0,972,https://x.com/fauz11ukman/status/1974818302821323214,https://x.com/IndoPopBase/status/1974750424734617996,2
2025-10-05 10:07:01+00:00,ivanzouw,Because we don't have enough forest anymore,4,0,0,26548,https://x.com/ivanzouw/status/1974778342189715714,https://x.com/IndoPopBase/status/1974750424734617996,4
2025-10-05 09:36:48+00:00,thettabbycat,Now change its behavior,0,0,0,6238,https://x.com/thettabbycat/status/1974770740596797909,https://x.com/IndoPopBase/status/1974750424734617996,0
2025-10-05 08:55:08+00:00,pluemonac,Asik pengadaan seragam baru,0,0,0,676,https://x.com/pluemonac/status/1974760252886442209,https://x.com/IndoPopBase/status/1974750424734617996,0
2025-10-05 15:22:38+00:00,Asep_Shelby,Ajg butut kek usa army,0,0,0,99,https://x.com/Asep_Shelby/status/1974857769766502813,https://x.com/IndoPopBase/status/1974750424734617996,0
2025-10-05 14:42:55+00:00,gerbongbagasi,"Karena tanah Indonesia sudah gersang, tidak secoklat & sehijau dulu. Makanya militer Indonesia menyesuaikan dengan ganti warna seragam.",0,0,0,403,https://x.com/gerbongbagasi/status/1974847774870138889,https://x.com/IndoPopBase/status/1974750424734617996,0
2025-10-05 08:57:25+00:00,Rifqieffendiask,"Bener sih hutannya udah ga seijo dulu wkwkwk, udah bekas galian dan sawit semua seperti gambar di kanan",0,0,0,962,https://x.com/Rifqieffendiask/status/1974760826931462415,https://x.com/IndoPopBase/status/1974750424734617996,0
2025-10-05 09:05:57+00:00,sineasrms,Berubah menyesuaikan hutan kita yg banyak berubah jd kebun sawit,0,0,0,9455,https://x.com/sineasrms/status/1974762976646463703,https://x.com/IndoPopBase/status/1974750424734617996,0
2025-10-05 08:56:41+00:00,troublemaekers,Pattern baru yg cocok untuk OOTD pembebasan lahan melawan warga sendiri! ,0,0,0,807,https://x.com/troublemaekers/status/1974760642587615415,https://x.com/IndoPopBase/status/1974750424734617996,0
2025-10-05 12:19:08+00:00,ssleepyboyy,,0,0,0,426,https://x.com/ssleepyboyy/status/1974811593646252444,https://x.com/IndoPopBase/status/1974750424734617996,0
2025-10-05 08:41:26+00:00,bayuwicak14,Ijo camo Bahlil,0,0,0,7793,https://x.com/bayuwicak14/status/1974756807446069753,https://x.com/IndoPopBase/status/1974750424734617996,0
2025-10-05 09:58:15+00:00,bagaswghani,Harusnya coklat aja gak si? Biar nyamar di tambang lebih gampang,0,0,0,194,https://x.com/bagaswghani/status/1974776136103268363,https://x.com/IndoPopBase/status/1974750424734617996,0
2025-10-05 11:22:49+00:00,kamle1n,Yuyur bagus wkwk. Tapi JUJUR nambah anggaran,0,0,0,89,https://x.com/kamle1n/status/1974797420967203050,https://x.com/IndoPopBase/status/1974750424734617996,0
2025-10-05 11:40:55+00:00,RakyatChungus,Thank Fucking God Nigga.,0,0,0,89,https://x.com/RakyatChungus/status/1974801973443809313,https://x.com/IndoPopBase/status/1974750424734617996,0
2025-10-05 12:21:29+00:00,Pawangmagang,,4,0,0,21411,https://x.com/Pawangmagang/status/1974812184090943559,https://x.com/IndoPopBase/status/1974750424734617996,4
2025-10-05 08:25:15+00:00,Seung_ha_,"do you prefer the old design or the new one? 
@grok",1,0,0,17129,https://x.com/Seung_ha_/status/1974752734600741080,https://x.com/IndoPopBase/status/1974750424734617996,1
2025-10-05 08:44:48+00:00,PROSPERDEGREAT,"From jungle camo to sage green, it looks like the army’s trying to match my bedroom walls",0,0,0,50873,https://x.com/PROSPERDEGREAT/status/1974757655211388985,https://x.com/IndoPopBase/status/1974750424734617996,0
2025-10-05 08:21:24+00:00,ursteulyNaveen,"The new look’s clean  sage green gives it a modern, tactical vibe.",0,0,0,6972,https://x.com/ursteulyNaveen/status/1974751762990194936,https://x.com/IndoPopBase/status/1974750424734617996,0
2025-10-05 13:33:30+00:00,jerawat_imut,Udah gundul kah hutannya?,1,0,0,5024,https://x.com/jerawat_imut/status/1974830307947024520,https://x.com/IndoPopBase/status/1974750424734617996,1
2025-10-06 10:46:49+00:00,gepengsekali,"Diubah karena tempat kamuflasenya sdh gak ada, alias hutannya sdh gundul semua dibabat dan dirusak oleh pemerintah berkolaborasi dg masyatakatnya sendiri.",0,0,0,238,https://x.com/gepengsekali/status/1975150749261947385,https://x.com/IndoPopBase/status/1974750424734617996,0
2025-10-06 07:16:53+00:00,AdiX404,Pertanda Indonesia sudah tidak begitu hijau lagi?,0,0,0,40,https://x.com/AdiX404/status/1975097917246767159,https://x.com/IndoPopBase/status/1974750424734617996,0
2025-10-05 15:23:53+00:00,reaumurr,"Yg kiri biar nyaru sama warna hutan dan pepohonan, yg kanan biar nyaru sama hutan yg udah gundul",0,0,0,355,https://x.com/reaumurr/status/1974858087455731735,https://x.com/IndoPopBase/status/1974750424734617996,0
2025-10-05 09:24:01+00:00,UdangPostur,bertempur di area tambang yg tandus kah maniiesss. wwkkwkww,0,0,0,520,https://x.com/UdangPostur/status/1974767524597371073,https://x.com/IndoPopBase/status/1974750424734617996,0
2025-10-05 09:59:48+00:00,brooklynbrick89,Kenapa gak warna oranye aja,1,0,0,80,https://x.com/brooklynbrick89/status/1974776529772216657,https://x.com/IndoPopBase/status/1974750424734617996,1
2025-10-05 10:22:53+00:00,RKinashi,asik lahan basah korupsi,0,0,0,92,https://x.com/RKinashi/status/1974782338887520285,https://x.com/IndoPopBase/status/1974750424734617996,0
2025-10-06 15:58:47+00:00,dance_o2,deforestation camou,0,0,0,29,https://x.com/dance_o2/status/1975229256230916542,https://x.com/IndoPopBase/status/1974750424734617996,0
2025-10-05 06:45:34+00:00,hidupbodoamat,Opick is the writer of this song.,1,0,0,632,https://x.com/hidupbodoamat/status/1974727647717658764,https://x.com/IndoPopBase/status/1974725648439783772,1
2025-10-05 07:01:37+00:00,PROSPERDEGREAT,"Man, nostalgia hit hard ‘Dealova’ is 20 and still slaps. Who else can’t decide if once Mekel dropped the chick-magnet anthem or the heartbreak ballad first?",0,0,0,547,https://x.com/PROSPERDEGREAT/status/1974731687939711093,https://x.com/IndoPopBase/status/1974725648439783772,0
2025-10-05 07:36:31+00:00,nindya311,"Daripada yg dinyanyiin ulang sama si penyanyi amatir itu, mending yg ini sih. Syahdu banget dulu.",0,0,0,351,https://x.com/nindya311/status/1974740468174029039,https://x.com/IndoPopBase/status/1974725648439783772,0
2025-10-05 10:59:10+00:00,InzaTechMedia,Ada gak Versi Lofi-nya dari Lagu ini?,0,0,0,228,https://x.com/InzaTechMedia/status/1974791468033462511,https://x.com/IndoPopBase/status/1974725648439783772,0
2025-10-05 07:47:08+00:00,moonchiatto,BEST INTRO,0,0,0,247,https://x.com/moonchiatto/status/1974743142932054228,https://x.com/IndoPopBase/status/1974725648439783772,0
2025-10-05 06:53:32+00:00,yohkkubi,Wdym it was released 3 years ago?!?!?!?!?!?,0,0,0,290,https://x.com/yohkkubi/status/1974729652225909169,https://x.com/IndoPopBase/status/1974725648439783772,0
2025-10-05 08:34:06+00:00,ursteulyNaveen,Two decades later and it still hits the heart the same way  timeless masterpiece.,0,0,0,359,https://x.com/ursteulyNaveen/status/1974754960060596249,https://x.com/IndoPopBase/status/1974725648439783772,0
2025-10-05 07:02:17+00:00,PROSPERDEGREAT,"20 years and still hitting harder than most new releases, who else remembers blasting this on repeat like it was yesterday?",0,0,0,462,https://x.com/PROSPERDEGREAT/status/1974731852562026645,https://x.com/IndoPopBase/status/1974725648439783772,0
2025-10-05 06:44:13+00:00,Seung_ha_,Dealova by Once Mekel turns 20 today a timeless Indonesian love song that still hits the heart. ,0,0,0,364,https://x.com/Seung_ha_/status/1974727306007769217,https://x.com/IndoPopBase/status/1974725648439783772,0
2025-10-05 09:02:47+00:00,GobloSayaBilang,Opick version is better when the night comes,1,0,0,279,https://x.com/GobloSayaBilang/status/1974762177660960815,https://x.com/IndoPopBase/status/1974725648439783772,1
2025-10-05 14:58:12+00:00,dvviad,lagu villain sinetron religi tobat,0,0,0,133,https://x.com/dvviad/status/1974851622699479074,https://x.com/IndoPopBase/status/1974725648439783772,0
2025-10-05 11:48:33+00:00,ardwiwik,Dealova was released 20 years ago and I still remember the lyrics to this day. Who would have thought that Dealova would get stuck in my head for so long? Definitely a masterpiece,0,0,0,282,https://x.com/ardwiwik/status/1974803896863522917,https://x.com/IndoPopBase/status/1974725648439783772,0
2025-10-05 15:19:21+00:00,kakaknyaleo,"Dealova
Dira - Ibel - Kara - Lova

APAAN
Tapi w dagdigdug baca novelnye dulu",0,0,0,193,https://x.com/kakaknyaleo/status/1974856944935690370,https://x.com/IndoPopBase/status/1974725648439783772,0
2025-10-05 07:17:31+00:00,yoisoba_,beautiful,0,0,0,225,https://x.com/yoisoba_/status/1974735686415810946,https://x.com/IndoPopBase/status/1974725648439783772,0
2025-10-05 07:47:23+00:00,ocikal13,Directly hit the heart,0,0,0,203,https://x.com/ocikal13/status/1974743205859213805,https://x.com/IndoPopBase/status/1974725648439783772,0
2025-10-05 08:31:07+00:00,firzafp,Aura lagu rohanis,0,0,0,155,https://x.com/firzafp/status/1974754208109953269,https://x.com/IndoPopBase/status/1974725648439783772,0
2025-10-05 16:11:07+00:00,suryandria,Lovable but prefer Opick’s version ,1,0,0,179,https://x.com/suryandria/status/1974869971831488818,https://x.com/IndoPopBase/status/1974725648439783772,1
2025-10-06 02:33:03+00:00,bocahgundu,"nggak pernah nonton filmnya karena dulu masih bocil, tapi sering banget lihat iklan filmnya di TV dan... yakkk suka banget sama lagu ini, sampe sekarang masih ingat ",0,0,0,70,https://x.com/bocahgundu/status/1975026487981142041,https://x.com/IndoPopBase/status/1974725648439783772,0
2025-10-05 14:15:31+00:00,jaegerawr,this song wins 4x platinum in my room,0,0,0,193,https://x.com/jaegerawr/status/1974840881099551183,https://x.com/IndoPopBase/status/1974725648439783772,0
2025-10-05 11:00:13+00:00,gieeforfun,one of my fave,0,0,0,142,https://x.com/gieeforfun/status/1974791732530483517,https://x.com/IndoPopBase/status/1974725648439783772,0
2025-10-05 15:25:37+00:00,akuragil,,0,0,0,78,https://x.com/akuragil/status/1974858524049219901,https://x.com/IndoPopBase/status/1974725648439783772,0
2025-10-05 10:11:41+00:00,3usri,Banger,0,0,0,176,https://x.com/3usri/status/1974779520386474154,https://x.com/IndoPopBase/status/1974725648439783772,0
2025-10-05 09:08:43+00:00,KurniawanRicho,Dealova favorite song,0,0,0,190,https://x.com/KurniawanRicho/status/1974763674427699600,https://x.com/IndoPopBase/status/1974725648439783772,0
2025-10-05 06:42:05+00:00,bluemoonikii,Unknown,1,1,0,249,https://x.com/bluemoonikii/status/1974726770042827217,https://x.com/IndoPopBase/status/1974725648439783772,2
2025-10-05 14:34:54+00:00,heyyitsgemini,best bgt ini lagu ,0,0,0,69,https://x.com/heyyitsgemini/status/1974845758609477633,https://x.com/IndoPopBase/status/1974725648439783772,0
2025-10-04 06:22:21+00:00,sfulr,"“My milkshake brings all the boys to the yard
And they're like it's better than yours”",1,0,0,12161,https://x.com/sfulr/status/1974359417106936234,https://x.com/IndoPopBase/status/1974358569475846538,1
2025-10-05 10:33:18+00:00,suhfectionist,Neo got my back,2,8,0,7674,https://x.com/suhfectionist/status/1974784957555093550,https://x.com/IndoPopBase/status/1974358569475846538,10
2025-10-04 06:51:57+00:00,svadrlf,"Ini fotonya pasang pasangan ya ceritanya Aku ship yang depan, cup",0,1,0,9623,https://x.com/svadrlf/status/1974366865347784988,https://x.com/IndoPopBase/status/1974358569475846538,1
2025-10-04 06:41:58+00:00,ayaisysmn,tell me you're milly without telling me you're  milly,0,1,0,9571,https://x.com/ayaisysmn/status/1974364352036942315,https://x.com/IndoPopBase/status/1974358569475846538,1
2025-10-04 07:12:59+00:00,qiksversal,,0,0,0,6846,https://x.com/qiksversal/status/1974372157552800013,https://x.com/IndoPopBase/status/1974358569475846538,0
2025-10-04 06:28:10+00:00,gubernurgotham,Mamet yang tidak Mamet,0,0,0,6206,https://x.com/gubernurgotham/status/1974360880176640497,https://x.com/IndoPopBase/status/1974358569475846538,0
2025-10-05 12:04:41+00:00,velvetxmenace,w gak bisa lupain scene si borne tiba² nyanyi dan minionnya tiba² cartwheel ,0,0,0,3143,https://x.com/velvetxmenace/status/1974807956509360302,https://x.com/IndoPopBase/status/1974358569475846538,0
2025-10-04 11:07:29+00:00,SukaSetengah,MashaAllah mamet kamu kok ngga ngemamet,0,0,0,5369,https://x.com/SukaSetengah/status/1974431172362182702,https://x.com/IndoPopBase/status/1974358569475846538,0
2025-10-04 06:49:04+00:00,Love_3children,The first published version of Rangga and Cinta still holds the highest position in the hearts of,0,0,0,3300,https://x.com/Love_3children/status/1974366141830345129,https://x.com/IndoPopBase/status/1974358569475846538,0
2025-10-04 11:48:24+00:00,·,TWICE YES OR YES,0,0,0,1689,https://x.com/masaendeberr/status/1974441469974138982,https://x.com/IndoPopBase/status/1974358569475846538,0
2025-10-05 03:10:48+00:00,guifey,,0,0,0,1253,https://x.com/guifey/status/1974673601443053899,https://x.com/IndoPopBase/status/1974358569475846538,0
2025-10-04 06:27:16+00:00,Seung_ha_,"Which Rangga & Cinta cast member do you think stole the spotlight in their Cosmopolitan Indonesia shoot? 
@grok",1,0,0,5195,https://x.com/Seung_ha_/status/1974360653059273157,https://x.com/IndoPopBase/status/1974358569475846538,1
2025-10-06 07:44:22+00:00,lail_23,Kirain yg jd rangga yg agak bule pojok itu,0,0,0,352,https://x.com/lail_23/status/1975104831099687200,https://x.com/IndoPopBase/status/1974358569475846538,0
2025-10-06 02:10:05+00:00,ditdawe,WADAW,0,0,0,212,https://x.com/ditdawe/status/1975020708746125473,https://x.com/IndoPopBase/status/1974358569475846538,0
2025-10-04 07:19:20+00:00,ursteulyNaveen,The reunion we’ve all been waiting for  The Rangga & Cinta cast looking effortlessly iconic in this Cosmopolitan Indonesia shoot. ,0,0,0,1301,https://x.com/ursteulyNaveen/status/1974373756329210189,https://x.com/IndoPopBase/status/1974358569475846538,0
2025-10-04 06:24:31+00:00,PROSPERDEGREAT,This cast just made the word “stunning” look lazy. How does one group have this much chemistry?,0,0,0,1346,https://x.com/PROSPERDEGREAT/status/1974359963276619956,https://x.com/IndoPopBase/status/1974358569475846538,0
2025-10-05 15:00:46+00:00,tabolt,Itu yg cepak akim bagil kah?,0,0,0,1389,https://x.com/tabolt/status/1974852268727132434,https://x.com/IndoPopBase/status/1974358569475846538,0
2025-10-05 10:54:07+00:00,crodhet,alya cakeo bgy,0,0,0,1237,https://x.com/crodhet/status/1974790196307857548,https://x.com/IndoPopBase/status/1974358569475846538,0
2025-10-04 17:57:09+00:00,bandungprideg,Belakang kanan mantannya si kekeyi ya,0,0,0,3038,https://x.com/bandungprideg/status/1974534268576780581,https://x.com/IndoPopBase/status/1974358569475846538,0
2025-10-04 10:36:41+00:00,primrodite,Nct,0,0,0,1192,https://x.com/primrodite/status/1974423420986442189,https://x.com/IndoPopBase/status/1974358569475846538,0
2025-10-04 06:43:30+00:00,07postmeridiem,goat,0,0,0,2570,https://x.com/07postmeridiem/status/1974364740765036923,https://x.com/IndoPopBase/status/1974358569475846538,0
2025-10-05 01:15:25+00:00,·,kayak ga asing sama fotonyaa,0,0,0,1947,https://x.com/seltumbuhann/status/1974644560795140554,https://x.com/IndoPopBase/status/1974358569475846538,0
2025-10-04 07:25:02+00:00,desift1,EL Putra ...,0,0,0,3835,https://x.com/desift1/status/1974375189883568365,https://x.com/IndoPopBase/status/1974358569475846538,0
2025-10-04 13:15:46+00:00,shinypiplupp,Cakep amat mamet….,0,0,0,1265,https://x.com/shinypiplupp/status/1974463456544960572,https://x.com/IndoPopBase/status/1974358569475846538,0
2025-10-05 08:50:53+00:00,oktiara_k,GAP ad,0,0,0,967,https://x.com/oktiara_k/status/1974759184723034475,https://x.com/IndoPopBase/status/1974358569475846538,0
2025-10-04 06:54:10+00:00,oneitlove,Nct 2020,0,0,0,1792,https://x.com/oneitlove/status/1974367423433511290,https://x.com/IndoPopBase/status/1974358569475846538,0
2025-10-05 10:20:25+00:00,KDecade35774,Nct 2018 Black On Black photoshoot,0,0,0,415,https://x.com/KDecade35774/status/1974781717585268880,https://x.com/IndoPopBase/status/1974358569475846538,0
2025-10-04 06:36:25+00:00,jackthegon,Stunnnnn,0,0,0,969,https://x.com/jackthegon/status/1974362956520698267,https://x.com/IndoPopBase/status/1974358569475846538,0
2025-10-03 19:28:08+00:00,WilliamAndals,"Padahal mereka bertiga populer banget, tapi kalau naik bus antar kota antar provinsi kenapa full dangdut, koplo + dewa19 ya musiknya. Sampai muak aku dengernya ",71,94,0,82554,https://x.com/WilliamAndals/status/1974194776468844689,https://x.com/IndoPopBase/status/1974134779827339622,165
2025-10-03 16:09:44+00:00,HILARlO,"Ketiganya layak mendapatkannya. Karena selain suaranya bagus, juga mereka ini pintar menciptakan lagu sendiri, mengingat tidak banyak penyanyi wanita yang bisa melakukannya.",0,6,0,19771,https://x.com/HILARlO/status/1974144848543559903,https://x.com/IndoPopBase/status/1974134779827339622,6
2025-10-03 16:05:31+00:00,cruellostsummer,notice how it’s all female artists?‍,40,29,0,41506,https://x.com/cruellostsummer/status/1974143786185077187,https://x.com/IndoPopBase/status/1974134779827339622,69
2025-10-03 15:30:47+00:00,ursteulyNaveen,"Bernadya started the year strong, NIKI ruled the middle, and Nadin Amizah is closing 2025 in style ",1,1,0,31319,https://x.com/ursteulyNaveen/status/1974135045763051922,https://x.com/IndoPopBase/status/1974134779827339622,2
2025-10-03 15:31:08+00:00,CorenswetsSlut,and tiara MIDdini? FLOPPPP LOL,6,0,0,10704,https://x.com/CorenswetsSlut/status/1974135133600166304,https://x.com/IndoPopBase/status/1974134779827339622,6
2025-10-03 16:47:06+00:00,arwahgoyangkrwg,And icha chellow???,4,2,0,11490,https://x.com/arwahgoyangkrwg/status/1974154253183877544,https://x.com/IndoPopBase/status/1974134779827339622,6
2025-10-03 16:50:09+00:00,menjalang,"Week 0: Sleep
Week 420: Sleep",0,0,0,3160,https://x.com/menjalang/status/1974155019198083204,https://x.com/IndoPopBase/status/1974134779827339622,0
2025-10-03 21:17:16+00:00,666Gorky,Lah perasaan suaranya sama aja dah semuanya,7,5,0,12701,https://x.com/666Gorky/status/1974222241291436193,https://x.com/IndoPopBase/status/1974134779827339622,12
2025-10-03 16:26:26+00:00,randussyy,listnya cewe semua. mmpus penyanyi cowo indon floppy,6,1,0,2461,https://x.com/randussyy/status/1974149053329125436,https://x.com/IndoPopBase/status/1974134779827339622,7
2025-10-03 16:13:13+00:00,twice_jypnation,"Kalo seandainya ini zaman 2010s 
Mungkin isinya Band Band dan Group Group Band",2,0,0,3676,https://x.com/twice_jypnation/status/1974145727665483808,https://x.com/IndoPopBase/status/1974134779827339622,2
2025-10-03 22:58:03+00:00,moonchildren555,"Bernadya = 6 weeks
NIKI = 18 weeks
Nadin = 16 weeks",1,0,0,1398,https://x.com/moonchildren555/status/1974247604184649929,https://x.com/IndoPopBase/status/1974134779827339622,1
2025-10-03 15:30:58+00:00,Seung_ha_,"Who do you think will finish the year on top? 
@grok",2,0,0,34302,https://x.com/Seung_ha_/status/1974135091552268648,https://x.com/IndoPopBase/status/1974134779827339622,2
2025-10-03 15:40:43+00:00,PROSPERDEGREAT,"NIKI’s run was dominant, but Nadin taking over this long is impressive. Wonder if Bernadya can bounce back before year’s end.",0,0,0,43660,https://x.com/PROSPERDEGREAT/status/1974137547195625858,https://x.com/IndoPopBase/status/1974134779827339622,0
2025-10-03 16:22:53+00:00,leftblur,niki pls,0,0,0,596,https://x.com/leftblur/status/1974148156737925165,https://x.com/IndoPopBase/status/1974134779827339622,0
2025-10-04 04:36:23+00:00,triswaldo,"""Spotify""",0,0,0,527,https://x.com/triswaldo/status/1974332749298409566,https://x.com/IndoPopBase/status/1974134779827339622,0
2025-10-03 15:39:17+00:00,AkadeMichie,next week niken minaj,0,0,0,1425,https://x.com/AkadeMichie/status/1974137187844436219,https://x.com/IndoPopBase/status/1974134779827339622,0
2025-10-03 17:07:33+00:00,KnoxEventDude,who are these people?,0,0,0,358,https://x.com/KnoxEventDude/status/1974159398856765526,https://x.com/IndoPopBase/status/1974134779827339622,0
2025-10-03 15:32:00+00:00,zeroncese,this holy trinity... iktr,0,0,0,3483,https://x.com/zeroncese/status/1974135353742336137,https://x.com/IndoPopBase/status/1974134779827339622,0
2025-10-03 22:13:29+00:00,fikri_ink,Ayo Lyodra kamu bisaa,0,0,0,367,https://x.com/fikri_ink/status/1974236387936215054,https://x.com/IndoPopBase/status/1974134779827339622,0
2025-10-03 23:18:05+00:00,Filekosonk,IJAHHH,0,0,0,167,https://x.com/Filekosonk/status/1974252644903563403,https://x.com/IndoPopBase/status/1974134779827339622,0
2025-10-03 16:36:18+00:00,tragedidari,"So, where is ambiVert? Is a flop?",0,0,0,876,https://x.com/tragedidari/status/1974151536717750753,https://x.com/IndoPopBase/status/1974134779827339622,0
2025-10-03 15:33:00+00:00,mingdilf,look how they are all women,0,0,0,707,https://x.com/mingdilf/status/1974135605207748846,https://x.com/IndoPopBase/status/1974134779827339622,0
2025-10-05 05:12:05+00:00,gakgakgaaaak,Overrated.,0,0,0,14,https://x.com/gakgakgaaaak/status/1974704119857516938,https://x.com/IndoPopBase/status/1974134779827339622,0
2025-10-03 18:33:28+00:00,fuckmiyuzik,love u nadin,0,0,0,385,https://x.com/fuckmiyuzik/status/1974181021261443516,https://x.com/IndoPopBase/status/1974134779827339622,0
2025-10-04 22:18:24+00:00,lelakibudiman,BNN,0,0,0,38,https://x.com/lelakibudiman/status/1974600015227339103,https://x.com/IndoPopBase/status/1974134779827339622,0
2025-10-03 16:44:26+00:00,akkuushon,divas,0,0,0,235,https://x.com/akkuushon/status/1974153579616481728,https://x.com/IndoPopBase/status/1974134779827339622,0
2025-10-04 07:13:42+00:00,nanurais3,the power of genZ girls ,0,0,0,196,https://x.com/nanurais3/status/1974372338788642933,https://x.com/IndoPopBase/status/1974134779827339622,0
2025-10-05 05:55:07+00:00,nanioooooooo,gua wali mpe kiamat,0,0,0,21,https://x.com/nanioooooooo/status/1974714950385062363,https://x.com/IndoPopBase/status/1974134779827339622,0
2025-10-04 03:44:29+00:00,budi_wicaksono,Teu wawuh euy.,0,0,0,208,https://x.com/budi_wicaksono/status/1974319690098094575,https://x.com/IndoPopBase/status/1974134779827339622,0
2025-10-03 15:49:14+00:00,·,"queens, all of them ",0,0,0,930,https://x.com/enradbaser/status/1974139688350069127,https://x.com/IndoPopBase/status/1974134779827339622,0
2025-10-03 16:24:09+00:00,cupang_fish,Deserve,0,0,0,1135,https://x.com/cupang_fish/status/1974148477925146742,https://x.com/IndoPopBase/status/1974134779827339622,0
2025-10-03 15:55:05+00:00,danseee_,NADH1N AHMIJAH,0,0,0,490,https://x.com/danseee_/status/1974141161213485125,https://x.com/IndoPopBase/status/1974134779827339622,0
2025-10-03 16:07:16+00:00,BlueOceanwe,"Deserved
Yashh Queen",0,0,0,572,https://x.com/BlueOceanwe/status/1974144229845958804,https://x.com/IndoPopBase/status/1974134779827339622,0
2025-10-03 20:00:41+00:00,fithrah_m,etdah warga spotify sedih mulu,0,0,0,423,https://x.com/fithrah_m/status/1974202969538326742,https://x.com/IndoPopBase/status/1974134779827339622,0
2025-10-03 18:13:19+00:00,iniyangasli_,Wowww,0,0,0,269,https://x.com/iniyangasli_/status/1974175948473053447,https://x.com/IndoPopBase/status/1974134779827339622,0
2025-10-03 16:02:00+00:00,oosaurus,my queen niken salindri?,0,0,0,413,https://x.com/oosaurus/status/1974142902478778552,https://x.com/IndoPopBase/status/1974134779827339622,0
2025-10-03 15:48:46+00:00,apagunanyayaya,Mtv ampuh,0,0,0,513,https://x.com/apagunanyayaya/status/1974139574667653405,https://x.com/IndoPopBase/status/1974134779827339622,0
2025-10-03 15:37:42+00:00,Ihyanursamsie,wow,0,0,0,970,https://x.com/Ihyanursamsie/status/1974136786290192403,https://x.com/IndoPopBase/status/1974134779827339622,0
2025-10-04 08:32:01+00:00,yogie_rezki,Nadin Amizah stun Spotify,0,0,0,200,https://x.com/yogie_rezki/status/1974392047969923314,https://x.com/IndoPopBase/status/1974134779827339622,0
2025-10-04 13:37:29+00:00,BossCizu,"Wow,, kalau playlist gue sih ini nders..",0,0,0,65,https://x.com/BossCizu/status/1974468921542767083,https://x.com/IndoPopBase/status/1974134779827339622,0
2025-10-03 23:40:21+00:00,nanalyn_____,global streams or local?? niki always stable at 4M++ since January,0,0,0,69,https://x.com/nanalyn_____/status/1974258251702456779,https://x.com/IndoPopBase/status/1974134779827339622,0
2025-10-03 15:40:55+00:00,baerizzz,Outnez mo could nevehh,0,0,0,317,https://x.com/baerizzz/status/1974137598793929072,https://x.com/IndoPopBase/status/1974134779827339622,0
2025-10-03 17:59:33+00:00,pisaangkejuenak,?,1,0,0,204,https://x.com/pisaangkejuenak/status/1974172483281723807,https://x.com/IndoPopBase/status/1974134779827339622,1
2025-10-03 15:40:18+00:00,jackthegon,Bernadya ,0,0,0,1602,https://x.com/jackthegon/status/1974137443487256708,https://x.com/IndoPopBase/status/1974134779827339622,0
2025-10-04 13:03:12+00:00,Bluebluey99,Lagu2nya Nadin tuh emang feel nya beda banget ya. Kerasaaa sekali.,0,0,0,18,https://x.com/Bluebluey99/status/1974460295973380201,https://x.com/IndoPopBase/status/1974134779827339622,0
2025-10-04 03:11:34+00:00,brontotaurus_,"nadin tida pernah absen di kantorku, selalu masuk playlist wajib ak dan teman""",0,0,0,59,https://x.com/brontotaurus_/status/1974311403076137395,https://x.com/IndoPopBase/status/1974134779827339622,0
2025-10-03 16:38:53+00:00,okcarun,And agnes moggednica?,0,0,0,130,https://x.com/okcarun/status/1974152183525568594,https://x.com/IndoPopBase/status/1974134779827339622,0
2025-10-03 16:59:09+00:00,veraamiamore,dont end hagnez like that,0,0,0,309,https://x.com/veraamiamore/status/1974157284726206852,https://x.com/IndoPopBase/status/1974134779827339622,0
2025-10-03 16:14:58+00:00,nezdaily,We need Tulus to release something,1,5,0,2405,https://x.com/nezdaily/status/1974146166024778096,https://x.com/IndoPopBase/status/1974133737752608866,6
2025-10-03 15:49:35+00:00,byrdzxmb,Its me and my membasuh/evaluasi repeats,0,0,0,1743,https://x.com/byrdzxmb/status/1974139777143492789,https://x.com/IndoPopBase/status/1974133737752608866,0
2025-10-03 18:24:29+00:00,mbaditaaa,Yeah!,0,2,0,2321,https://x.com/mbaditaaa/status/1974178761471111231,https://x.com/IndoPopBase/status/1974133737752608866,2
2025-10-03 15:27:58+00:00,PROSPERDEGREAT,Hindia holding the top spot that long says a lot about his reach. Who else in Indonesia can even challenge him right now?,0,0,0,2505,https://x.com/PROSPERDEGREAT/status/1974134339396120867,https://x.com/IndoPopBase/status/1974133737752608866,0
2025-10-03 15:33:39+00:00,erlotinibb,Welcome back.. Hindia,0,0,0,1420,https://x.com/erlotinibb/status/1974135767032316321,https://x.com/IndoPopBase/status/1974133737752608866,0
2025-10-04 08:34:22+00:00,dwinucleo,"Kan dah ku bilang: pergi kerja bersama .Feast, pulang kerja bersama Hindia. ",0,0,0,325,https://x.com/dwinucleo/status/1974392639886897479,https://x.com/IndoPopBase/status/1974133737752608866,0
2025-10-04 07:34:24+00:00,dhilornodhil,"@elonmusk
 tolong lah bot ini di apakan dulu biar gak apa kali",0,0,0,321,https://x.com/dhilornodhil/status/1974377550806986769,https://x.com/IndoPopBase/status/1974133737752608866,0
2025-10-03 15:27:41+00:00,PROSPERDEGREAT,30 weeks on top is crazy consistency. Wonder who’s even close to challenging him right now,0,0,0,2269,https://x.com/PROSPERDEGREAT/status/1974134266264170700,https://x.com/IndoPopBase/status/1974133737752608866,0
2025-10-03 15:28:22+00:00,ursteulyNaveen,Hindia’s dominance is unreal  30 weeks on top shows just how deeply his music connects with listeners across Indonesia.,0,0,0,2165,https://x.com/ursteulyNaveen/status/1974134439258329249,https://x.com/IndoPopBase/status/1974133737752608866,0
2025-10-04 03:45:23+00:00,gavinthorrr,ini udah gaada yang teriak teriak satanis lagi? WKWKWKWKWK,1,0,0,693,https://x.com/gavinthorrr/status/1974319915806101865,https://x.com/IndoPopBase/status/1974133737752608866,1
2025-10-03 15:44:58+00:00,goodafternif,"alhamdulillah abang gue #suksesloeye

tapi apakah ga ada plan ikut cabut dari spotify juga?",0,0,0,1394,https://x.com/goodafternif/status/1974138616277520517,https://x.com/IndoPopBase/status/1974133737752608866,0
2025-10-04 07:30:08+00:00,childeryy,akulah salah satu bagian yang tiap detik dengerin,0,0,0,274,https://x.com/childeryy/status/1974376474103951860,https://x.com/IndoPopBase/status/1974133737752608866,0
2025-10-04 07:27:31+00:00,bussinesacc__,sukses lu ye,0,0,0,217,https://x.com/bussinesacc__/status/1974375818035184042,https://x.com/IndoPopBase/status/1974133737752608866,0
2025-10-03 15:28:50+00:00,ursteulyNaveen,Hindia on top  30 weeks straight!,0,0,0,1762,https://x.com/ursteulyNaveen/status/1974134556405215633,https://x.com/IndoPopBase/status/1974133737752608866,0
2025-10-03 15:28:03+00:00,Seung_ha_,"which of his songs do you think fans streamed the most? 
@grok",1,0,0,1595,https://x.com/Seung_ha_/status/1974134359004455337,https://x.com/IndoPopBase/status/1974133737752608866,1
2025-10-03 15:30:39+00:00,paduaras,deserve,1,0,0,1749,https://x.com/paduaras/status/1974135011373953124,https://x.com/IndoPopBase/status/1974133737752608866,1
2025-10-04 04:01:47+00:00,AD4Mindfulnes,Is it somehow related to indian mother tongue Hindi + India ? Does anyone has some idea ??,1,0,0,411,https://x.com/AD4Mindfulnes/status/1974324041696825441,https://x.com/IndoPopBase/status/1974133737752608866,1
2025-10-04 09:21:46+00:00,aqordonut,"Hindia terlalu op njir, di kantor sampe yg nyetel dia gw suruh next",0,1,0,592,https://x.com/aqordonut/status/1974404567065649363,https://x.com/IndoPopBase/status/1974133737752608866,1
2025-10-04 09:11:12+00:00,astagalanaga,Hindayeu!!!,0,0,0,147,https://x.com/astagalanaga/status/1974401908715692536,https://x.com/IndoPopBase/status/1974133737752608866,0
2025-10-04 10:04:46+00:00,Atrheides,Udah sukses banget ya sekarang lu bang.,0,0,0,211,https://x.com/Atrheides/status/1974415387996697008,https://x.com/IndoPopBase/status/1974133737752608866,0
2025-10-04 03:01:57+00:00,loloodite,congrets yh kriwil,0,0,0,481,https://x.com/loloodite/status/1974308986188161082,https://x.com/IndoPopBase/status/1974133737752608866,0
2025-10-05 03:11:03+00:00,decrdwbla,it's me and my kids on repeat,0,0,0,62,https://x.com/decrdwbla/status/1974673662147227873,https://x.com/IndoPopBase/status/1974133737752608866,0
2025-10-04 07:05:22+00:00,jihandzahab,Everything you are ,0,0,0,243,https://x.com/jihandzahab/status/1974370241770852362,https://x.com/IndoPopBase/status/1974133737752608866,0
2025-10-03 16:00:00+00:00,Leonaderune,i just know spotify is a twink...,0,0,0,84,https://x.com/Leonaderune/status/1974142400961654908,https://x.com/IndoPopBase/status/1974133737752608866,0
2025-10-03 15:46:12+00:00,jackthegon,Congrats feast,1,0,0,797,https://x.com/jackthegon/status/1974138926848971183,https://x.com/IndoPopBase/status/1974133737752608866,1
2025-10-04 01:40:16+00:00,aswan21w,aca aca,0,0,0,357,https://x.com/aswan21w/status/1974288426372640831,https://x.com/IndoPopBase/status/1974133737752608866,0
2025-10-03 12:45:03+00:00,Zuttomayonise,"When Courage (red) is no longer intertwined with Purity (white).

Leaving behind only those who dare to do anything without any pure intention, and those who have pure intentions, no longer dare to do anything.",30,1428,0,129447,https://x.com/Zuttomayonise/status/1974093338497429770,https://x.com/IndoPopBase/status/1974074028173525354,1458
2025-10-03 11:40:37+00:00,·,sang saka sense how evil spirited tni actually are and decided to drop the first warning,3,939,0,116330,https://x.com/hyugagged/status/1974077122298945893,https://x.com/IndoPopBase/status/1974074028173525354,942
2025-10-03 12:41:00+00:00,itsufika,Mau nyalahin angin juga ga bisa karena angin ga punya ktp,31,404,0,123856,https://x.com/itsufika/status/1974092318971199492,https://x.com/IndoPopBase/status/1974074028173525354,435
2025-10-03 11:53:51+00:00,jannahseeker99,"Sang merah putih be like: malas

Yang lepas merah artinya seakan-akan keberanian, kekuatan, semangat untuk berkorban demi bangsa itu udah gak ada buktinya mafia dimana-mana, parcok idf tingkahnya udah begitu bejatnya, mbg gagal total belum ditarik demi bangsa, geng solo, dll.",3,337,0,52621,https://x.com/jannahseeker99/status/1974080453591396557,https://x.com/IndoPopBase/status/1974074028173525354,340
2025-10-03 12:18:54+00:00,billllliiee,Black clouds in the background and a torn flag. It's bad sign for us,2,207,0,62586,https://x.com/billllliiee/status/1974086759781945831,https://x.com/IndoPopBase/status/1974074028173525354,209
2025-10-03 11:43:10+00:00,sunshinetally4,"oh mother nature was pissed!, it was all your fault fraudbowo and fufufafa!",2,204,0,43205,https://x.com/sunshinetally4/status/1974077764157518219,https://x.com/IndoPopBase/status/1974074028173525354,206
2025-10-03 12:48:45+00:00,dimsthekid,it is a 'give-up' flag rn,2,108,0,38878,https://x.com/dimsthekid/status/1974094268311740673,https://x.com/IndoPopBase/status/1974074028173525354,110
2025-10-03 13:01:54+00:00,BoxerAfro,,5,54,0,35662,https://x.com/BoxerAfro/status/1974097579949600871,https://x.com/IndoPopBase/status/1974074028173525354,59
2025-10-03 11:48:38+00:00,rischolast,Bendera indo & rakyat yg sering didzolimi pemerentah be like:,1,4,0,19864,https://x.com/rischolast/status/1974079141160104413,https://x.com/IndoPopBase/status/1974074028173525354,5
2025-10-03 11:45:03+00:00,aawwaaaawwaa,"Warga X: ""Indonesia gk akan maju kalau di otak rakyatnya masih agama dan hal2 ngga logis"" 
Also warga X melihat ini: ""Ini pertandaa syurgaaa... Alam sudah memberi kode... Pertanda apa ini?... Lihatlah merah yg berarti berani terlepas dari putih lambang kesucian, ini buruk...""",17,10,0,7152,https://x.com/aawwaaaawwaa/status/1974078240504545781,https://x.com/IndoPopBase/status/1974074028173525354,27
2025-10-03 15:57:57+00:00,sunaxlev,"Tinggal putih. :)
Sudah menyerah, gencatan senjata. Negeri ini sudah terlalu banyak dikuasai mafia & korupsi.",0,2,0,863,https://x.com/sunaxlev/status/1974141883149688898,https://x.com/IndoPopBase/status/1974074028173525354,2
2025-10-03 12:40:15+00:00,ndroe_,today's rehearsal worked successfully,11,11,0,14070,https://x.com/ndroe_/status/1974092132823818342,https://x.com/IndoPopBase/status/1974074028173525354,22
2025-10-03 12:42:12+00:00,conscientiamea,"emang seremonial yang ngabisin duit kayak gini penting, huh? Nah kan, mending gausah ngadi². Robek kan benderanya. Udah dibilang mamah juga, gausah dirayain ultahnya, ngabisin duit. Mending ditabung buat beli beras.",0,0,0,1353,https://x.com/conscientiamea/status/1974092620071870659,https://x.com/IndoPopBase/status/1974074028173525354,0
2025-10-03 12:22:03+00:00,adrmptra,"kebangetan korupnya, sampe benang diembat",2,1,0,46580,https://x.com/adrmptra/status/1974087552169853187,https://x.com/IndoPopBase/status/1974074028173525354,3
2025-10-03 17:36:45+00:00,f4tl0l,"Karena sekarang sang keberanian/merah di Indonesia sudah nggak sejalan dengan sang kesucian/putih. Yg berani sekarang yg tidak suci, sedangkan yg suci dibungkam atau tidak berdaya untuk melawan. Bahkan kebobrokan dan kejahatan pun mengatasnamakan kesucian Indonesia. Pertanda.",1,3,0,4128,https://x.com/f4tl0l/status/1974166748707578190,https://x.com/IndoPopBase/status/1974074028173525354,4
2025-10-03 12:02:07+00:00,mwkerr1916,"Sang Merah Putih tidak sudi tanahnya dinodai kelakuan parjo.

Pas giliran parcok, bakal robek juga ga ya?",0,4,0,14506,https://x.com/mwkerr1916/status/1974082533538345445,https://x.com/IndoPopBase/status/1974074028173525354,4
2025-10-03 11:46:02+00:00,ghoulesper,"Alampun udah nyerah, berkibarlah bendera putih",1,0,0,13821,https://x.com/ghoulesper/status/1974078485720375515,https://x.com/IndoPopBase/status/1974074028173525354,1
2025-10-03 12:23:45+00:00,Ddharny1,Itu gk adakah yg lari menyelematkan bendera detidaknya jangan sampai menyentuh tanah..ini yg berdiri berbaris cuma bengong dimanakah jiwa ksatria nasionalis patriotnya ??,5,0,0,1865,https://x.com/Ddharny1/status/1974087979045171432,https://x.com/IndoPopBase/status/1974074028173525354,5
2025-10-03 11:41:17+00:00,motherlander,Uh-oh..,1,0,0,10667,https://x.com/motherlander/status/1974077293049086341,https://x.com/IndoPopBase/status/1974074028173525354,1
2025-10-03 12:59:37+00:00,Pak_Mulll,"Kementerian lain saat hari jadinya lebih memilih tanpa perayaan yang besar, hanya melakukan upacara dgn sederhana krn menghargai kondisi ekonomi rakyat yg sdang menurun.

Instansi ini malah sebaliknya",0,0,0,898,https://x.com/Pak_Mulll/status/1974097004080026073,https://x.com/IndoPopBase/status/1974074028173525354,0
2025-10-03 14:40:26+00:00,tedy_ang_,"akhirnya indonesia bubar terkabulkan semakin cepat bubar negeri ini semakin bagus, sudah muak dengan pejabat korup",0,2,0,244,https://x.com/tedy_ang_/status/1974122375949230269,https://x.com/IndoPopBase/status/1974074028173525354,2
2025-10-03 12:00:34+00:00,ndroe_,beautiful like diamonds in the sky ,2,1,0,1600,https://x.com/ndroe_/status/1974082143321309373,https://x.com/IndoPopBase/status/1974074028173525354,3
2025-10-03 12:38:46+00:00,shintaeffendi,"Masih latihan/persiapan, HUT TNI 5 oktober. ",1,1,0,8279,https://x.com/shintaeffendi/status/1974091757001585085,https://x.com/IndoPopBase/status/1974074028173525354,2
2025-10-03 11:42:08+00:00,lizziemylovey,were cooked y’all,0,0,0,7517,https://x.com/lizziemylovey/status/1974077506409189583,https://x.com/IndoPopBase/status/1974074028173525354,0
2025-10-03 13:06:50+00:00,LenaSutanto,Waduh ,0,3,0,663,https://x.com/LenaSutanto/status/1974098822684160210,https://x.com/IndoPopBase/status/1974074028173525354,3
2025-10-04 03:33:33+00:00,kevandaputra,Buat budget bikin bendera aja dikorupsi. Hadeh.,0,0,0,95,https://x.com/kevandaputra/status/1974316937405739026,https://x.com/IndoPopBase/status/1974074028173525354,0
2025-10-03 15:49:08+00:00,chris_akis,Bad Sign banget anjirrr ,0,0,0,406,https://x.com/chris_akis/status/1974139666183205220,https://x.com/IndoPopBase/status/1974074028173525354,0
2025-10-04 03:38:37+00:00,quickeningg,bendera aja capek sama ni negara,0,1,0,86,https://x.com/quickeningg/status/1974318212931273117,https://x.com/IndoPopBase/status/1974074028173525354,1
2025-10-03 11:31:14+00:00,xAvellesch,surrender ceremonial,0,0,0,5487,https://x.com/xAvellesch/status/1974074762126311494,https://x.com/IndoPopBase/status/1974074028173525354,0
2025-10-04 07:36:27+00:00,obetoy,"orang2 pada gak sadar, ini sebenarnya performing art, jadi ada makna tersirat dibalik sobeknya merah-putih yang dipaksa berkibar di ""lingga-yoni"", sungguh sangat seni  kerennn",0,0,0,206,https://x.com/obetoy/status/1974378063170544095,https://x.com/IndoPopBase/status/1974074028173525354,0
2025-10-03 19:50:45+00:00,ramasarigadun,Ini jelas penyebabnya angin yang kencang sehingga mengoyak sang saka merah putih. Anginya pasti dihembuskan oleh antek-antek asing yang gak suka kalo indonesia maju. Tangkap anis!,0,0,0,81,https://x.com/ramasarigadun/status/1974200469561188574,https://x.com/IndoPopBase/status/1974074028173525354,0
2025-10-03 17:22:23+00:00,DatukPanduto_,This would be a natural sign that currently Indonesia is unsave conditions and potential collapse immediately,0,0,0,153,https://x.com/DatukPanduto_/status/1974163134031278222,https://x.com/IndoPopBase/status/1974074028173525354,0
2025-10-03 13:37:23+00:00,Tanju5Syafrudin,Kode alam ada dua kubu dalam tubuh TNI,0,0,0,165,https://x.com/Tanju5Syafrudin/status/1974106508444254390,https://x.com/IndoPopBase/status/1974074028173525354,0
2025-10-03 16:29:40+00:00,gitaskndr,"Ya Tuhan.. apakah ini pertanda....

Jengjeng jengjeeeeng~
Zoomin zoomout",0,0,0,114,https://x.com/gitaskndr/status/1974149863509221381,https://x.com/IndoPopBase/status/1974074028173525354,0
2025-10-03 13:03:43+00:00,xyzzah_,"kalau game over kan mengibarkan bendera putih,",0,0,0,2228,https://x.com/xyzzah_/status/1974098035203584058,https://x.com/IndoPopBase/status/1974074028173525354,0
2025-10-03 23:08:36+00:00,iluvtari,"Aku zaman paskib dlu klo bendera jatuh suruh nangkep, gak boleh sampe nyentuh tanah. Tp blm ada kejadian sampe kebelah gini sih 
Sang Saka jd bendera putih: nyerah ",0,0,0,356,https://x.com/iluvtari/status/1974250260655452329,https://x.com/IndoPopBase/status/1974074028173525354,0
2025-10-03 15:51:31+00:00,PrijayantoDhony,"Kok jadi inget ramalan Tarot kartu terakhir yang mengenai ""Tower"" ya, njiir merinding pas ngetik ini",1,0,0,392,https://x.com/PrijayantoDhony/status/1974140263812772239,https://x.com/IndoPopBase/status/1974074028173525354,1
2025-10-03 14:09:14+00:00,nyamukbtina,It's a sign from god...,0,0,0,142,https://x.com/nyamukbtina/status/1974114524228915497,https://x.com/IndoPopBase/status/1974074028173525354,0
2025-10-03 12:12:29+00:00,Wicaksusanoo,what an ominous omen,0,0,0,293,https://x.com/Wicaksusanoo/status/1974085141552377975,https://x.com/IndoPopBase/status/1974074028173525354,0
2025-10-03 16:20:53+00:00,TikTocShop,vendor jahit nya ketar ketir,0,0,0,922,https://x.com/TikTocShop/status/1974147656500076638,https://x.com/IndoPopBase/status/1974074028173525354,0
2025-10-03 14:22:11+00:00,hh_hosea,"Waduh...!
Hopefully bukan pertanda buruk.",0,0,0,6646,https://x.com/hh_hosea/status/1974117783421292731,https://x.com/IndoPopBase/status/1974074028173525354,0
2025-10-04 02:50:22+00:00,SumaClove,Uang beli benderanya di korupsi...,0,0,0,3031,https://x.com/SumaClove/status/1974306071234912291,https://x.com/IndoPopBase/status/1974074028173525354,0
2025-10-03 14:43:11+00:00,ArifLabMed,"Titi wanci, wis wayahe, sama seperti saat gus dur keluar dari istana hanya mengenakan celana pendek, ini juga pertanda",0,0,0,133,https://x.com/ArifLabMed/status/1974123068051370060,https://x.com/IndoPopBase/status/1974074028173525354,0
2025-10-03 13:32:07+00:00,ChandraAD327189,Semoga bukan pertanda merah dari darah yang tumpah di bumi pertiwi ini,0,0,0,270,https://x.com/ChandraAD327189/status/1974105184851931306,https://x.com/IndoPopBase/status/1974074028173525354,0
2025-10-04 00:46:13+00:00,20th_07,"   to      to   
Bersiap... Kesucian dan kemurnian akan datang...",0,0,0,13,https://x.com/20th_07/status/1974274827864453125,https://x.com/IndoPopBase/status/1974074028173525354,0
2025-10-04 00:37:25+00:00,txtfrompram,"Mungkin Tuhan mulai bosan melihat tingkah kita
Yang selalu salah dan bangga dengan dosa-dosa
Atau alam mulai enggan bersahabat dengan kita
Coba kita bertanya pada rumput yang bergoyang",0,0,0,367,https://x.com/txtfrompram/status/1974272609853608002,https://x.com/IndoPopBase/status/1974074028173525354,0
2025-10-03 12:55:00+00:00,reddd_cherry,Bahkan semesta tak merestui,0,0,0,33,https://x.com/reddd_cherry/status/1974095844371804529,https://x.com/IndoPopBase/status/1974074028173525354,0
2025-10-03 12:05:12+00:00,GratiaKn,Merahnya berontak karena nyawa manusia semakin gak ada harganya,0,0,0,45,https://x.com/GratiaKn/status/1974083312223428798,https://x.com/IndoPopBase/status/1974074028173525354,0
2025-10-04 06:32:21+00:00,A146417,Apakah alam memberi isyarat atas kondisi Indonesia ??,0,0,0,66,https://x.com/A146417/status/1974361933857108130,https://x.com/IndoPopBase/status/1974074028173525354,0
2025-10-05 01:47:32+00:00,artaccceritanya,jangan jangan anginnya antek antek asheengg,0,0,0,13,https://x.com/artaccceritanya/status/1974652646251471262,https://x.com/IndoPopBase/status/1974074028173525354,0
2025-10-03 09:04:42+00:00,wasbrat,had my 10 year old ass crying like I had gone though a multiple divorces and lost my three kids and the dog,1,2,0,949,https://x.com/wasbrat/status/1974037885595640128,https://x.com/IndoPopBase/status/1974036938777907429,3
2025-10-03 09:36:57+00:00,ardhypam,Indonesian pop queen,0,1,0,485,https://x.com/ardhypam/status/1974046000735285488,https://x.com/IndoPopBase/status/1974036938777907429,1
2025-10-03 10:11:05+00:00,TejaAru05798875,I really despreate for another sadass bop from her,0,1,0,668,https://x.com/TejaAru05798875/status/1974054591252869549,https://x.com/IndoPopBase/status/1974036938777907429,1
2025-10-03 09:36:41+00:00,ardhypam,The music industry for a reason,0,1,0,521,https://x.com/ardhypam/status/1974045935526457730,https://x.com/IndoPopBase/status/1974036938777907429,1
2025-10-03 12:01:42+00:00,sanihanii,Ballad Monica we missed you ,0,1,0,474,https://x.com/sanihanii/status/1974082430018765132,https://x.com/IndoPopBase/status/1974036938777907429,1
2025-10-04 06:02:08+00:00,libraboyyy68,She was And still the best till this day,0,1,0,194,https://x.com/libraboyyy68/status/1974354331018383370,https://x.com/IndoPopBase/status/1974036938777907429,1
2025-10-03 12:23:10+00:00,Xyz545X,"time so flies,,,~",0,1,0,461,https://x.com/Xyz545X/status/1974087832009650308,https://x.com/IndoPopBase/status/1974036938777907429,1
2025-10-03 09:01:10+00:00,calmdownhunny,the music industry,0,0,0,464,https://x.com/calmdownhunny/status/1974036996919099622,https://x.com/IndoPopBase/status/1974036938777907429,0
2025-10-03 10:13:58+00:00,ursteulyNaveen,14 years on and ‘Rindu’ still hits the heart the same way.  Agnes Monica’s timeless voice made this song an unforgettable classic in Indonesian music history. ,0,0,0,732,https://x.com/ursteulyNaveen/status/1974055315357536388,https://x.com/IndoPopBase/status/1974036938777907429,0
2025-10-04 01:43:27+00:00,Anti_Takhayul,2011 udah 14 tahun yg lalu ,0,0,0,183,https://x.com/Anti_Takhayul/status/1974289229607022886,https://x.com/IndoPopBase/status/1974036938777907429,0
2025-10-03 13:05:04+00:00,kokobuncit,Bring back Ce Monikah Muljoto singing ballads till her vocal cords file for early retirement!,0,0,0,539,https://x.com/kokobuncit/status/1974098375080570923,https://x.com/IndoPopBase/status/1974036938777907429,0
2025-10-03 13:47:59+00:00,lemonlyme44,aku suka bgt lagu ini (sampe skrg),0,0,0,291,https://x.com/lemonlyme44/status/1974109177531539527,https://x.com/IndoPopBase/status/1974036938777907429,0
2025-10-03 11:21:44+00:00,cho2MLHC,"Produced by Pay Burman, he also playing guitars on this tracks.",0,0,0,542,https://x.com/cho2MLHC/status/1974072370785886331,https://x.com/IndoPopBase/status/1974036938777907429,0
2025-10-03 10:04:12+00:00,SINGKITMYLUV,SMASH HIT,0,0,0,456,https://x.com/SINGKITMYLUV/status/1974052861202858194,https://x.com/IndoPopBase/status/1974036938777907429,0
2025-10-03 10:48:47+00:00,3usri,Banger ,0,0,0,424,https://x.com/3usri/status/1974064078944694621,https://x.com/IndoPopBase/status/1974036938777907429,0
2025-10-03 09:51:59+00:00,ikan_ikangoreng,love her,0,0,0,551,https://x.com/ikan_ikangoreng/status/1974049785800724858,https://x.com/IndoPopBase/status/1974036938777907429,0
2025-10-03 09:36:29+00:00,kucing_jingga,we need her to reheat those nachos,0,0,0,428,https://x.com/kucing_jingga/status/1974045884368163268,https://x.com/IndoPopBase/status/1974036938777907429,0
2025-10-03 09:12:08+00:00,pulentembem,In her prime era,0,0,0,457,https://x.com/pulentembem/status/1974039754456117363,https://x.com/IndoPopBase/status/1974036938777907429,0
2025-10-03 09:12:45+00:00,9999911111101O,I love this vibe,0,0,0,564,https://x.com/9999911111101O/status/1974039911901900849,https://x.com/IndoPopBase/status/1974036938777907429,0
2025-10-03 13:10:37+00:00,93mygloss,Love it!,0,31,0,5403,https://x.com/93mygloss/status/1974099771116990806,https://x.com/IndoPopBase/status/1974024525973971010,31
2025-10-03 10:44:40+00:00,haikarrll85,Maizura bareface cantik banget Ya Allah..,0,9,0,4005,https://x.com/haikarrll85/status/1974063042129506348,https://x.com/IndoPopBase/status/1974024525973971010,9
2025-10-03 11:59:48+00:00,dawbrigidaw,time flies..,1,10,0,4783,https://x.com/dawbrigidaw/status/1974081951448641822,https://x.com/IndoPopBase/status/1974024525973971010,11
2025-10-03 10:14:44+00:00,puqimike,"Scoringnya enak enak gila, dan tahun lalu ternyata dapet kesempatan dimentorin sama sound department nih film ",0,0,0,3505,https://x.com/puqimike/status/1974055510187126890,https://x.com/IndoPopBase/status/1974024525973971010,0
2025-10-03 12:26:42+00:00,nsabdill4h,liat foto pertama bawaannya pengen drop ini,5,2,0,3443,https://x.com/nsabdill4h/status/1974088722049384788,https://x.com/IndoPopBase/status/1974024525973971010,7
2025-10-03 14:05:36+00:00,kedempetan,"and my pov of how it’s like being a teenager change, 6 years ago today.",0,1,0,1708,https://x.com/kedempetan/status/1974113610919276913,https://x.com/IndoPopBase/status/1974024525973971010,1
2025-10-03 08:14:46+00:00,ursteulyNaveen,6 years already?  Bebas still feels so fresh—what a timeless coming-of-age story. ,0,0,0,4068,https://x.com/ursteulyNaveen/status/1974025317703692708,https://x.com/IndoPopBase/status/1974024525973971010,0
2025-10-03 08:50:45+00:00,sugar_6378,Ini siapa yah?,5,0,0,4513,https://x.com/sugar_6378/status/1974034373679657370,https://x.com/IndoPopBase/status/1974024525973971010,5
2025-10-04 05:11:31+00:00,cegil_in_action,Pertama kali liat Lutesha disini... Buseeet cakep bener,1,0,0,348,https://x.com/cegil_in_action/status/1974341590325067850,https://x.com/IndoPopBase/status/1974024525973971010,1
2025-10-04 04:45:14+00:00,bobomboi,"Marsha Timothy ini cantik banget, tapi kok mukanya kaya yg cape gitu ya di beberapa filmnya dia.",0,0,0,412,https://x.com/bobomboi/status/1974334978281648249,https://x.com/IndoPopBase/status/1974024525973971010,0
2025-10-03 09:20:54+00:00,mahrani97,Best remake ever ,0,0,0,1006,https://x.com/mahrani97/status/1974041964611039503,https://x.com/IndoPopBase/status/1974024525973971010,0
2025-10-03 23:57:36+00:00,eucairoo,"wow udah 6 th aja, cepet bgt. pengen rewatch soalnya seru bgt lah gilak",0,0,0,333,https://x.com/eucairoo/status/1974262591468810659,https://x.com/IndoPopBase/status/1974024525973971010,0
2025-10-03 19:15:00+00:00,zyyyyyy00,Ada temen gue yang as always muter nih film kalo lagi nginep bareng,0,0,0,918,https://x.com/zyyyyyy00/status/1974191473940967898,https://x.com/IndoPopBase/status/1974024525973971010,0
2025-10-04 17:20:51+00:00,ttavhir,"geng bebas gue haha, lulus sma 2020 tapi",0,1,0,122,https://x.com/ttavhir/status/1974525132686409903,https://x.com/IndoPopBase/status/1974024525973971010,1
2025-10-03 08:18:54+00:00,sirsakjuice,Kalo streamingnya dimana ya?,2,0,0,3053,https://x.com/sirsakjuice/status/1974026361884062003,https://x.com/IndoPopBase/status/1974024525973971010,2
2025-10-03 16:04:11+00:00,yaudasibeb,Ini luthesa debut ngga si? Keren bgt doi disini ,1,0,0,2303,https://x.com/yaudasibeb/status/1974143454029754673,https://x.com/IndoPopBase/status/1974024525973971010,1
2025-10-04 01:58:12+00:00,Atti_pr,Film yang diputar ulang2 nggak bosan. ,1,0,0,276,https://x.com/Atti_pr/status/1974292939980619841,https://x.com/IndoPopBase/status/1974024525973971010,1
2025-10-04 07:39:26+00:00,citruuush,6 tahun yg lalu?... GILA inget bgt kata bapak gw nih film seru  dan itu udah 6 THN yg lalu,0,0,0,162,https://x.com/citruuush/status/1974378816031371429,https://x.com/IndoPopBase/status/1974024525973971010,0
2025-10-03 17:11:51+00:00,annesthecie,Lutesha cantik bgt disini plss suka bgt rambut kitingnya,0,0,0,308,https://x.com/annesthecie/status/1974160482887217448,https://x.com/IndoPopBase/status/1974024525973971010,0
2025-10-03 10:27:17+00:00,gmtmozes,Buset im old,0,0,0,688,https://x.com/gmtmozes/status/1974058669697573074,https://x.com/IndoPopBase/status/1974024525973971010,0
2025-10-03 08:19:41+00:00,Seung_ha_,"Bebas premiered 6 years ago today do you remember which classic Korean film it was adapted from?
@grok",1,0,0,2311,https://x.com/Seung_ha_/status/1974026558391140864,https://x.com/IndoPopBase/status/1974024525973971010,1
2025-10-03 10:37:40+00:00,optimuswixlaa,ini yg originalnya film korea Sunny bukan?,1,0,0,1833,https://x.com/optimuswixlaa/status/1974061282535092485,https://x.com/IndoPopBase/status/1974024525973971010,1
2025-10-03 13:48:39+00:00,lemonlyme44,udh 6 tahun dan 'ingin menontonku' masih selalu wacana,1,0,0,1759,https://x.com/lemonlyme44/status/1974109345706356990,https://x.com/IndoPopBase/status/1974024525973971010,1
2025-10-03 22:59:16+00:00,octovi_,hah??udah 6 tahun lalu?!! gilakk cepet bgt waktu berlaluu,1,0,0,457,https://x.com/octovi_/status/1974247910708507078,https://x.com/IndoPopBase/status/1974024525973971010,1
2025-10-03 18:50:02+00:00,Syiva_AWd,"""Jidat Lo lebar kayak parkir timur!""",1,0,0,296,https://x.com/Syiva_AWd/status/1974185190634500590,https://x.com/IndoPopBase/status/1974024525973971010,1
2025-10-04 02:24:49+00:00,bubblegumbitc__,"@nnishiken
 gila kt nonton 6taun lalu ya brrt di sency wakakak",1,0,0,492,https://x.com/bubblegumbitc__/status/1974299637923393954,https://x.com/IndoPopBase/status/1974024525973971010,1
2025-10-04 08:09:40+00:00,skidvnn,GOAT,0,0,0,52,https://x.com/skidvnn/status/1974386422569431166,https://x.com/IndoPopBase/status/1974024525973971010,0
2025-10-03 14:04:12+00:00,Ramdhan_1810,"Please release music scoringnya 
@rizariri
 @MirLes
 @milesfilms",0,0,0,677,https://x.com/Ramdhan_1810/status/1974113259017170982,https://x.com/IndoPopBase/status/1974024525973971010,0
2025-10-03 08:27:56+00:00,radian1990,Sherylyola and Luteshkhia are being blamed for the film’s flop,0,0,0,1389,https://x.com/radian1990/status/1974028633120649508,https://x.com/IndoPopBase/status/1974024525973971010,0
2025-10-04 05:00:28+00:00,unmatchedboi,No one in my office get this movie when we watched it together and that's sad that they don't have taste (their go to watch movie is obv horror) ,0,0,0,351,https://x.com/unmatchedboi/status/1974338809270825053,https://x.com/IndoPopBase/status/1974024525973971010,0
2025-10-03 16:45:40+00:00,lahsiapaaku_,Lutesha masih mode jutek,0,0,0,309,https://x.com/lahsiapaaku_/status/1974153890611503160,https://x.com/IndoPopBase/status/1974024525973971010,0
2025-10-03 16:20:54+00:00,LyfeIsSoGr8,But it flopped unfortunately,0,0,0,330,https://x.com/LyfeIsSoGr8/status/1974147657179541764,https://x.com/IndoPopBase/status/1974024525973971010,0
2025-10-03 14:43:01+00:00,cineppapi,GOAT!!!!,0,0,0,298,https://x.com/cineppapi/status/1974123026070618486,https://x.com/IndoPopBase/status/1974024525973971010,0
2025-10-03 12:05:52+00:00,sweet__revenges,Bagusssssss bgt dulu rewatch 2x sm ex bf (mas suami),0,0,0,1438,https://x.com/sweet__revenges/status/1974083478984724987,https://x.com/IndoPopBase/status/1974024525973971010,0
2025-10-04 02:50:16+00:00,zenday4hat,"Jir 6 tahun yg lalu ya, bangkee dah lama bgt",0,0,0,81,https://x.com/zenday4hat/status/1974306046299791409,https://x.com/IndoPopBase/status/1974024525973971010,0
2025-10-03 14:06:06+00:00,afifahalss,dulu nonton ini di bioskop seruuu abis,0,0,0,490,https://x.com/afifahalss/status/1974113733682344171,https://x.com/IndoPopBase/status/1974024525973971010,0
2025-10-04 08:45:48+00:00,·,hah... 6 years ago?????,0,0,0,66,https://x.com/Earth2Waves/status/1974395518425133314,https://x.com/IndoPopBase/status/1974024525973971010,0
2025-10-03 16:04:33+00:00,fabulafau,"@milesfilms
 selalu terbaikk",0,0,0,162,https://x.com/fabulafau/status/1974143545171923158,https://x.com/IndoPopBase/status/1974024525973971010,0
2025-10-03 11:34:28+00:00,shlln_,"Enjoy bgt nonton ini sama mamah, dulu",0,0,0,1561,https://x.com/shlln_/status/1974075577981423709,https://x.com/IndoPopBase/status/1974024525973971010,0
2025-10-03 12:20:25+00:00,gyuvrrr,"ini film adaptasi terkeren sihh, selalu rewatch",0,0,0,652,https://x.com/gyuvrrr/status/1974087141161640169,https://x.com/IndoPopBase/status/1974024525973971010,0
2025-10-03 13:24:03+00:00,ancdemonn,film indo paling seru sih,0,0,0,372,https://x.com/ancdemonn/status/1974103155047809039,https://x.com/IndoPopBase/status/1974024525973971010,0
2025-10-05 16:33:57+00:00,jaasskyy,ANDAAIKIII AKH NONTON INI DI BIOSKOP LANGSUNGGGG,0,0,0,32,https://x.com/jaasskyy/status/1974875718225117312,https://x.com/IndoPopBase/status/1974024525973971010,0
2025-10-03 10:07:41+00:00,gaddameh,buset udah 6 tahun aja,0,0,0,818,https://x.com/gaddameh/status/1974053736994726093,https://x.com/IndoPopBase/status/1974024525973971010,0
2025-10-03 15:00:56+00:00,muthechan,life-changing…,0,0,0,242,https://x.com/muthechan/status/1974127535048020263,https://x.com/IndoPopBase/status/1974024525973971010,0
2025-10-03 18:50:47+00:00,parkyshall,Lutesha,0,0,0,201,https://x.com/parkyshall/status/1974185378585456714,https://x.com/IndoPopBase/status/1974024525973971010,0
2025-10-04 08:46:27+00:00,Atikamfthr,,0,0,0,66,https://x.com/Atikamfthr/status/1974395680023294142,https://x.com/IndoPopBase/status/1974024525973971010,0
2025-10-04 03:27:02+00:00,aunulhakim,Salvita Decorte as Suci gedee ,0,0,0,99,https://x.com/aunulhakim/status/1974315296875032724,https://x.com/IndoPopBase/status/1974024525973971010,0
2025-10-03 12:42:29+00:00,rikiyucu,INI SERUUUUUUUUU BGTTTTT,0,0,0,338,https://x.com/rikiyucu/status/1974092694466252875,https://x.com/IndoPopBase/status/1974024525973971010,0
2025-10-03 14:52:30+00:00,mattninson,kayak.. baru kmrnn???,0,0,0,282,https://x.com/mattninson/status/1974125413598446039,https://x.com/IndoPopBase/status/1974024525973971010,0
2025-10-03 12:17:59+00:00,bukananakibu,Kesukaanku,0,0,0,334,https://x.com/bukananakibu/status/1974086528155725909,https://x.com/IndoPopBase/status/1974024525973971010,0
2025-10-03 06:35:10+00:00,NoLetsNot111,DIRGAHAYURIIII,1,151,0,92077,https://x.com/NoLetsNot111/status/1974000256426578291,https://x.com/IndoPopBase/status/1973989447558705319,152
2025-10-03 06:34:16+00:00,heesoorable,is she fr gay or just queerbaiting,10,34,0,86802,https://x.com/heesoorable/status/1974000028730417542,https://x.com/IndoPopBase/status/1973989447558705319,44
2025-10-03 06:30:27+00:00,rotibite,no na girls are ONLY for the girlies,2,19,0,73961,https://x.com/rotibite/status/1973999068725547265,https://x.com/IndoPopBase/status/1973989447558705319,21
2025-10-03 10:43:19+00:00,nawbiel,wanita luas wawasan,0,9,0,14901,https://x.com/nawbiel/status/1974062704043479392,https://x.com/IndoPopBase/status/1973989447558705319,9
2025-10-03 06:00:09+00:00,bareda,Aren't the fans suppose to be happy when their idols have a significant other?,0,5,0,84739,https://x.com/bareda/status/1973991442289742057,https://x.com/IndoPopBase/status/1973989447558705319,5
2025-10-03 07:16:14+00:00,quokkadong97,Girl is consistent with her “husband” role i love her ,0,0,0,46290,https://x.com/quokkadong97/status/1974010590780928089,https://x.com/IndoPopBase/status/1973989447558705319,0
2025-10-03 06:12:05+00:00,Chukky2nd_,Stop queer baiting,1,0,0,9007,https://x.com/Chukky2nd_/status/1973994443641676173,https://x.com/IndoPopBase/status/1973989447558705319,1
2025-10-03 07:26:45+00:00,vosverseau,MY FAV WLW,0,0,0,10519,https://x.com/vosverseau/status/1974013237361586322,https://x.com/IndoPopBase/status/1973989447558705319,0
2025-10-03 06:39:04+00:00,lizziemylovey,,0,0,0,4663,https://x.com/lizziemylovey/status/1974001235054223656,https://x.com/IndoPopBase/status/1973989447558705319,0
2025-10-03 09:32:38+00:00,·,the queer bait,0,0,0,4370,https://x.com/ther2diodept/status/1974044915567915056,https://x.com/IndoPopBase/status/1973989447558705319,0
2025-10-03 06:33:27+00:00,Yoimdiya,IT’S ME YAALL IT’S MEEEE.,0,0,0,35336,https://x.com/Yoimdiya/status/1973999823142445150,https://x.com/IndoPopBase/status/1973989447558705319,0
2025-10-03 13:16:45+00:00,fotneph,is she being fr (i want her so bad),0,0,0,1711,https://x.com/fotneph/status/1974101315099013591,https://x.com/IndoPopBase/status/1973989447558705319,0
2025-10-03 09:18:15+00:00,___lazycat___,Cara paling aman bertahan didunia hiburan,0,0,0,5165,https://x.com/___lazycat___/status/1974041294319284626,https://x.com/IndoPopBase/status/1973989447558705319,0
2025-10-03 06:52:22+00:00,ursteulyNaveen,Christy with the plot twist answer  fans definitely didn’t see that coming!,0,0,0,60614,https://x.com/ursteulyNaveen/status/1974004581504794889,https://x.com/IndoPopBase/status/1973989447558705319,0
2025-10-03 10:57:26+00:00,datuyulianto,"Ketika twice Sana dimix sama Indah Kalalo, jadilah nona Christy",0,0,0,13687,https://x.com/datuyulianto/status/1974066257902383176,https://x.com/IndoPopBase/status/1973989447558705319,0
2025-10-04 02:21:09+00:00,rebahannojutsu,Halah queerbaiting,0,0,0,454,https://x.com/rebahannojutsu/status/1974298715574902971,https://x.com/IndoPopBase/status/1973989447558705319,0
2025-10-03 14:25:51+00:00,dwiAngrrr,lets bring that one community to stay relevant,0,0,0,1548,https://x.com/dwiAngrrr/status/1974118704473649323,https://x.com/IndoPopBase/status/1973989447558705319,0
2025-10-04 09:34:34+00:00,univrs__,While nobody cares whos agnezmo is dating like oh use that fresh care hunni,0,0,0,697,https://x.com/univrs__/status/1974407788886737231,https://x.com/IndoPopBase/status/1973989447558705319,0
2025-10-03 10:43:11+00:00,jenaissoshum,MEEEEEEE IM THE WIFE ,0,0,0,12738,https://x.com/jenaissoshum/status/1974062669633368370,https://x.com/IndoPopBase/status/1973989447558705319,0
2025-10-03 13:13:43+00:00,marsyjan,lombok pride for a reason,0,0,0,1963,https://x.com/marsyjan/status/1974100552624885800,https://x.com/IndoPopBase/status/1973989447558705319,0
2025-10-03 06:03:54+00:00,dudionline,"Is this superstitious? Nooo, I’m only joking. ",0,0,0,2483,https://x.com/dudionline/status/1973992387388076187,https://x.com/IndoPopBase/status/1973989447558705319,0
2025-10-03 10:56:56+00:00,gamovra,Yesss tell em girl,0,0,0,4,https://x.com/gamovra/status/1974066129242108373,https://x.com/IndoPopBase/status/1973989447558705319,0
2025-10-03 11:58:50+00:00,kinjoring,is she? ,0,0,0,2292,https://x.com/kinjoring/status/1974081706333532444,https://x.com/IndoPopBase/status/1973989447558705319,0
2025-10-03 08:45:12+00:00,theaceshin,mau jd istrimu juga ,0,0,0,4235,https://x.com/theaceshin/status/1974032977530118468,https://x.com/IndoPopBase/status/1973989447558705319,0
2025-10-03 06:06:31+00:00,Seung_ha_,"How did fans react to no na’s Christy joking that she “already has a wife”? 
@grok",1,0,0,21935,https://x.com/Seung_ha_/status/1973993046095130840,https://x.com/IndoPopBase/status/1973989447558705319,1
2025-10-03 11:34:10+00:00,PROSPERDEGREAT,That’s one way to shut down the speculation. Fans must be shaken,0,0,0,16458,https://x.com/PROSPERDEGREAT/status/1974075500164440366,https://x.com/IndoPopBase/status/1973989447558705319,0
2025-10-03 11:59:41+00:00,gift_gifthya,Wife gaktuh,0,0,0,28,https://x.com/gift_gifthya/status/1974081919819395208,https://x.com/IndoPopBase/status/1973989447558705319,0
2025-10-03 08:02:29+00:00,hiranokuning,OMG?????,0,0,0,1580,https://x.com/hiranokuning/status/1974022228376236053,https://x.com/IndoPopBase/status/1973989447558705319,0
2025-10-03 06:26:17+00:00,roweeasley,"She is beautiful in her own way, tapi beneran mirip Kazuha Le Sserafim ",0,0,0,7899,https://x.com/roweeasley/status/1973998018534994162,https://x.com/IndoPopBase/status/1973989447558705319,0
2025-10-03 08:50:09+00:00,ghfrrrr_,buci please hold on,0,0,0,2793,https://x.com/ghfrrrr_/status/1974034223163191509,https://x.com/IndoPopBase/status/1973989447558705319,0
2025-10-03 08:42:46+00:00,avemujicac,NONAYURI,0,0,0,1002,https://x.com/avemujicac/status/1974032365421830389,https://x.com/IndoPopBase/status/1973989447558705319,0
2025-10-03 12:20:26+00:00,·,YESSS IM THE WIFE ,0,0,0,1548,https://x.com/igemajja/status/1974087144567439844,https://x.com/IndoPopBase/status/1973989447558705319,0
2025-10-03 09:20:42+00:00,badluvkind,they have a lebanese in the group??,0,0,0,1241,https://x.com/badluvkind/status/1974041912039628858,https://x.com/IndoPopBase/status/1973989447558705319,0
2025-10-03 08:33:46+00:00,theloola,another win for the girls,0,0,0,2182,https://x.com/theloola/status/1974030101814915242,https://x.com/IndoPopBase/status/1973989447558705319,0
2025-10-03 10:30:06+00:00,k4ng_batagor,LECI,0,0,0,341,https://x.com/k4ng_batagor/status/1974059378199441454,https://x.com/IndoPopBase/status/1973989447558705319,0
2025-10-03 09:48:28+00:00,·,that's me y'all,0,0,0,1754,https://x.com/myngchacco/status/1974048901595340887,https://x.com/IndoPopBase/status/1973989447558705319,0
2025-10-03 12:45:15+00:00,tomatejo,"sorry guys, im the wifey",0,0,0,8624,https://x.com/tomatejo/status/1974093389848330407,https://x.com/IndoPopBase/status/1973989447558705319,0
2025-10-03 13:16:26+00:00,URIGANUGU143,nona for nona,0,0,0,659,https://x.com/URIGANUGU143/status/1974101237458219321,https://x.com/IndoPopBase/status/1973989447558705319,0
2025-10-03 10:54:21+00:00,blackgladioluss,loh kemarin bilangnya mau backstreet,0,0,0,10428,https://x.com/blackgladioluss/status/1974065481415078107,https://x.com/IndoPopBase/status/1973989447558705319,0
2025-10-03 14:19:45+00:00,carouvsei,MAU JOIN BLEH GA,0,0,0,149,https://x.com/carouvsei/status/1974117169106665577,https://x.com/IndoPopBase/status/1973989447558705319,0
2025-10-03 07:34:22+00:00,SINGKITMYLUV,,0,0,0,4846,https://x.com/SINGKITMYLUV/status/1974015153437016138,https://x.com/IndoPopBase/status/1973989447558705319,0
2025-10-03 08:11:44+00:00,callmebreew,,0,0,0,898,https://x.com/callmebreew/status/1974024557561512222,https://x.com/IndoPopBase/status/1973989447558705319,0
2025-10-03 07:50:10+00:00,nomincandies,SHE IS LESBIAN? OH THE QUEEN THAT YOU ARE,0,0,0,4009,https://x.com/nomincandies/status/1974019128278110337,https://x.com/IndoPopBase/status/1973989447558705319,0
2025-10-03 05:58:41+00:00,Prime___TV,,0,0,0,11710,https://x.com/Prime___TV/status/1973991074130518290,https://x.com/IndoPopBase/status/1973989447558705319,0
2025-10-03 06:12:32+00:00,DestsPangestuni,No na man is,0,0,0,2251,https://x.com/DestsPangestuni/status/1973994557684502697,https://x.com/IndoPopBase/status/1973989447558705319,0
2025-10-03 10:40:46+00:00,Leonaderune,"shes for the girls, nyam",0,0,0,59,https://x.com/Leonaderune/status/1974062061014692057,https://x.com/IndoPopBase/status/1973989447558705319,0
2025-10-03 09:12:38+00:00,gay4bailaa,we cheers,0,0,0,570,https://x.com/gay4bailaa/status/1974039884101992563,https://x.com/IndoPopBase/status/1973989447558705319,0
2025-10-03 06:39:52+00:00,aswan21w,pengemarnya harusnya seneng lihat idolanya pnya pacar,0,0,0,1100,https://x.com/aswan21w/status/1974001438985503142,https://x.com/IndoPopBase/status/1973989447558705319,0
2025-10-03 05:57:35+00:00,·,and im the wife,0,0,0,2030,https://x.com/woncdrous/status/1973990795624734935,https://x.com/IndoPopBase/status/1973989447558705319,0
2025-10-03 13:50:05+00:00,obabydolls,akulah wifey blio,0,0,0,37,https://x.com/obabydolls/status/1974109705367945418,https://x.com/IndoPopBase/status/1973989447558705319,0
2025-10-03 05:53:52+00:00,estelersatu,"welcome back, Aristotle",0,0,0,853,https://x.com/estelersatu/status/1973989859099574626,https://x.com/IndoPopBase/status/1973981884284866995,0
2025-10-03 08:12:27+00:00,barba_dian,Beauty - Brain - Behavior and that's why she'll always be mother,0,1,0,535,https://x.com/barba_dian/status/1974024735458799846,https://x.com/IndoPopBase/status/1973981884284866995,1
2025-10-03 10:43:23+00:00,cityleng,yes girl,0,0,0,431,https://x.com/cityleng/status/1974062721856647622,https://x.com/IndoPopBase/status/1973981884284866995,0
2025-10-03 13:49:17+00:00,lemonlyme44,aku pernah membaca kalimat yg sama di suatu tempat. tapi saya belum bisa mengingatnya secara jelas.,0,0,0,235,https://x.com/lemonlyme44/status/1974109504825667825,https://x.com/IndoPopBase/status/1973981884284866995,0
2025-10-03 06:44:23+00:00,ursteulyNaveen,Beautifully said—time really is the silent teacher that shapes who we are and how we see the world. ,0,0,0,371,https://x.com/ursteulyNaveen/status/1974002575847350567,https://x.com/IndoPopBase/status/1973981884284866995,0
2025-10-03 11:11:28+00:00,kameg0mego,dress: ernesto abram,0,0,0,462,https://x.com/kameg0mego/status/1974069787857989678,https://x.com/IndoPopBase/status/1973981884284866995,0
2025-10-03 06:26:55+00:00,dinil4nd,setujuuu pake banget.,0,0,0,670,https://x.com/dinil4nd/status/1973998179940249872,https://x.com/IndoPopBase/status/1973981884284866995,0
2025-10-03 08:19:47+00:00,OynRetriever,BEAUTY AND BEAURAIN <3 welcome Sheila Dara!,0,0,0,453,https://x.com/OynRetriever/status/1974026583502696698,https://x.com/IndoPopBase/status/1973981884284866995,0
2025-10-03 06:43:31+00:00,iloveutil,"Memang,",0,0,0,530,https://x.com/iloveutil/status/1974002355533214028,https://x.com/IndoPopBase/status/1973981884284866995,0
2025-10-03 06:00:49+00:00,pelurukuhabis,Waktu tidak mencetak duplikat. Ia mencetak karakter.,0,0,0,677,https://x.com/pelurukuhabis/status/1973991609290125412,https://x.com/IndoPopBase/status/1973981884284866995,0
2025-10-03 07:20:50+00:00,aswan21w,setuju buanget,0,0,0,218,https://x.com/aswan21w/status/1974011745061449867,https://x.com/IndoPopBase/status/1973981884284866995,0
2025-10-03 06:15:09+00:00,Seung_ha_,"Do you agree that our past experiences are the main force shaping how we see the world and make decisions? 
@grok",1,0,0,281,https://x.com/Seung_ha_/status/1973995218748747882,https://x.com/IndoPopBase/status/1973981884284866995,1
2025-10-10 01:33:36+00:00,momocilagiii,"Traditional Indonesian snacks, gluten free:
ES BUBUR SUMSUM MY LOVE",423,3985,0,660697,https://x.com/momocilagiii/status/1976461078491275540,https://x.com/IndoPopBase/status/1973981884284866995,4408
2025-10-09 15:42:46+00:00,siyyaniverse,reveal hands?? are you CRAZY???,321,10263,0,8530803,https://x.com/siyyaniverse/status/1976312390171099548,https://x.com/IndoPopBase/status/1973981884284866995,10584
2025-10-09 06:42:03+00:00,Keangae_Mk2,,247,55372,0,7166636,https://x.com/Keangae_Mk2/status/1976176315322728818,https://x.com/IndoPopBase/status/1973981884284866995,55619
2025-10-09 10:29:50+00:00,CakRedi,Possibly the most beautiful hotel swimming pool the world. ,53,841,0,627868,https://x.com/CakRedi/status/1976233638657392698,https://x.com/IndoPopBase/status/1973981884284866995,894
2025-10-03 05:46:07+00:00,BearryBlush,never crediting the photographer smh,0,0,0,243,https://x.com/BearryBlush/status/1973987910568559070,https://x.com/IndoPopBase/status/1973981442771427465,0
2025-10-03 06:10:05+00:00,PROSPERDEGREAT,Sheila Dara on the cover is giving strong vibes. Wonder what angle the feature takes,0,0,0,275,https://x.com/PROSPERDEGREAT/status/1973993942795309296,https://x.com/IndoPopBase/status/1973981442771427465,0
2025-10-03 06:09:39+00:00,PROSPERDEGREAT,Sheila Dara looks stunning on the cover. I'm curious to see what stories she shares inside,0,0,0,272,https://x.com/PROSPERDEGREAT/status/1973993831696584825,https://x.com/IndoPopBase/status/1973981442771427465,0
2025-10-03 06:13:30+00:00,Seung_ha_,"What do you think of Sheila Dara’s stunning new ELLE Indonesia cover? 
@grok",1,0,0,278,https://x.com/Seung_ha_/status/1973994802208518282,https://x.com/IndoPopBase/status/1973981442771427465,1
2025-10-03 07:21:11+00:00,aswan21w,cantiknya,0,0,0,159,https://x.com/aswan21w/status/1974011834744135754,https://x.com/IndoPopBase/status/1973981442771427465,0
2025-10-03 05:29:37+00:00,Razziizzar,Who??,0,0,0,244,https://x.com/Razziizzar/status/1973983758178300135,https://x.com/IndoPopBase/status/1973981442771427465,0
2025-10-09 09:27:44+00:00,QUEERAUSAHAAN,ammar zoni is the best anti-drug ad cause WTF HAPPENED like oh my god…..,110,782,0,501693,https://x.com/QUEERAUSAHAAN/status/1976218010957512842,https://x.com/IndoPopBase/status/1973981442771427465,892
2025-10-09 14:34:33+00:00,findormeme,bunch of elementary school kids revealing their exam passing status while slipping through my fingers is playing on the background meryl streep tidak lulus anak sd nangis dramatic hasil ujian nangis,361,2108,0,1354058,https://x.com/findormeme/status/1976295222960427487,https://x.com/IndoPopBase/status/1973981442771427465,2469
2025-10-09 10:29:50+00:00,CakRedi,Possibly the most beautiful hotel swimming pool the world. ,53,841,0,629206,https://x.com/CakRedi/status/1976233638657392698,https://x.com/IndoPopBase/status/1973981442771427465,894
2025-10-09 14:12:41+00:00,kiorcally,life better on tempe,101,1819,0,120495,https://x.com/kiorcally/status/1976289721119817843,https://x.com/IndoPopBase/status/1973981442771427465,1920
2025-10-03 05:50:21+00:00,lPosumA0209,"It should be like this, the Song Writing Format :
- Yovie Widianto x RAN — Cukup Sudah  
- Rizky Febian x Adrian Khalif — Alamak 
- Kunto Aji x IKLIM — Manusia Terakhir di Bumi 
- Sukatani x IKLIM — Kebangkitan 
- Denny Caknan x NDX A.K.A. — Ropang 
...",1,2,0,1753,https://x.com/lPosumA0209/status/1973988976836137414,https://x.com/IndoPopBase/status/1973977793601106156,3
2025-10-03 06:46:15+00:00,bioplacenton13,Di mana Kehidupan Wanita Pertunjukan?,0,0,0,1155,https://x.com/bioplacenton13/status/1974003044099539418,https://x.com/IndoPopBase/status/1973977793601106156,0
2025-10-03 07:00:15+00:00,naynayeon_pop,Angie Carvalho also drop new single today,0,0,0,701,https://x.com/naynayeon_pop/status/1974006567369412914,https://x.com/IndoPopBase/status/1973977793601106156,0
2025-10-03 05:09:12+00:00,bobby001_eth,"Stacked release week

Kunto Aji x IKLIM collab is the one I’m most curious about.",0,0,0,1066,https://x.com/bobby001_eth/status/1973978621649010802,https://x.com/IndoPopBase/status/1973977793601106156,0
2025-10-03 13:10:08+00:00,mailvelous,"bagus traffic jam.. judulnya ibukota, search di yt yg keluar malah kemacetan jakarta..",0,0,0,607,https://x.com/mailvelous/status/1974099653160546769,https://x.com/IndoPopBase/status/1973977793601106156,0
2025-10-03 06:13:24+00:00,3usri,,0,0,0,612,https://x.com/3usri/status/1973994775322738924,https://x.com/IndoPopBase/status/1973977793601106156,0
2025-10-03 05:27:59+00:00,PROSPERDEGREAT,Solid lineup this week. Is anyone else curious which tracks will actually stick after a few listens?,0,0,0,1300,https://x.com/PROSPERDEGREAT/status/1973983348260548628,https://x.com/IndoPopBase/status/1973977793601106156,0
2025-10-03 05:28:28+00:00,PROSPERDEGREAT,Plenty of tracks to dive into. I'm curious which ones will actually stick after the first listen,0,0,0,643,https://x.com/PROSPERDEGREAT/status/1973983470281240908,https://x.com/IndoPopBase/status/1973977793601106156,0
2025-10-03 05:38:38+00:00,GhhopesHi,Where’s Taylor,0,0,0,506,https://x.com/GhhopesHi/status/1973986026113937791,https://x.com/IndoPopBase/status/1973977793601106156,0
2025-10-03 06:16:13+00:00,Seung_ha_,"Which one are you spinning first?
@grok",1,0,0,313,https://x.com/Seung_ha_/status/1973995486647627817,https://x.com/IndoPopBase/status/1973977793601106156,1
2025-10-03 05:16:30+00:00,moodjianto,we will stream,0,0,0,643,https://x.com/moodjianto/status/1973980459513397343,https://x.com/IndoPopBase/status/1973977793601106156,0
2025-10-03 07:21:43+00:00,aswan21w,dengar,0,0,0,178,https://x.com/aswan21w/status/1974011968710455675,https://x.com/IndoPopBase/status/1973977793601106156,0
2025-10-03 05:06:40+00:00,tinkumaawa,Rizky Febian alamak,0,0,0,456,https://x.com/tinkumaawa/status/1973977983460557233,https://x.com/IndoPopBase/status/1973977793601106156,0
2025-10-03 07:16:00+00:00,VVYND,IT WORKED,0,1,0,1710,https://x.com/VVYND/status/1974010531934831094,https://x.com/IndoPopBase/status/1973962033537450112,1
2025-10-03 08:56:49+00:00,firhidz,"@T3RIP4NG
 impact",0,0,0,354,https://x.com/firhidz/status/1974035900095992110,https://x.com/IndoPopBase/status/1973962033537450112,0
2025-10-03 05:08:30+00:00,bobby001_eth,"That’s a bold move, full album sets always hit different when the crowd knows every track.",0,0,0,885,https://x.com/bobby001_eth/status/1973978443865075979,https://x.com/IndoPopBase/status/1973962033537450112,0
2025-10-03 15:32:53+00:00,firzafp,"Kinanti didalam SynchroFest
*Baru tahu referensi dari sebuah 'komik berkisah 3 gadis badung namanya Julie, Klara, Cecile (3 CEWEK BADUNG) [Julie, Claire, Cécile - komik lawas karya Sidney & Bom]'",0,0,0,178,https://x.com/firzafp/status/1974135574346006862,https://x.com/IndoPopBase/status/1973962033537450112,0
2025-10-03 04:18:16+00:00,Seung_ha_,"What inspired Andien to perform her full Kinanti album live after so many years? 
@grok",2,0,0,1080,https://x.com/Seung_ha_/status/1973965801528176899,https://x.com/IndoPopBase/status/1973962033537450112,2
2025-10-03 06:18:45+00:00,beyoftheUS,"@T3RIP4NG
 IMPACT",0,0,0,320,https://x.com/beyoftheUS/status/1973996122885456253,https://x.com/IndoPopBase/status/1973962033537450112,0
2025-10-03 06:55:04+00:00,ursteulyNaveen,That’s huge!  A full Kinanti performance at Synchronize Fest is going to be such a beautiful experience. ,0,0,0,583,https://x.com/ursteulyNaveen/status/1974005262446125565,https://x.com/IndoPopBase/status/1973962033537450112,0
2025-10-03 05:26:53+00:00,PROSPERDEGREAT,Performing the whole Kinanti album live? That’s a bold move. Should be amazing for fans who know every track,0,0,0,637,https://x.com/PROSPERDEGREAT/status/1973983070064947665,https://x.com/IndoPopBase/status/1973962033537450112,0
2025-10-03 05:27:30+00:00,PROSPERDEGREAT,Playing the full Kinanti album sounds epic. Can’t wait to see how it hits live,0,0,0,610,https://x.com/PROSPERDEGREAT/status/1973983224025264424,https://x.com/IndoPopBase/status/1973962033537450112,0
2025-10-03 04:54:24+00:00,shibaswhap,Ini yg iklan sampo bukan,0,0,0,1078,https://x.com/shibaswhap/status/1973974897308414223,https://x.com/IndoPopBase/status/1973962033537450112,0
2025-10-04 09:41:19+00:00,ibraanimeprince,queen of performance,0,0,0,20,https://x.com/ibraanimeprince/status/1974409487114289656,https://x.com/IndoPopBase/status/1973962033537450112,0
2025-10-03 08:02:23+00:00,notmyuname,"And will she be changing her wardrobe in between each song?! 
@andienaisyah",0,0,0,509,https://x.com/notmyuname/status/1974022201700725128,https://x.com/IndoPopBase/status/1973962033537450112,0
2025-10-03 12:01:33+00:00,Dea_R_,damnnn,0,0,0,154,https://x.com/Dea_R_/status/1974082392618119443,https://x.com/IndoPopBase/status/1973962033537450112,0
2025-10-03 13:07:39+00:00,setanidol,Indonesian Pop Base impact,0,0,0,159,https://x.com/setanidol/status/1974099027454275668,https://x.com/IndoPopBase/status/1973962033537450112,0
2025-10-03 18:50:50+00:00,desikator10jt,legend,0,0,0,78,https://x.com/desikator10jt/status/1974185389952020840,https://x.com/IndoPopBase/status/1973962033537450112,0
2025-10-03 07:57:00+00:00,RiriMeigita,yaampun mauu,0,0,0,327,https://x.com/RiriMeigita/status/1974020849754910920,https://x.com/IndoPopBase/status/1973962033537450112,0
2025-10-03 07:22:29+00:00,aswan21w,sdh lama g muncul,0,0,0,236,https://x.com/aswan21w/status/1974012161929421239,https://x.com/IndoPopBase/status/1973962033537450112,0
2025-10-02 06:27:28+00:00,pukimakncheese,and fatbowo is licking bibi's balls instead of helping the flotilla..,0,26,0,4250,https://x.com/pukimakncheese/status/1973635930398609856,https://x.com/IndoPopBase/status/1973634930807808374,26
2025-10-02 06:36:10+00:00,SistersInDanger,"Same rotten Zionist playbook..  always spread propaganda to cover up apartheid, war crimes, & nonstop violations of international law ",0,9,0,5231,https://x.com/SistersInDanger/status/1973638117459701815,https://x.com/IndoPopBase/status/1973634930807808374,9
2025-10-02 06:59:15+00:00,hrgila,"F
  　 U
  　　    C
  　　　　 K
  　　　　　    
                            I

  　　              S

  　　       R

  　　   A

  　　　  E

                         L
                 ｡  ･
         ｡°*.",0,16,0,1525,https://x.com/hrgila/status/1973643927552139650,https://x.com/IndoPopBase/status/1973634930807808374,16
2025-10-02 06:40:34+00:00,windaberdelapan,"Dikit² Hamas, apa² Hamas. Kecintaan bgt kayanya idf tolol sama Hamas.",1,1,0,1132,https://x.com/windaberdelapan/status/1973639227658412341,https://x.com/IndoPopBase/status/1973634930807808374,2
2025-10-02 06:28:22+00:00,bareda,The terrorist state of Israel.,0,1,0,1438,https://x.com/bareda/status/1973636154609324270,https://x.com/IndoPopBase/status/1973634930807808374,1
2025-10-02 06:35:56+00:00,yohdd12,I Dont want to call Israel is a State but crime organization,1,1,0,651,https://x.com/yohdd12/status/1973638060001951883,https://x.com/IndoPopBase/status/1973634930807808374,2
2025-10-02 12:38:31+00:00,vinmnel,"640.000+ jiwa, bukan hanya sekedar angka tapi nyawa! Stop genosida, pemerkaosan, penyiksaan, penculikan, penjualan organ tubuh jenazah, pemifitnahan! 
#AllEyesOnGaza
#AllEyesOnGlobalSumudFlotilla 
#FreeGazaFromisrael",0,2,0,598,https://x.com/vinmnel/status/1973729307114799586,https://x.com/IndoPopBase/status/1973634930807808374,2
2025-10-02 12:54:38+00:00,atm0j06,"Things that are Hamas: 

-Hospitals
-Schools
-Aid workers
-Journalists
-Doctors
-The UN
-The ICC
-S/Africa
-The IPC
-Amnesty International
-Human Rights Watch
-Doctors Without Borders
-All buildings in Gaza
-Pope
-Children
-Cameras
-Greta
-Flotilla
They want you to believe this.",0,0,0,840,https://x.com/atm0j06/status/1973733362188812303,https://x.com/IndoPopBase/status/1973634930807808374,0
2025-10-02 06:42:04+00:00,B4n6_H4n5,"Penjahat, pasti cara berpikirnya jahat...",0,0,0,788,https://x.com/B4n6_H4n5/status/1973639605095465250,https://x.com/IndoPopBase/status/1973634930807808374,0
2025-10-02 06:49:51+00:00,KukoGemaz,"@grok
 Kenapa sebagian besar banyak negara yang tidak mengikuti aksi itu seperti yang gambar di atas",1,0,0,589,https://x.com/KukoGemaz/status/1973641560702198275,https://x.com/IndoPopBase/status/1973634930807808374,1
2025-10-04 05:58:45+00:00,iwaaaak26,"Hamas sumud flotilla wkwkwkwk sumpaj kek begonya mereka tuh ga ketulungan, apa2 dikata hamas, apa2 dikira hamas, dikit2 takut sama katanya yg mirip hamas meskipun bukan hamas wkwkwkwkwkkw tll",0,0,0,41,https://x.com/iwaaaak26/status/1974353479004311762,https://x.com/IndoPopBase/status/1973634930807808374,0
2025-10-02 13:26:04+00:00,rover_male,Minum jus yuk. Katanya Israel takut sama jus,1,0,0,168,https://x.com/rover_male/status/1973741272075780412,https://x.com/IndoPopBase/status/1973634930807808374,1
2025-10-02 06:25:12+00:00,Seung_ha_,"Why is Israel attempting to label the Global Sumud Flotilla as linked to Hamas, and how might this affect global perceptions of the mission?
@grok",1,0,0,2605,https://x.com/Seung_ha_/status/1973635358639399397,https://x.com/IndoPopBase/status/1973634930807808374,1
2025-10-02 06:24:35+00:00,ursteulyNaveen,Classic propaganda play rebranding a humanitarian mission as “terror-linked” to delegitimize global solidarity. The world sees through it. ,0,0,0,1575,https://x.com/ursteulyNaveen/status/1973635203248824686,https://x.com/IndoPopBase/status/1973634930807808374,0
2025-10-02 11:59:51+00:00,orcidaceaesp,Si zionis ini ga ada otaknya sama sekali,0,0,0,116,https://x.com/orcidaceaesp/status/1973719575176126828,https://x.com/IndoPopBase/status/1973634930807808374,0
2025-10-02 07:02:34+00:00,Aisy_welel14,"Salah fokus sama pemilihan diksinya, keren  ",0,0,0,389,https://x.com/Aisy_welel14/status/1973644763883778347,https://x.com/IndoPopBase/status/1973634930807808374,0
2025-10-02 11:21:57+00:00,jvstforvan,ISRAEL KONTOL,0,0,0,157,https://x.com/jvstforvan/status/1973710037735641483,https://x.com/IndoPopBase/status/1973634930807808374,0
2025-10-02 06:30:42+00:00,achiavellian,"@grok
 explain in simple Indonesian",1,0,0,314,https://x.com/achiavellian/status/1973636742675939636,https://x.com/IndoPopBase/status/1973634930807808374,1
2025-10-03 08:27:41+00:00,pesertapeninjau,"Fuck Israel !!!

There is no room for genocider and colonialist illgela state like Israhell.",0,0,0,9,https://x.com/pesertapeninjau/status/1974028570508067251,https://x.com/IndoPopBase/status/1973634930807808374,0
2025-10-02 07:48:18+00:00,deepublishstore,"busetttt propagandanya ada aja yeee, tetep kawaal temen temen  #alleyesonsumud",0,0,0,166,https://x.com/deepublishstore/status/1973656270306762756,https://x.com/IndoPopBase/status/1973634930807808374,0
2025-10-02 14:44:12+00:00,kazan_elista,"Fuck IDF
Free Gaza",1,0,0,29,https://x.com/kazan_elista/status/1973760936474444118,https://x.com/IndoPopBase/status/1973634930807808374,1
2025-10-02 07:30:35+00:00,billllliiee,Sejauh ini baru 1 kapal yang bisa masuk ke perairan Gaza. Semoga selamat sampai ke daratan,0,1,0,142,https://x.com/billllliiee/status/1973651813909082306,https://x.com/IndoPopBase/status/1973634930807808374,1
2025-10-02 07:36:13+00:00,nocturnalforsa1,Presiden elu pendukung israel ,0,0,0,93,https://x.com/nocturnalforsa1/status/1973653230094786944,https://x.com/IndoPopBase/status/1973634930807808374,0
2025-10-02 08:43:48+00:00,MTwist8100,And flopbowo?,0,0,0,134,https://x.com/MTwist8100/status/1973670239964700825,https://x.com/IndoPopBase/status/1973634930807808374,0
2025-10-02 11:19:54+00:00,agustinus_48103,"You see 
@prabowo
 ? Zionism and Israel means death and you must cut support from them.",0,0,0,30,https://x.com/agustinus_48103/status/1973709523086106655,https://x.com/IndoPopBase/status/1973634930807808374,0
2025-10-02 09:49:41+00:00,freethink32,"Apartheid? Global humanitarian movement? What do you mean by apartheid and global humanitarian movement? They are all simply sympathizers and supporters of the terrorist groups Hamas, PIJ, etc in Gaza. Use civilians as political tools to achieve their goals and targets.",0,0,0,59,https://x.com/freethink32/status/1973686817317949885,https://x.com/IndoPopBase/status/1973634930807808374,0
2025-10-02 06:18:03+00:00,·,Teriak2 antek asing faktanya dia sendiri yg jilat antek asing. Di indo aja korban penculikan dan keracunan hanya diliat sbg angka sma Wowo apalagi ini ga akan peduli dia. Bagian dari zionist mmng begini,7,435,0,25243,https://x.com/whiterosestea/status/1973633559765418486,https://x.com/IndoPopBase/status/1973625015645118820,442
2025-10-02 06:01:48+00:00,SistersInDanger,"If the government stays silent, it betrays Pancasila’s core values of justice and humanity.
The abduction of the Global Sumud Flotilla cannot be ignored!",2,142,0,32683,https://x.com/SistersInDanger/status/1973629471589802114,https://x.com/IndoPopBase/status/1973625015645118820,144
2025-10-02 07:34:20+00:00,PrimaPrisma,,1,172,0,24482,https://x.com/PrimaPrisma/status/1973652757551915468,https://x.com/IndoPopBase/status/1973625015645118820,173
2025-10-02 06:31:47+00:00,alotsofweird,"emangnya apa yg lu harapkan dari pemimpin seorang pelanggar HAM berat, penculik, penyepong antek asing + zionist???",2,37,0,14373,https://x.com/alotsofweird/status/1973637015011991930,https://x.com/IndoPopBase/status/1973625015645118820,39
2025-10-02 05:49:10+00:00,kiokio878,What did you expect from human rights violators BIJI PELER SATU,1,30,0,5439,https://x.com/kiokio878/status/1973626291640476046,https://x.com/IndoPopBase/status/1973625015645118820,31
2025-10-02 05:51:50+00:00,SaddamWeb3,masih mabok pujian,0,0,0,12987,https://x.com/SaddamWeb3/status/1973626959893766513,https://x.com/IndoPopBase/status/1973625015645118820,0
2025-10-02 05:47:03+00:00,TabletoskadonIm,"@Kemlu_RI
 shame on you? Are we ZIONIST lapdog rn?",0,12,0,10739,https://x.com/TabletoskadonIm/status/1973625758414414054,https://x.com/IndoPopBase/status/1973625015645118820,12
2025-10-02 08:16:16+00:00,cho2MLHC,"Malay: 1
Indo: -11",2,8,0,11844,https://x.com/cho2MLHC/status/1973663308483010875,https://x.com/IndoPopBase/status/1973625015645118820,10
2025-10-03 15:39:27+00:00,K0rbanNep0tisme,"Di tengah maraknya pemimpin dunia mengecam genosida yg di lakukan Israel, dia dengan santay nya speak up soal hak hak keamanan Israel, pdhl yg lebih tidak aman adalah krisis kemanusiaan di Palestina",1,0,0,117,https://x.com/K0rbanNep0tisme/status/1974137227044381083,https://x.com/IndoPopBase/status/1973625015645118820,1
2025-10-02 06:51:00+00:00,willopink,"Takut banget ""yg diculik cuman 0,sekian% dari jumlah penduduk""",0,0,0,546,https://x.com/willopink/status/1973641850465690076,https://x.com/IndoPopBase/status/1973625015645118820,0
2025-10-02 06:17:08+00:00,k4ng_batagor,"pemerintah Indon kan zionis, prabowo kontol",0,0,0,231,https://x.com/k4ng_batagor/status/1973633326566220073,https://x.com/IndoPopBase/status/1973625015645118820,0
2025-10-02 06:25:01+00:00,lavenderswift93,"Not surprised, the president is a zionist too",0,1,0,1317,https://x.com/lavenderswift93/status/1973635311742885894,https://x.com/IndoPopBase/status/1973625015645118820,1
2025-10-02 06:58:34+00:00,andiaryos,Mana mau. Kan udah udah mejeng baliho di tel aviv ,0,1,0,1432,https://x.com/andiaryos/status/1973643756810510420,https://x.com/IndoPopBase/status/1973625015645118820,1
2025-10-02 10:01:07+00:00,JJSSJJ77,"They are lucky.  In Gaza, they would have been taken hostage, ra*ed and k**led.  Fools.",0,0,0,703,https://x.com/JJSSJJ77/status/1973689696921485639,https://x.com/IndoPopBase/status/1973625015645118820,0
2025-10-02 14:11:17+00:00,jonmamau,,0,1,0,281,https://x.com/jonmamau/status/1973752652703101251,https://x.com/IndoPopBase/status/1973625015645118820,1
2025-10-02 10:00:54+00:00,mr_cordova,"Di saat rakyat Palestina lagi dibantai, kelaparan, kehilangan rumah, keluarga, dan harapan. ada yang bilang ""damai"" itu dengan melindungi penjajah

Hhhhhh
Itu bukan perdamaian
Itu pembiaran
Itu pengkhianatan terhadap keadilan

:((((",3,0,0,287,https://x.com/mr_cordova/status/1973689641263042673,https://x.com/IndoPopBase/status/1973625015645118820,3
2025-10-02 10:00:20+00:00,littlezombiekun,indonesia udh dinilai sebagai penjilat israel. Ironis,1,0,0,297,https://x.com/littlezombiekun/status/1973689497075569149,https://x.com/IndoPopBase/status/1973625015645118820,1
2025-10-02 06:00:03+00:00,_ZyZ_Z,"Ngapain, president nya aja nge back up netanyahu ",0,0,0,692,https://x.com/_ZyZ_Z/status/1973629030059614558,https://x.com/IndoPopBase/status/1973625015645118820,0
2025-10-02 10:43:59+00:00,hideousrockstar,"Ga berani, jek! Ga berani. Pidato aja presidennya pilih kalimat² aman yg multitafsir kok, lalu msh ngarepin ap lg?

Gaya doang gebrak² meja, kang soto jg jago kalo gebrak mah",0,0,0,1918,https://x.com/hideousrockstar/status/1973700482209386773,https://x.com/IndoPopBase/status/1973625015645118820,0
2025-10-02 05:56:27+00:00,humanitey,What would that zionist president say? That they glad the israeli abduct those ships?? ,0,0,0,1302,https://x.com/humanitey/status/1973628124429709420,https://x.com/IndoPopBase/status/1973625015645118820,0
2025-10-03 04:15:42+00:00,jakardoding,"You may want to expect a softer low-tone by the Indonesian President, 
@prabowo
 as the price he has agreed on a deal with the US/Israel when Israel granted permission for Indonesia Air-dropping aid into Gaza.

The deal includes Indonesia’s support for & softer tone against Israel.",0,2,0,89,https://x.com/jakardoding/status/1973965154967781400,https://x.com/IndoPopBase/status/1973625015645118820,2
2025-10-03 01:41:54+00:00,wong_clayten,"In this country, volunteers are never recognized by the government, they are like secret agent 007, if they are successful they will be recognized as an achievement by the government, if they fail they are foreign stooges and the government doesn't know anything about it.",0,0,0,1454,https://x.com/wong_clayten/status/1973926451859874251,https://x.com/IndoPopBase/status/1973625015645118820,0
2025-10-02 15:25:38+00:00,HimeLavender1,"Apa yang mau diharapkan dari penyelenggara negara ini? Sama rakyat sendiri saja ga peduli, apa lagi ma yang bukan rakyatnya.",1,0,0,267,https://x.com/HimeLavender1/status/1973771361932960170,https://x.com/IndoPopBase/status/1973625015645118820,1
2025-10-02 05:49:29+00:00,yohdd12,"@Kemlu_RI
 Shame on you !!!",0,0,0,427,https://x.com/yohdd12/status/1973626372213055735,https://x.com/IndoPopBase/status/1973625015645118820,0
2025-10-03 14:51:30+00:00,ClashRulla,,0,0,0,22,https://x.com/ClashRulla/status/1974125159364870513,https://x.com/IndoPopBase/status/1973625015645118820,0
2025-10-02 12:45:13+00:00,celiwne,"padahal ada 1 aktivis Indonesia yang kena tahan loh, emang cuma dianggep angka kah ama indon govs nih??",1,1,0,1057,https://x.com/celiwne/status/1973730994600763431,https://x.com/IndoPopBase/status/1973625015645118820,2
2025-10-03 05:22:37+00:00,QuQu19112889,,0,0,0,66,https://x.com/QuQu19112889/status/1973981996402741634,https://x.com/IndoPopBase/status/1973625015645118820,0
2025-10-03 15:45:02+00:00,NunNew357089,Please gue buka tiktok komenan tentah free Palestine pasti di olok2 terus kaya di buat candaan kek ya Alloh sakit hati bangett makanya selalu skip kalau di tiktok lagi bahas palestina pasti sakit kalau udah lihat komen,1,0,0,30,https://x.com/NunNew357089/status/1974138634455732624,https://x.com/IndoPopBase/status/1973625015645118820,1
2025-10-02 06:03:11+00:00,ChinaSh117,Menlu sekarang kerjanya ngapain sih anjir. Jomplang bgt kalo dibandingkan dgn kinerja bu retno,0,0,0,239,https://x.com/ChinaSh117/status/1973629818945282193,https://x.com/IndoPopBase/status/1973625015645118820,0
2025-10-02 07:57:16+00:00,lovely_osho,Halahhh... Anda punya agenda apa mengangkat isu ini hah ? Anda tidak benar-benar peduli pada Global Sumud Flotilla.,24,0,0,2499,https://x.com/lovely_osho/status/1973658529312678368,https://x.com/IndoPopBase/status/1973625015645118820,24
2025-10-02 06:58:24+00:00,mbacip,"gebrak meja lagi yok pak 
@prabowo",0,0,0,332,https://x.com/mbacip/status/1973643712464085199,https://x.com/IndoPopBase/status/1973625015645118820,0
2025-10-02 09:22:36+00:00,putrapetir_007,Ini lho gak ada protes,0,0,0,158,https://x.com/putrapetir_007/status/1973680004153409615,https://x.com/IndoPopBase/status/1973625015645118820,0
2025-10-02 06:55:37+00:00,BatasAir,"asingkan Prabowo

dulu hukum Belanda sering mengasingkan pihak yg mereka tidak sukai

sekarang kita yg harus membuang orang-orang yg tidak sejalan dengan ideologi negara",0,0,0,45,https://x.com/BatasAir/status/1973643014070477156,https://x.com/IndoPopBase/status/1973625015645118820,0
2025-10-03 00:46:42+00:00,armagraceddon,ih anjir,0,0,0,7,https://x.com/armagraceddon/status/1973912557984653441,https://x.com/IndoPopBase/status/1973625015645118820,0
2025-10-02 06:36:13+00:00,rikiarya757,"kan sahabat baru lagi deket-deketnya, mana mau bersuara",0,0,0,7025,https://x.com/rikiarya757/status/1973638132739551348,https://x.com/IndoPopBase/status/1973625015645118820,0
2025-10-02 06:16:05+00:00,PROSPERDEGREAT,It's hard to ignore how quiet the government is on this. Are international laws only for some countries?,0,0,0,16217,https://x.com/PROSPERDEGREAT/status/1973633063637954708,https://x.com/IndoPopBase/status/1973625015645118820,0
2025-10-02 06:16:25+00:00,PROSPERDEGREAT,Why is Indonesia staying silent on this? International law is pretty clear on protecting ships in international waters.,0,0,0,8545,https://x.com/PROSPERDEGREAT/status/1973633148496793987,https://x.com/IndoPopBase/status/1973625015645118820,0
2025-10-02 11:46:17+00:00,indargisaurus,Pelayan negara yang abis dipuji sama Zionist mana berani?,0,0,0,13,https://x.com/indargisaurus/status/1973716162887430359,https://x.com/IndoPopBase/status/1973625015645118820,0
2025-10-02 09:10:39+00:00,jankerzone,"wait, i thought we were the abrahamshield gang?",0,0,0,3252,https://x.com/jankerzone/status/1973676995453329497,https://x.com/IndoPopBase/status/1973625015645118820,0
2025-10-02 06:43:52+00:00,B4n6_H4n5,Keknya Indonesia mau main Aman...,0,0,0,2211,https://x.com/B4n6_H4n5/status/1973640057702719747,https://x.com/IndoPopBase/status/1973625015645118820,0
2025-10-02 12:24:22+00:00,koalaitytimes,"Why Indonesia government is silent??? 

You need to ask him first  bayangin aja rakyatnya aja jadi buzzer bangga banget.",1,0,0,967,https://x.com/koalaitytimes/status/1973725745009827984,https://x.com/IndoPopBase/status/1973625015645118820,1
2025-10-02 14:55:19+00:00,jhndigitaldiary,"very very sadd sedih banget kenapa ini terjadi dipimpin oleh presiden yang cara berpikirnya begini. nyawa rakyat dilihat hanya sebagai angka, suara rakyat tidak diwaro, condong ke zionist. Ya Allah, protect me.",1,0,0,326,https://x.com/jhndigitaldiary/status/1973763734222098911,https://x.com/IndoPopBase/status/1973625015645118820,1
2025-10-02 22:27:34+00:00,sosorry2235011,"Semua pemerintahan  dari negara2 yang diam berarti, rahasia busuk pribadi mereka kepegang tuh ma mamarika dan Israel.  Lah tapi dia lupa, dosa mamarika dan zionshit lebih busuk dari busuk.",0,0,0,168,https://x.com/sosorry2235011/status/1973877546371723299,https://x.com/IndoPopBase/status/1973625015645118820,0
2025-10-02 10:36:41+00:00,zarrolladora,gue malu banget demi Allah,0,0,0,8,https://x.com/zarrolladora/status/1973698646576378177,https://x.com/IndoPopBase/status/1973625015645118820,0
2025-10-03 04:25:25+00:00,Kipas979,,0,0,0,51,https://x.com/Kipas979/status/1973967600536445020,https://x.com/IndoPopBase/status/1973625015645118820,0
2025-10-03 10:47:28+00:00,AisNobi,"Update Terkini dari Pemerintah Indonesia

Dukungan Penuh untuk Partisipasi Indonesia
Pemerintah (Kemlu) menyatakan dukungan penuh kepada Indonesia Global Peace Convoy (IGPC) yang ikut dalam Global Sumud Flotilla. 
ANTARA News
+2
ANTARA News
+2",0,0,0,61,https://x.com/AisNobi/status/1974063746810355900,https://x.com/IndoPopBase/status/1973625015645118820,0
2025-10-03 02:04:01+00:00,ZIMGODO,aduh gimana dounk,0,0,0,190,https://x.com/ZIMGODO/status/1973932017999131093,https://x.com/IndoPopBase/status/1973625015645118820,0
2025-10-02 17:16:37+00:00,agam_duadroe,,0,0,0,77,https://x.com/agam_duadroe/status/1973799292117922285,https://x.com/IndoPopBase/status/1973625015645118820,0
2025-10-02 18:35:57+00:00,sofeathef1rst,"najis presiden zionis, nanti kekal di neraka sm netanyahu",0,0,0,49,https://x.com/sofeathef1rst/status/1973819258653315081,https://x.com/IndoPopBase/status/1973625015645118820,0
2025-10-02 16:58:42+00:00,erniarrow,"Jangan salahkan kalau rakyatnya bergerak untuk mengingatkan, dan kalau itu terjadi massa akan jauh lebih besar dari gerakan-gerakan sebelumnya dan kali ini akan langsung menyasar kepala negara.",0,0,0,384,https://x.com/erniarrow/status/1973794784776237334,https://x.com/IndoPopBase/status/1973625015645118820,0
2025-10-01 16:27:00+00:00,IndoPopBase,"no na teases new music in interview with JoySauce:

“We can say that something exciting is coming. Very new and exciting.”",31,196,0,34698,https://x.com/IndoPopBase/status/1973424417104601124,https://x.com/IndoPopBase/status/1973424494103638368,227
2025-10-01 16:28:14+00:00,ursteulyNaveen,,0,0,0,61,https://x.com/ursteulyNaveen/status/1973424730071060842,https://x.com/IndoPopBase/status/1973424494103638368,0
2025-10-01 16:27:18+00:00,IndoPopBase,,3,5,0,6976,https://x.com/IndoPopBase/status/1973424494103638368,https://x.com/IndoPopBase/status/1973424417104601124,8
2025-10-01 21:38:12+00:00,dprinul,88rising ga pengen ikut bootcamp marketing gitu? biar bisa promosiin no na dengan layak.,1,2,0,884,https://x.com/dprinul/status/1973502733392208344,https://x.com/IndoPopBase/status/1973424417104601124,3
2025-10-01 16:27:59+00:00,jawaberat,Girl af least a proper promo,0,0,0,853,https://x.com/jawaberat/status/1973424664669200711,https://x.com/IndoPopBase/status/1973424417104601124,0
2025-10-01 16:46:35+00:00,christygardena,And we cant waitttt,0,0,0,1216,https://x.com/christygardena/status/1973429346007421197,https://x.com/IndoPopBase/status/1973424417104601124,0
2025-10-01 23:42:15+00:00,mikoladylove,can’t wait but also 88 need to promote them,0,0,0,529,https://x.com/mikoladylove/status/1973533953316495854,https://x.com/IndoPopBase/status/1973424417104601124,0
2025-10-01 16:28:04+00:00,PROSPERDEGREAT,"Keep it vague, but hype wonder what direction the new music will take.",0,0,0,1059,https://x.com/PROSPERDEGREAT/status/1973424686781571331,https://x.com/IndoPopBase/status/1973424417104601124,0
2025-10-01 16:28:05+00:00,ursteulyNaveen,The suspense is real  can’t wait to see what no na has in store this time!,0,0,0,900,https://x.com/ursteulyNaveen/status/1973424689440776542,https://x.com/IndoPopBase/status/1973424417104601124,0
2025-10-01 16:40:08+00:00,rubycln,No n with fans,0,0,0,473,https://x.com/rubycln/status/1973427724950876276,https://x.com/IndoPopBase/status/1973424417104601124,0
2025-10-01 16:56:38+00:00,balanceshxxt,just drop the damn full album already,0,0,0,549,https://x.com/balanceshxxt/status/1973431876133199927,https://x.com/IndoPopBase/status/1973424417104601124,0
2025-10-01 23:40:44+00:00,tarokar01,Can't wait ,0,0,0,403,https://x.com/tarokar01/status/1973533572926783995,https://x.com/IndoPopBase/status/1973424417104601124,0
2025-10-01 23:34:38+00:00,muthechan,promote them better,0,0,0,303,https://x.com/muthechan/status/1973532036905443409,https://x.com/IndoPopBase/status/1973424417104601124,0
2025-10-02 09:12:41+00:00,y2kfiles,Physical album???,0,0,0,160,https://x.com/y2kfiles/status/1973677505799491611,https://x.com/IndoPopBase/status/1973424417104601124,0
2025-10-01 23:04:06+00:00,rareb3ing,it's back off,0,0,0,310,https://x.com/rareb3ing/status/1973524350407266534,https://x.com/IndoPopBase/status/1973424417104601124,0
2025-10-02 01:06:28+00:00,apenarchives,no na's care,0,0,0,295,https://x.com/apenarchives/status/1973555145737904327,https://x.com/IndoPopBase/status/1973424417104601124,0
2025-10-01 23:43:14+00:00,_urfavvpersonnn,plssssssss kgnn,0,0,0,273,https://x.com/_urfavvpersonnn/status/1973534201308913987,https://x.com/IndoPopBase/status/1973424417104601124,0
2025-10-01 16:28:29+00:00,PROSPERDEGREAT,They’re really keeping it vague and wonder what direction the new music will take.,0,0,0,852,https://x.com/PROSPERDEGREAT/status/1973424791400186209,https://x.com/IndoPopBase/status/1973424417104601124,0
2025-10-02 20:53:42+00:00,Nawakaya99,No na aa i love you,0,2,0,75,https://x.com/Nawakaya99/status/1973853925733511303,https://x.com/IndoPopBase/status/1973424417104601124,2
2025-10-02 00:40:32+00:00,kalaniejingga,GIRLSSS,0,0,0,334,https://x.com/kalaniejingga/status/1973548620336320659,https://x.com/IndoPopBase/status/1973424417104601124,0
2025-10-01 19:53:40+00:00,fajardharmaa,vsauce when,0,0,0,310,https://x.com/fajardharmaa/status/1973476429091446800,https://x.com/IndoPopBase/status/1973424417104601124,0
2025-10-02 17:41:56+00:00,blazedlit,always excited for their music ,0,0,0,42,https://x.com/blazedlit/status/1973805661994827796,https://x.com/IndoPopBase/status/1973424417104601124,0
2025-10-02 19:12:26+00:00,ecebrighterdays,watch as they drop it and do no promo whatsoever,0,0,0,42,https://x.com/ecebrighterdays/status/1973828440030917088,https://x.com/IndoPopBase/status/1973424417104601124,0
2025-10-01 16:30:07+00:00,baerizzz,Oh wow can’t wait for our next tanked song ,0,0,0,358,https://x.com/baerizzz/status/1973425203435934094,https://x.com/IndoPopBase/status/1973424417104601124,0
2025-10-01 16:28:01+00:00,AmberSaira95910,That’s actually a clever twist  Mondays really are the missing link.,0,0,0,315,https://x.com/AmberSaira95910/status/1973424674970411266,https://x.com/IndoPopBase/status/1973424417104601124,0
2025-10-01 15:53:58+00:00,IndoPopBase,"Ahmad Dhani favors the Constitutional Court’s decision to reject the judicial review of education requirements for the president and state officials:

“Syarat Pemimpin menurut ISLAM itu adalah SHIDIQ-AMANAH-FATHONAH dan TABLIGH.. Gak pernah dengar syaratnya itu harus sarjana.”",261,486,0,93108,https://x.com/IndoPopBase/status/1973416105457885332,https://x.com/IndoPopBase/status/1973416148256608483,747
2025-10-01 15:54:08+00:00,IndoPopBase,,4,1,0,13732,https://x.com/IndoPopBase/status/1973416148256608483,https://x.com/IndoPopBase/status/1973416105457885332,5
2025-10-01 16:25:19+00:00,thezaym,"Kalo syarat pemimpin itu SHIDIQ, AMANAH, FATHONAH DAN TABHLIGH.
berarti PRABOWO dan GIBRAN harusnya gamasuk syarat",1,103,0,9437,https://x.com/thezaym/status/1973423996546002988,https://x.com/IndoPopBase/status/1973416105457885332,104
2025-10-01 15:58:32+00:00,irularr_,pantes indonesia gak maju maju cuma sekedar perdebatin “beragama” atau “berilmu”. padahal dua duanya harus sejalan dan penting.,1,32,0,7104,https://x.com/irularr_/status/1973417254466494712,https://x.com/IndoPopBase/status/1973416105457885332,33
2025-10-01 16:21:08+00:00,tedfess_ot9,and you are not siddiq amanah fathonah and tabligh indeed so what’s your point,2,23,0,4223,https://x.com/tedfess_ot9/status/1973422940365660198,https://x.com/IndoPopBase/status/1973416105457885332,25
2025-10-01 16:06:20+00:00,faiztimewa,Jaman sekarang utk mencapai Fathonah alias cerdas ya harus dari jalur pendidikan pak. Jangan samakan kita dengan nabi pak. Kita mana bisa cerdas kalau gak sekolah? Hehe,0,25,0,6657,https://x.com/faiztimewa/status/1973419217635647597,https://x.com/IndoPopBase/status/1973416105457885332,25
2025-10-01 16:42:43+00:00,andreaonchain,Tambah tahun kenapa tambah goblok sih lu?? Bunda Maia hoki bgt bs pisah dr lu bjir,0,0,0,60,https://x.com/andreaonchain/status/1973428372555571458,https://x.com/IndoPopBase/status/1973416105457885332,0
2025-10-01 15:54:22+00:00,SaddamWeb3,boleh,0,0,0,309,https://x.com/SaddamWeb3/status/1973416207547248933,https://x.com/IndoPopBase/status/1973416105457885332,0
2025-10-01 16:20:35+00:00,JokoREBORNN,"Sayangnya ini negara konstitusi, bukan negara Islam. Dengan lu berstatement kayak gitu cuma nunjukin berapa inkompetennya lu sbg stakeholder",1,7,0,4365,https://x.com/JokoREBORNN/status/1973422804021510582,https://x.com/IndoPopBase/status/1973416105457885332,8
2025-10-01 18:59:14+00:00,GandalfsWhisper,"Ga usah ngomong Shiddiq, Amanah, Fatonah, Tabligh. Hukuman pidana buat anak lu aja lu beli.

Klo syarat cm sarjana & popularitas, lu pasti gampang masuk (ijazah tinggal beli kaya yg onoh). Klo pake 4 standar dlm Islam itu 95% anggota DPR out semua, termasuk (apalagi) LU. Mikir.",1,5,0,2893,https://x.com/GandalfsWhisper/status/1973462728489705734,https://x.com/IndoPopBase/status/1973416105457885332,6
2025-10-01 16:26:20+00:00,_rairawan,Ohh shit.. Prabowo dan gibran harus dilengserkan karena tidak FATHONAH,0,0,0,2157,https://x.com/_rairawan/status/1973424251433857237,https://x.com/IndoPopBase/status/1973416105457885332,0
2025-10-01 22:10:50+00:00,Padamu___,Alah jembooot,0,0,0,122,https://x.com/Padamu___/status/1973510948288864620,https://x.com/IndoPopBase/status/1973416105457885332,0
2025-10-02 09:05:04+00:00,wahyu_djanti88,"Hahahaha ...ga paham artinya ato pura2 bego sih?? Jelas2 4 sifat Rosulullah itu ada fatonah=cerdas...jaman itu ga ada gelar pendidikan, tp jls gelar fatonah itu ga sembarangan dberikan tanpa bukti. 
Sementara omon2 n belimbing sayur 8 bulan ini terbukti spt apa???",0,0,0,101,https://x.com/wahyu_djanti88/status/1973675590365725110,https://x.com/IndoPopBase/status/1973416105457885332,0
2025-10-02 00:07:39+00:00,afrilla__,"ya kalo memang sarjana buktiin kalo mmg sarjana 
@xxtienft
 :)",0,0,0,12,https://x.com/afrilla__/status/1973540344546599080,https://x.com/IndoPopBase/status/1973416105457885332,0
2025-10-01 22:56:03+00:00,mukabeton,"orang indo jadi tolol masuk politik! bisa gitu yaa??!! 
@DPR_RI
 @officialMKRI",0,0,0,20,https://x.com/mukabeton/status/1973522325602705533,https://x.com/IndoPopBase/status/1973416105457885332,0
2025-10-02 00:52:47+00:00,GendiOfficial28,"Duh anjir gue selalu dilema liat si botak ini, di sisi musik gue nge fans abis. Tapi kalau lagi main politik politikan gak pernah ada ucapan dia yang bener di telinga / mata gue",0,0,0,62,https://x.com/GendiOfficial28/status/1973551702864437368,https://x.com/IndoPopBase/status/1973416105457885332,0
2025-10-01 21:07:46+00:00,distinctv_,"Lah tolol nih AHMAD wkwkwk, dipikir arti Fathonah itu apa?",0,0,0,42,https://x.com/distinctv_/status/1973495074773450872,https://x.com/IndoPopBase/status/1973416105457885332,0
2025-10-01 22:26:16+00:00,alfanrahadi,"la terus dipikir Nabi Muhammad ga berilmu? validasi ilmu di dunia modern kan gelar, kalau bisa yang lengkap juga, shidiq, amanah, fathonah, tabligh dan alim. gelar ya juga pas screening divalidasi, yang ketahuan nembak atau palsu ya ga bisa masuk.",0,0,0,105,https://x.com/alfanrahadi/status/1973514829416816923,https://x.com/IndoPopBase/status/1973416105457885332,0
2025-10-02 01:00:36+00:00,decepticon073,"Sifat Shidiq & Fathonah kalo gak belajar dari pendidikan tinggi ya susah dapatnya.
Kecuali dia hamba"" yg terpilih macam nabi/rosul.",0,0,0,15,https://x.com/decepticon073/status/1973553671293251803,https://x.com/IndoPopBase/status/1973416105457885332,0
2025-10-01 16:51:19+00:00,zacacarkaz,gausah bawa² agama bisa ga anjing lu udh bawa² agama ampe korup tai lu,0,0,0,44,https://x.com/zacacarkaz/status/1973430536434753642,https://x.com/IndoPopBase/status/1973416105457885332,0
2025-10-02 10:40:03+00:00,greybell37,"Of course dia ngomong itu, istrinya aja gak sarjana jadi anggota DPR ",0,0,0,35,https://x.com/greybell37/status/1973699492546503119,https://x.com/IndoPopBase/status/1973416105457885332,0
2025-10-01 21:48:24+00:00,segerombol,"and do they even shidiq (benar), amanah (dapat dipercaya), tabligh (menyampaikan) and fatonah (cerdas) at the first place? ",0,0,0,290,https://x.com/segerombol/status/1973505301082186207,https://x.com/IndoPopBase/status/1973416105457885332,0
2025-10-01 15:59:55+00:00,notttmike,very contrary to how they set the bar so high for job recruitment nowadays.,0,0,0,319,https://x.com/notttmike/status/1973417602841190406,https://x.com/IndoPopBase/status/1973416105457885332,0
2025-10-01 22:40:01+00:00,mencla_mencle,Botak satu ini kagak ngaca apa gimana ya? Ra nduwe isin,0,0,0,25,https://x.com/mencla_mencle/status/1973518292188012936,https://x.com/IndoPopBase/status/1973416105457885332,0
2025-10-01 22:11:13+00:00,masreyhaan,Ukuran siddiq amanah tabligh ama fathanah itu gimanaa maliihh,0,0,0,39,https://x.com/masreyhaan/status/1973511044636221779,https://x.com/IndoPopBase/status/1973416105457885332,0
2025-10-01 16:29:00+00:00,dimitriceta,Does he know what meaning of fathonah???!!,0,0,0,195,https://x.com/dimitriceta/status/1973424923147411902,https://x.com/IndoPopBase/status/1973416105457885332,0
2025-10-02 03:13:21+00:00,HandyW12,"Bawa bawa agama mulu,tapi kelakuannya tidak mencerminkan umat beragama",0,0,0,18,https://x.com/HandyW12/status/1973587078681338325,https://x.com/IndoPopBase/status/1973416105457885332,0
2025-10-02 07:24:45+00:00,ngapalocok,"Yaudah, keluar sono luh. Gakusah jadi perwakilan lagi lah",0,0,0,8,https://x.com/ngapalocok/status/1973650346863108114,https://x.com/IndoPopBase/status/1973416105457885332,0
2025-10-02 02:57:52+00:00,Sunyisejati,"Dani dani, kalau syarat itu diterapkan ya mana ada yg bisa jadi pemimpin di negeri ini",0,0,0,4,https://x.com/Sunyisejati/status/1973583179710865451,https://x.com/IndoPopBase/status/1973416105457885332,0
2025-10-02 07:03:45+00:00,Pretetett,"Tapi Indonesia bukan negara islam meski mayoritasnya beraga islam, lupa ya?",0,0,0,55,https://x.com/Pretetett/status/1973645058512658606,https://x.com/IndoPopBase/status/1973416105457885332,0
2025-10-02 04:51:23+00:00,Hyandi_,Kenapa ga sekalian hukum di Indonesia jadiin hukum islam aja? Biar yang maling duit rakyat dipotong tangannya,0,0,0,57,https://x.com/Hyandi_/status/1973611748776415670,https://x.com/IndoPopBase/status/1973416105457885332,0
2025-10-02 03:03:47+00:00,bsokakubahagia, omongannya selalu menjadi boomerang utk dirinya.,0,0,0,8,https://x.com/bsokakubahagia/status/1973584669003358717,https://x.com/IndoPopBase/status/1973416105457885332,0
2025-10-02 00:30:04+00:00,roweeasley,Tapi kalau kriteria SHIDIQ-AMANAH-FATHONAH dan TABLIGH nya juga ga ada gimana? Apalagi yang part SHIDIQ dan AMANAH ga keliatan.,0,0,0,138,https://x.com/roweeasley/status/1973545984857874911,https://x.com/IndoPopBase/status/1973416105457885332,0
2025-10-01 16:50:15+00:00,yaelahapasi,Pemimpin lo noh kaga memenuhi semua yang lu bilang menurut Islam,0,0,0,147,https://x.com/yaelahapasi/status/1973430271115657721,https://x.com/IndoPopBase/status/1973416105457885332,0
2025-10-02 06:49:40+00:00,KesirupanMassal,"Pertama, Fathonah artinya cerdas. 
Kedua, kalau syaratnya harus 4 itu, lha pres & wapres sekarang punya apa enggak?",0,0,0,29,https://x.com/KesirupanMassal/status/1973641516599091457,https://x.com/IndoPopBase/status/1973416105457885332,0
2025-10-02 01:35:52+00:00,naurchalant,monyetttt stop jual jual agamaaaa ,0,0,0,9,https://x.com/naurchalant/status/1973562547463921958,https://x.com/IndoPopBase/status/1973416105457885332,0
2025-10-01 19:57:58+00:00,supdumpling,Tau makna fathonah itu apa kan ya? Tau kan ya?,0,0,0,264,https://x.com/supdumpling/status/1973477511582589283,https://x.com/IndoPopBase/status/1973416105457885332,0
2025-10-01 22:03:24+00:00,raffinyourhead,"tipikal indonesian politicians ya begini, hobi banget bawa agama buat jadi dalil pembenaran",0,0,0,53,https://x.com/raffinyourhead/status/1973509078245842961,https://x.com/IndoPopBase/status/1973416105457885332,0
2025-10-01 23:55:47+00:00,mieyamindepok,"lahhh kalo sekarang maunya pake ilmu agama gt, udah dijalankan belum selama ini? beraakkkkk",0,0,0,124,https://x.com/mieyamindepok/status/1973537358017601551,https://x.com/IndoPopBase/status/1973416105457885332,0
2025-10-02 00:11:35+00:00,mirrramenn,"ya itu kan menurut islam bukan menurut konstitusi negara ini.
botak gila",0,0,0,28,https://x.com/mirrramenn/status/1973541335866155513,https://x.com/IndoPopBase/status/1973416105457885332,0
2025-10-02 02:55:25+00:00,n0irsanity,Malah makin banyak yg ga masuk syarat dong cok,0,0,0,8,https://x.com/n0irsanity/status/1973582565958369294,https://x.com/IndoPopBase/status/1973416105457885332,0
2025-10-01 23:59:50+00:00,Koishi_ihsioK,Enak ya tinggal sembunyi di balik agama,0,0,0,22,https://x.com/Koishi_ihsioK/status/1973538379825627274,https://x.com/IndoPopBase/status/1973416105457885332,0
2025-10-01 23:13:48+00:00,ansory_arrawiy,"Malah harusnya menurut gw seorang pengurus negara harus s2, artinya dia benar2 ahli",0,0,0,42,https://x.com/ansory_arrawiy/status/1973526792452579594,https://x.com/IndoPopBase/status/1973416105457885332,0
2025-10-01 23:24:03+00:00,monathty19,"Dari 4 syarat yg di sebut, gak ada 1 pun masuk kriteria ",0,0,0,141,https://x.com/monathty19/status/1973529372138283193,https://x.com/IndoPopBase/status/1973416105457885332,0
2025-10-02 02:32:23+00:00,kopitempait,Apa si gibran sudah memenuhi syarat yg anda sebutkan itu? Faham agama saja tidak si gibran itu!,0,0,0,61,https://x.com/kopitempait/status/1973576767068840096,https://x.com/IndoPopBase/status/1973416105457885332,0
2025-10-02 00:57:38+00:00,GobloSayaBilang,"Nu kieu wae maneh make agama, dhan.",0,0,0,9,https://x.com/GobloSayaBilang/status/1973552922228301968,https://x.com/IndoPopBase/status/1973416105457885332,0
2025-10-01 16:39:49+00:00,becomingism,"Berisik ni orang kyk becus aja kerjanya. Udah bener lu bikin lagu aja, Om",0,0,0,131,https://x.com/becomingism/status/1973427645523415294,https://x.com/IndoPopBase/status/1973416105457885332,0
2025-10-01 22:58:15+00:00,kopi_baru,kau ga usah bawa2 ajaran agamamu di dalam ketatanegaraan lah dhani,0,0,0,33,https://x.com/kopi_baru/status/1973522877992542472,https://x.com/IndoPopBase/status/1973416105457885332,0
2025-10-01 16:22:05+00:00,redermoree,"lu menjabat di sebuah negara, bukan pesantren.",0,0,0,586,https://x.com/redermoree/status/1973423180225323435,https://x.com/IndoPopBase/status/1973416105457885332,0
2025-10-02 00:29:17+00:00,AzureNoutarii,"Mas inget Ketuhanan yang Maha Esa bukan Ketuhanan, dengan kewajiban menjalankan syariat Islam bagi pemeluk-pemeluknya",0,0,0,61,https://x.com/AzureNoutarii/status/1973545787234853138,https://x.com/IndoPopBase/status/1973416105457885332,0
2025-10-02 18:26:27+00:00,janganfollowai2,PLISLAHH Dia ini tdk prnh berkaca njing,0,0,0,6,https://x.com/janganfollowai2/status/1973816865521873362,https://x.com/IndoPopBase/status/1973416105457885332,0
2025-10-01 15:30:42+00:00,·,knp black and white ya kaya orang meninggal (aamiin) mungkin itu indirect message nya dari si wowo biar fufufafa meninggal (aamiin),20,133,0,15581,https://x.com/helfut/status/1973410248598954309,https://x.com/IndoPopBase/status/1973409412233699540,153
2025-10-01 15:45:21+00:00,GhhopesHi,Happy birthday Mas Gibran  wish you all the worst,3,58,0,15290,https://x.com/GhhopesHi/status/1973413937405370844,https://x.com/IndoPopBase/status/1973409412233699540,61
2025-10-01 23:56:21+00:00,coffebit,Selamat ulang tahun buat brother kitee Gibran rakabuming. Satu aja pisan kitee kalo mau nyebrang jangan lupa tengok kanan kiri.,15,6,0,12720,https://x.com/coffebit/status/1973537500040929467,https://x.com/IndoPopBase/status/1973409412233699540,21
2025-10-01 20:50:32+00:00,b1ntang_____,...,8,52,0,7301,https://x.com/b1ntang_____/status/1973490739377217975,https://x.com/IndoPopBase/status/1973409412233699540,60
2025-10-01 15:49:30+00:00,SaddamWeb3,"On this day, tepat 14 tahun yang lalu pada 1 Oktober 2011, Mas Kaesang mengucapkan selamat ulang tahun kepada Ibu Iriana Jokowi dan Mas Gibran, pemilik akun Kaskus Fufufafa. Sehat-sehat ya kalian sekeluarga

happy birthday pak wapres",0,6,0,8693,https://x.com/SaddamWeb3/status/1973414982747574494,https://x.com/IndoPopBase/status/1973409412233699540,6
2025-10-01 15:34:28+00:00,txtdaritaxpayer,"Buset designnya kayak kasih ucapan ulang tahun buat terakhir kalinya banget, Ndut",1,5,0,9518,https://x.com/txtdaritaxpayer/status/1973411199086895436,https://x.com/IndoPopBase/status/1973409412233699540,6
2025-10-01 16:37:26+00:00,jansuspendbgst,That murder eye,2,9,0,2189,https://x.com/jansuspendbgst/status/1973427042952819118,https://x.com/IndoPopBase/status/1973409412233699540,11
2025-10-02 04:38:17+00:00,RedPhoenix____,Udah punya jawaban belum wok?,0,0,0,464,https://x.com/RedPhoenix____/status/1973608453789892868,https://x.com/IndoPopBase/status/1973409412233699540,0
2025-10-01 15:41:23+00:00,hardhene,ouuuu he manifests his funeral ijbol,1,0,0,4016,https://x.com/hardhene/status/1973412940125782409,https://x.com/IndoPopBase/status/1973409412233699540,1
2025-10-01 15:45:50+00:00,FaSs1011701,At least we understand his hidden niat towards his wapres,0,0,0,414,https://x.com/FaSs1011701/status/1973414059950350357,https://x.com/IndoPopBase/status/1973409412233699540,0
2025-10-01 16:03:20+00:00,sahabatnonoy,"ehh tapi emang theme ig pak prabowo item putih gak sii? foto-fotonya banyak yang item putih, maybe biar konsisten estetika postingannya. 

cuma kalo bikin kebijakan napa susah konsisten sih wo?  plin-plan dan blunder",1,0,0,1225,https://x.com/sahabatnonoy/status/1973418461847233002,https://x.com/IndoPopBase/status/1973409412233699540,1
2025-10-01 15:55:22+00:00,marcelasidoo,Persiapan kah karna umur nga ada yg tau,0,0,0,269,https://x.com/marcelasidoo/status/1973416457762644042,https://x.com/IndoPopBase/status/1973409412233699540,0
2025-10-01 16:23:50+00:00,cursedilemma,"dari kemarin nih pejabat kalo bikin design kaya design turut berduka cita deh, udah pada mendekati ajal kah?",1,0,0,1664,https://x.com/cursedilemma/status/1973423620212089290,https://x.com/IndoPopBase/status/1973409412233699540,1
2025-10-01 15:56:35+00:00,agtszenitsu,jelek dari banyak aspek sampe sesimpel ngucapin hbd ke wakilnya sendiri kek ngucapin ke org meninggal. padahal duit dia banyak kenapa ga hire ilustrator lokal lah minimal ,1,0,0,881,https://x.com/agtszenitsu/status/1973416763573543282,https://x.com/IndoPopBase/status/1973409412233699540,1
2025-10-02 00:36:38+00:00,roweeasley,"Foto nya hitam putih udah cocok banget, tinggal nambah lagu Opick terangkanlah atau lagu Chrisye Ketika Tangan dan Kaki Berkata ",0,0,0,1355,https://x.com/roweeasley/status/1973547637833146632,https://x.com/IndoPopBase/status/1973409412233699540,0
2025-10-02 01:41:15+00:00,flriiest,item putih banget.... wkwkw,0,1,0,24,https://x.com/flriiest/status/1973563899942412636,https://x.com/IndoPopBase/status/1973409412233699540,1
2025-10-01 17:41:42+00:00,DegenKongg,"Itu matany kayak kurang singkron, apa pake AI prompt kah?",5,3,0,11336,https://x.com/DegenKongg/status/1973443217057362092,https://x.com/IndoPopBase/status/1973409412233699540,8
2025-10-02 01:30:15+00:00,Anissa1Q,Mereka yg sekoalisi pemerintah ini klo ada yg ultah fotonya mesti hitam putih klo ga gt kek ucapan bela sungkawa... Kalian satu sama lain doain mati ato gmn sih?,0,0,0,1416,https://x.com/Anissa1Q/status/1973561132746154364,https://x.com/IndoPopBase/status/1973409412233699540,0
2025-10-01 16:51:47+00:00,NAHUCIREK,"Kaya pamflet ucapan berduka, semoga segera dan beneran ke alam baka",0,0,0,1994,https://x.com/NAHUCIREK/status/1973430657020994052,https://x.com/IndoPopBase/status/1973409412233699540,0
2025-10-01 15:48:13+00:00,jvstforvan,hbd fufufafa,0,0,0,174,https://x.com/jvstforvan/status/1973414657726751017,https://x.com/IndoPopBase/status/1973409412233699540,0
2025-10-02 02:05:20+00:00,coup_de_et4t,Teori konspirasi apalagi ini blud,0,0,0,68,https://x.com/coup_de_et4t/status/1973569958958473438,https://x.com/IndoPopBase/status/1973409412233699540,0
2025-10-01 19:11:32+00:00,ntijamet,mau ngelayat tapi orang nya belom mati ,0,0,0,701,https://x.com/ntijamet/status/1973465826687939010,https://x.com/IndoPopBase/status/1973409412233699540,0
2025-10-02 12:45:12+00:00,Akang_RB26deTT,Selamat meninggal,0,0,0,19,https://x.com/Akang_RB26deTT/status/1973730990561566819,https://x.com/IndoPopBase/status/1973409412233699540,0
2025-10-02 01:18:44+00:00,natanremyless,"1 pria ulang tahum, 19 juta lainnya bersumpah serapah",0,0,0,579,https://x.com/natanremyless/status/1973558233022546035,https://x.com/IndoPopBase/status/1973409412233699540,0
2025-10-02 12:20:45+00:00,Lassegaf2,"Without Gibran, Prabowo wouldn't have become president. Without Prabowo, Gibran couldn't have become vice president. That's why Gibran is unlikely to step down. Behind the scenes, Prabowo and Jokowi are working together to control Indonesian politics until 2025/2029.",0,0,0,101,https://x.com/Lassegaf2/status/1973724835630219366,https://x.com/IndoPopBase/status/1973409412233699540,0
2025-10-02 11:41:42+00:00,Andyfeili00,"Knp harus hitam putih gitu warnanya, kyk foto pemakanan ",0,0,0,19,https://x.com/Andyfeili00/status/1973715007448973531,https://x.com/IndoPopBase/status/1973409412233699540,0
2025-10-02 04:02:49+00:00,reza_63,"Warna hitam putih Itu simbol dalam ""Adat Jawa"", memiliki makna filosofis yg mendalam tentang kehidupan, moralitas, dan keseimbangan alam yang dipegang teguh oleh masyarakat Jawa. Artinya Bapak Presiden mengenal Wakil Presiden nya luar dalam. Sugeng ambal warsa Mas Wapres ",0,0,0,84,https://x.com/reza_63/status/1973599525173707078,https://x.com/IndoPopBase/status/1973409412233699540,0
2025-10-02 06:13:43+00:00,RomanRomannista,Happy Birthday Fu,0,0,0,123,https://x.com/RomanRomannista/status/1973632467279196270,https://x.com/IndoPopBase/status/1973409412233699540,0
2025-10-01 15:32:09+00:00,PROSPERDEGREAT,Didn’t expect this birthday shoutout. Are they getting closer politically or just keeping it friendly?,0,0,0,5099,https://x.com/PROSPERDEGREAT/status/1973410614404874384,https://x.com/IndoPopBase/status/1973409412233699540,0
2025-10-01 15:31:47+00:00,PROSPERDEGREAT,Wonder if they’re planning something big together this year or just keeping it friendly?,0,0,0,1570,https://x.com/PROSPERDEGREAT/status/1973410520959943080,https://x.com/IndoPopBase/status/1973409412233699540,0
2025-10-01 15:41:19+00:00,ursteulyNaveen,"Happy birthday, Gibran! Wishing you strength, wisdom, and success.",0,0,0,1226,https://x.com/ursteulyNaveen/status/1973412920605417853,https://x.com/IndoPopBase/status/1973409412233699540,0
2025-10-01 15:32:54+00:00,aatelieer,inimah doain cepet meninggal soalnya umurnya ngurang,0,0,0,266,https://x.com/aatelieer/status/1973410804184785093,https://x.com/IndoPopBase/status/1973409412233699540,0
2025-10-01 16:42:14+00:00,mengudarabebas,"Bapak politik paling munafik seindonesia raya  anda sendiri yg bilang: saya yg pilih dia jadi wakil

( bohong aslinya dia bantalin tuduhan publik !! J lah yg menyodorkan 'maksa' anaknya )

SandiOno juga sy sengaja kirim ke 03 untuk memata-matai 03  padahal malu bgt aslinya ",0,0,0,673,https://x.com/mengudarabebas/status/1973428253219332563,https://x.com/IndoPopBase/status/1973409412233699540,0
2025-10-01 16:32:22+00:00,cupang_fish,"Kenapa foto yang di pilih itu sih? Kek ngeledek banget wkwkwk. 
Padahal foto udah pake setelan jas, tapi ekpresinya kaya awkward banget ",0,0,0,707,https://x.com/cupang_fish/status/1973425770006708521,https://x.com/IndoPopBase/status/1973409412233699540,0
2025-10-01 17:40:12+00:00,istriable06,"Gitu ya temen2 kalo ga cocok sebenernya yauda gausa di paksa ya.. emang gak seumur hidup sih, tapi 5 tahun lama loh, lama..",0,0,0,130,https://x.com/istriable06/status/1973442841792880926,https://x.com/IndoPopBase/status/1973409412233699540,0
2025-10-02 04:00:52+00:00,Utha_san,Bentar lagi nih wkkwwk siapa sih gk sakit hati dikata2in bgtu wkwkwk,0,0,0,66,https://x.com/Utha_san/status/1973599037938082122,https://x.com/IndoPopBase/status/1973409412233699540,0
2025-10-01 18:17:18+00:00,vforchz,Kaya poster org wafat dah,0,0,0,143,https://x.com/vforchz/status/1973452177193812013,https://x.com/IndoPopBase/status/1973409412233699540,0
2025-10-01 23:52:37+00:00,taejellys,ciye fufufafa diucapin ulang tahun,0,0,0,52,https://x.com/taejellys/status/1973536561695486172,https://x.com/IndoPopBase/status/1973409412233699540,0
2025-10-02 03:22:55+00:00,datuyulianto,Ngepost ucapannya kyk terpaksa banget sihlagi marahan kah kalian? ,0,0,0,474,https://x.com/datuyulianto/status/1973589485423398966,https://x.com/IndoPopBase/status/1973409412233699540,0
2025-10-02 03:22:30+00:00,callmesaturn_,"Hbd gibran, seneng deh umurnya makin berkurang di bumi. Cpt2 deh",0,0,0,135,https://x.com/callmesaturn_/status/1973589380397932646,https://x.com/IndoPopBase/status/1973409412233699540,0
2025-10-02 06:23:41+00:00,·,Paling adminnya yg buat mana ada Mbah Wowo main sosmed,0,0,0,217,https://x.com/pejalantakdir/status/1973634977075175674,https://x.com/IndoPopBase/status/1973409412233699540,0
2025-10-01 16:22:55+00:00,betterthanbrry,hawanya kek kaga enak gitu,0,0,0,109,https://x.com/betterthanbrry/status/1973423389252706637,https://x.com/IndoPopBase/status/1973409412233699540,0
2025-10-01 16:31:14+00:00,lcwkeys,yahh ga meninggal bete gw,0,0,0,151,https://x.com/lcwkeys/status/1973425485741986161,https://x.com/IndoPopBase/status/1973409412233699540,0
2025-10-02 00:00:02+00:00,BlueAnt03211193,Sebentarlagi berduka?? Kok hitam putih..,0,0,0,118,https://x.com/BlueAnt03211193/status/1973538430157201687,https://x.com/IndoPopBase/status/1973409412233699540,0
2025-10-01 23:16:23+00:00,Marqueesalenta,Kenapa igs nya hitam putih begitu? ,0,0,0,38,https://x.com/Marqueesalenta/status/1973527444675240150,https://x.com/IndoPopBase/status/1973409412233699540,0
2025-10-02 00:13:49+00:00,rest_area83,Kode kerassss ini mah wkwkk,0,0,0,116,https://x.com/rest_area83/status/1973541895168217133,https://x.com/IndoPopBase/status/1973409412233699540,0
2025-10-02 01:18:43+00:00,avoo100,kasih sayang atmin kepada anak owner,0,0,0,80,https://x.com/avoo100/status/1973558228161290521,https://x.com/IndoPopBase/status/1973409412233699540,0
2025-10-02 07:47:30+00:00,KayaPedagang,Tambahin motif bunga bunga dong pak presiden,0,0,0,46,https://x.com/KayaPedagang/status/1973656070930440429,https://x.com/IndoPopBase/status/1973409412233699540,0
2025-10-01 15:58:10+00:00,keustruckpdf,surem bgt potonya,0,0,0,85,https://x.com/keustruckpdf/status/1973417163613671453,https://x.com/IndoPopBase/status/1973409412233699540,0
2025-10-01 22:25:52+00:00,temanamaste,they hate each other ,0,0,0,55,https://x.com/temanamaste/status/1973514731576238156,https://x.com/IndoPopBase/status/1973409412233699540,0
2025-10-01 16:12:43+00:00,DestsPangestuni,"PLN aneh, giliran mati lampu, ga ada kompensasi, ga ada pemberitahuan... giliran ga dibayar padahal pake pemberitahuan, langsung mati..",4,280,0,40868,https://x.com/DestsPangestuni/status/1973420823466893549,https://x.com/IndoPopBase/status/1973402605645865373,284
2025-10-01 22:49:43+00:00,admiralkizaruuu,"Kalau di jakarta, 2 jam mati listrik aja udah breaking news. 
Kasihan emang provinsi selain di jawa",13,228,0,59117,https://x.com/admiralkizaruuu/status/1973520730735386880,https://x.com/IndoPopBase/status/1973402605645865373,241
2025-10-01 15:39:18+00:00,njowoki,"Rumah sakit, usaha-usaha lokal kesulitan semuanya. Penanganan kendalanya 3 hari ga selesai-selesai, mana klarifikasi-nya dari PLN juga ngga ada. Udah bener-bener kacau.",1,68,0,35062,https://x.com/njowoki/status/1973412414218788980,https://x.com/IndoPopBase/status/1973402605645865373,69
2025-10-01 16:54:27+00:00,bzzrhj,2025. Bayar Pajak dari ujung ke ujung pulau persentasenya sama. Tp yg di nikmati pembayar pajaknya beda. Itulah indonesia. Indonesia tanah airku aku berjanji padamu. Munjunjung tanah airku tanah airku indonesia.,1,94,0,28868,https://x.com/bzzrhj/status/1973431328042569864,https://x.com/IndoPopBase/status/1973402605645865373,95
2025-10-01 15:01:43+00:00,PROSPERDEGREAT,Three days straight? That’s wild. How are people even managing with no backup power?,7,23,0,83846,https://x.com/PROSPERDEGREAT/status/1973402958420169133,https://x.com/IndoPopBase/status/1973402605645865373,30
2025-10-01 16:21:04+00:00,SeaPandaa,"gila 3 hari! 
listrik udah d monopoli, tp tetep ga becus.",0,0,0,10855,https://x.com/SeaPandaa/status/1973422926411264397,https://x.com/IndoPopBase/status/1973402605645865373,0
2025-10-01 23:12:36+00:00,fajarajiie,"Negara yg dipimpin sama pro jionis ya jgn heran taktiknya kaya jionis. Dia ga mikir seberapa berbahaya tanpa listrik berkepanjangan buat bayi, ternak, usaha dll. Yg penting ambisinya tercapai bikin Aceh jadi ga lantang terhadap rezim.",2,41,0,8883,https://x.com/fajarajiie/status/1973526490806730939,https://x.com/IndoPopBase/status/1973402605645865373,43
2025-10-01 15:46:47+00:00,juventhira,"3 hari dan masih belum ada keterangan yg jelas dari PLN. Pemadaman juga ga adil, ada yang sama sekali ga mati, ada yang mati sampe 16 jam lebih, malah ada yang 2 hari ga nyala.",0,14,0,18973,https://x.com/juventhira/status/1973414296689562100,https://x.com/IndoPopBase/status/1973402605645865373,14
2025-10-01 15:14:12+00:00,kiokio878,All of this happened because Mulyono son in-law,1,21,0,6819,https://x.com/kiokio878/status/1973406097609564622,https://x.com/IndoPopBase/status/1973402605645865373,22
2025-10-01 15:22:11+00:00,bobi_tuankotta,"ngomong-ngomong soal major blackout, silakan dicek trit tentang pemadaman listrik dan pembakaran PLTD berikut:",1,28,0,18291,https://x.com/bobi_tuankotta/status/1973408107972927883,https://x.com/IndoPopBase/status/1973402605645865373,29
2025-10-01 16:50:51+00:00,linea_rosso,"warbiyasa, gegara ribut ama propinsi sebelah lgsung dikasih black out kaga diapa2in...",0,19,0,3424,https://x.com/linea_rosso/status/1973430420231561339,https://x.com/IndoPopBase/status/1973402605645865373,19
2025-10-01 15:46:30+00:00,elegansi66,"Tadi siang ada yg blg akan berlangsung sampe 5 hari ke depan, terus barusan ada yg blg akan berlangsung sampe 10 hari ke depan. Ga tau yg mana yg benar krn PLN pun ga ada kasih kejelasan. Hari ini dari jam 08.20 pagi padam sampe skrg belum nyala. Total udah 45 jam lebih padam :(",5,24,0,20326,https://x.com/elegansi66/status/1973414227022061640,https://x.com/IndoPopBase/status/1973402605645865373,29
2025-10-01 20:07:47+00:00,sao94027_,"Bayar listrik udahlah mahal, telat langsung diputus listrik, giliran blackout berhari2 gini pelanggan dapat apa? 
@pln_123",0,10,0,4605,https://x.com/sao94027_/status/1973479979855065324,https://x.com/IndoPopBase/status/1973402605645865373,10
2025-10-01 17:52:00+00:00,hqlidpp,Memang pln & negara anjing. Kalau kejadian di eropa / negara modern lain blackout sampe 3 hari kayak gini mungkin menteri & petinggi pln nya udah harakiri semuanya,0,3,0,2199,https://x.com/hqlidpp/status/1973445809179156605,https://x.com/IndoPopBase/status/1973402605645865373,3
2025-10-01 21:40:01+00:00,vladsyarif13,"Sepertinya PLN ingin menyalakan api perlawanan di dalam diri Rakyat Aceh. Jadi, kalau Aceh memberontak dan ingin pisah. Itu bukan salah mereka, tapi salah PLN.",0,1,0,835,https://x.com/vladsyarif13/status/1973503193750679916,https://x.com/IndoPopBase/status/1973402605645865373,1
2025-10-02 01:29:06+00:00,yourbitch_331,"it's giving ""ramadan kareem""",0,0,0,1269,https://x.com/yourbitch_331/status/1973560842504597617,https://x.com/IndoPopBase/status/1973402605645865373,0
2025-10-01 15:22:45+00:00,accriz,Yang hebatnya. Orang orangnya masih pada santuy,20,4,0,9263,https://x.com/accriz/status/1973408247685194170,https://x.com/IndoPopBase/status/1973402605645865373,24
2025-10-01 16:32:59+00:00,brentfordID,Bisa gak sih swasta bikin jaringan listrik di Indo? Jadi gak cuma ngandelin PLN..,0,0,0,4646,https://x.com/brentfordID/status/1973425923199476106,https://x.com/IndoPopBase/status/1973402605645865373,0
2025-10-02 10:34:41+00:00,twitrandomku,"Tuntut ganti rugi aja ke PLN.
Mereka kan jg perusahaan yg profit  oriented. Klo pelanggan dirugikan, ya harus ganti rugi. Profesional dong.

Jgn kau jadikan Aceh ""tahanan politik"". Mentang² gub nya berseteru dgn ipar wapres?",0,0,0,863,https://x.com/twitrandomku/status/1973698143071117377,https://x.com/IndoPopBase/status/1973402605645865373,0
2025-10-01 17:27:23+00:00,kucinggimbal,"Masa karena rebutan daerah kemarin itu jadi dibikin ""mati"" perlahan sih?",0,0,0,1056,https://x.com/kucinggimbal/status/1973439616201138519,https://x.com/IndoPopBase/status/1973402605645865373,0
2025-10-01 16:14:39+00:00,cwouette,"tai panas banget ege, jaringan ancur, air ga nyala, pln babi, monopoli gabecus emang",1,0,0,1721,https://x.com/cwouette/status/1973421311218352395,https://x.com/IndoPopBase/status/1973402605645865373,1
2025-10-01 15:32:10+00:00,Iam_Ndrrreeww,MAJOR WHAT?,0,2,0,3316,https://x.com/Iam_Ndrrreeww/status/1973410617798352933,https://x.com/IndoPopBase/status/1973402605645865373,2
2025-10-01 18:07:25+00:00,·,"di dom ku dulu 2/3 hari (klo ga salah inget) mati listrik, sempet nyala tapi bentar doang. bergilir gitu. PLN nya di demo warga smpe dibakar (dikit), dilemparin batu, besoknya nyala",2,0,0,4672,https://x.com/justsapii/status/1973449689602334831,https://x.com/IndoPopBase/status/1973402605645865373,2
2025-10-01 20:01:41+00:00,rahadianarief,"Anjir 3 hari tapi sepi sepi aja, ini kalo kejadian di pulau jawa bisa beda cerita",1,1,0,814,https://x.com/rahadianarief/status/1973478444823617690,https://x.com/IndoPopBase/status/1973402605645865373,2
2025-10-01 17:34:23+00:00,ntijamet,bekingan tambang illegal fight back? aneh bgt ini,2,1,0,1163,https://x.com/ntijamet/status/1973441375992684808,https://x.com/IndoPopBase/status/1973402605645865373,3
2025-10-02 03:13:22+00:00,protprotttt,agus thn lalu sumsel-sumbar-jambi-bengkulu yg mati berjam2 selama ampir 7 hari. tp gada yg peduli wkwk emg klo g jawa g viral g bakal ditangani dg cpt,0,0,0,620,https://x.com/protprotttt/status/1973587081743179906,https://x.com/IndoPopBase/status/1973402605645865373,0
2025-10-01 15:02:24+00:00,BlubluABC,Huhu degdegan takut kena giliran :(( daerah kaju rumah temen dah mati lg td :(,0,0,0,3036,https://x.com/BlubluABC/status/1973403126343307356,https://x.com/IndoPopBase/status/1973402605645865373,0
2025-10-01 22:48:14+00:00,saladbwuahaha,"Listrik pake swasta aja kali ya?
Apa2 yg dikelola negara gak ada yg bener.",0,0,0,1451,https://x.com/saladbwuahaha/status/1973520357144535379,https://x.com/IndoPopBase/status/1973402605645865373,0
2025-10-02 01:56:54+00:00,socreatesword,"PLN is fucking useless, 3 hari mati lampu gak ada kasi statement kejelasannya gimana. Di daerah ku malah hidup cuma 4 jam dari jam 3 malam sampe jam 7 pagi. Abis itu mati sampai jaringan internet juga hilang.",2,0,0,6468,https://x.com/socreatesword/status/1973567839861875199,https://x.com/IndoPopBase/status/1973402605645865373,2
2025-10-02 01:34:43+00:00,IrwindaF,"Kok bisa sampe 3 hari??? Trus rakyat Aceh kalau butuh apa2 gimana itu, dan ga viral beritanya. Emng klo bukan ibu kota negara pasti lamban kerjanya",1,0,0,626,https://x.com/IrwindaF/status/1973562257247445119,https://x.com/IndoPopBase/status/1973402605645865373,1
2025-10-01 15:11:34+00:00,mansurfers,gw di bekasi gak kena tuh,15,0,0,8016,https://x.com/mansurfers/status/1973405433156215270,https://x.com/IndoPopBase/status/1973402605645865373,15
2025-10-01 15:04:07+00:00,PROSPERDEGREAT,"This is small. In Nigeria, we stay months without no signs of light",3,2,0,25576,https://x.com/PROSPERDEGREAT/status/1973403559854043195,https://x.com/IndoPopBase/status/1973402605645865373,5
2025-10-01 22:04:25+00:00,Echie1993,Yang pada nyinyir sama orang Aceh mengenai mati listrik ini lupa kah kalau penyedia listrik di semua wilayah itu adalah PLN?,0,0,0,460,https://x.com/Echie1993/status/1973509330646475210,https://x.com/IndoPopBase/status/1973402605645865373,0
2025-10-02 10:18:30+00:00,ry_gand,"Sepertinya ada yg coba bermain di aceh, prabowo harus paham......",0,1,0,106,https://x.com/ry_gand/status/1973694069626015860,https://x.com/IndoPopBase/status/1973402605645865373,1
2025-10-02 13:12:02+00:00,Mas_fathur1,Terjadi hal seperti ini setelah ada ketegangan akibat ulah gub boby. Berbahaya bagi persatuan,0,1,0,191,https://x.com/Mas_fathur1/status/1973737743554584981,https://x.com/IndoPopBase/status/1973402605645865373,1
2025-10-02 11:20:35+00:00,gwathrenin,"Kemaren pulaunya diganggu, sekarang penerangannya kayak nggak diurusin. Aceh lagi diapain nih?",0,1,0,201,https://x.com/gwathrenin/status/1973709694595465708,https://x.com/IndoPopBase/status/1973402605645865373,1
2025-10-02 01:00:59+00:00,NouraFayruz,"Selain kejadian di Jawa,dilarang protes weii.",0,2,0,135,https://x.com/NouraFayruz/status/1973553765862306240,https://x.com/IndoPopBase/status/1973402605645865373,2
2025-10-01 15:02:21+00:00,PROSPERDEGREAT,"Seriously, surviving three days without power sounds brutal. Are stores and hospitals even keeping up?",0,1,0,35177,https://x.com/PROSPERDEGREAT/status/1973403114632818911,https://x.com/IndoPopBase/status/1973402605645865373,1
2025-10-01 15:02:03+00:00,ursteulyNaveen,"Three days without power in Aceh — the impact on daily life, businesses, and essential services is becoming more severe by the hour.",0,0,0,9407,https://x.com/ursteulyNaveen/status/1973403038246371516,https://x.com/IndoPopBase/status/1973402605645865373,0
2025-10-03 12:06:40+00:00,santo52194,"Gmna nich 
@pln_123
 ~ 
D suruh sma 
@jokowi
 ea,,,gara2 mntunya s 
@bobbynasution_
 b konplik dgn Muaelem",0,1,0,64,https://x.com/santo52194/status/1974083679850025342,https://x.com/IndoPopBase/status/1973402605645865373,1
2025-10-01 17:40:10+00:00,kactchaw,daerah kantor gubernur sm perumahan DPR-D gaa matii samsek ,0,0,0,1383,https://x.com/kactchaw/status/1973442831575556156,https://x.com/IndoPopBase/status/1973402605645865373,0
2025-10-03 03:33:06+00:00,adhams,dan semua orang disuruh pake EV. apa ga makin gelap tu? ,0,1,0,3015,https://x.com/adhams/status/1973954437237600761,https://x.com/IndoPopBase/status/1973402605645865373,1
2025-10-01 16:42:05+00:00,·,"FRRR
aku sampe book hotel cuz i need water and electricity ",1,1,0,3430,https://x.com/trymksh/status/1973428214853943321,https://x.com/IndoPopBase/status/1973402605645865373,2
2025-10-02 08:58:23+00:00,anxietyinsidee,"Giliran ginian aja pengen banget dapet atensi lebih, sisanya mau merdeka sendiri, ngaku di jaman aceh tsunami bilang indo ga nolong ",1,0,0,443,https://x.com/anxietyinsidee/status/1973673907656986825,https://x.com/IndoPopBase/status/1973402605645865373,1
2025-10-02 20:56:36+00:00,amo_bolang,Ini apakah balas dendam karna pulau kemarin? Dari plat kendaraan sampe blackout 3 hari,0,1,0,142,https://x.com/amo_bolang/status/1973854654493831591,https://x.com/IndoPopBase/status/1973402605645865373,1
2025-10-01 16:36:35+00:00,mozafiz,gabayangin sesumuk apa klo siang :( lekas pulih acehh,0,0,0,667,https://x.com/mozafiz/status/1973426830263853438,https://x.com/IndoPopBase/status/1973402605645865373,0
2025-10-01 17:45:12+00:00,·,Nasib BL….,0,0,0,216,https://x.com/hynotbad/status/1973444097286496618,https://x.com/IndoPopBase/status/1973402605645865373,0
2025-10-01 16:14:25+00:00,Strawberrytrap4,Berita ini masuk berita tv gak sih?,4,0,0,4703,https://x.com/Strawberrytrap4/status/1973421252540072008,https://x.com/IndoPopBase/status/1973402605645865373,4
2025-10-01 16:29:27+00:00,mhdarieff_,bayangin 3 hari hidup tanpa listrik ,1,0,0,5523,https://x.com/mhdarieff_/status/1973425036683096163,https://x.com/IndoPopBase/status/1973402605645865373,1
2025-10-02 09:02:22+00:00,tarotbyyaya,"aceh wkwkwkw di mana listrik, sinyal dan air jauh lebih susah dicari daripada ganja atau pejabat korupsi dan selingkuh di kotanya ",3,0,0,625,https://x.com/tarotbyyaya/status/1973674910498299947,https://x.com/IndoPopBase/status/1973402605645865373,3
2025-09-30 12:26:04+00:00,psis_semarangg,Sherina diukurnya harusnya dari lihatlah lebih dekat,1,5,0,3499,https://x.com/psis_semarangg/status/1973001396971807203,https://x.com/IndoPopBase/status/1972999818126704712,6
2025-09-30 13:00:47+00:00,utdstewie,"Lots of inaccuracies. 
Agnes already broke through with Pernikahan Dini
Andien with Sahabat Setia
Anggun with Tua-Tua Keladi
BCL with Cinta Pertama 
Melly (Potret) with Salah
Reza with Pertama 
Sherina with Andai Aku Besar Nanti 
Titi DJ with Salahkah Aku
Vina with September",0,3,0,4272,https://x.com/utdstewie/status/1973010134436839479,https://x.com/IndoPopBase/status/1972999818126704712,3
2025-09-30 12:20:52+00:00,ursteulyNaveen,"Amazing how diverse the journeys are  Some found their spotlight as teenagers, others in their late 20s or even 30s. Just shows there’s no “perfect age” for success — talent shines when the time is right. ",0,10,0,3364,https://x.com/ursteulyNaveen/status/1973000089976381510,https://x.com/IndoPopBase/status/1972999818126704712,10
2025-09-30 12:32:25+00:00,Berfikarpositif,"Tolak ukur ""Breakout hits"" ini kayak gimana sih? Lagu Agnes yang udah sukses dari album ...And the story goes, sedangkan Tak Ada Logika dari album Waddup A, Sherina udah sukses dengan hitsnya di album petualangan sherina, Andien lagu2nya udah banyak yg Hits sebelum Saat Bahagia",3,0,0,6103,https://x.com/Berfikarpositif/status/1973002996251541815,https://x.com/IndoPopBase/status/1972999818126704712,3
2025-09-30 13:23:41+00:00,sangentodt,Not including queen Tina Toon is crazy work. She was 5 when she recorded her first studio album Bolo-bolo!,0,0,0,1288,https://x.com/sangentodt/status/1973015896974373328,https://x.com/IndoPopBase/status/1972999818126704712,0
2025-09-30 12:49:36+00:00,cheesecakechs,Where are the men? Do we have none?,2,0,0,1641,https://x.com/cheesecakechs/status/1973007319098441834,https://x.com/IndoPopBase/status/1972999818126704712,2
2025-09-30 12:33:02+00:00,kokobuncit,"Anggun can relate although her phenomenon single in 1990, Tua-Tua Keladi is huge , and Sherina had first breakout after Andai Aku Besar nanti, her second single on her debut album at 9.",0,0,0,2402,https://x.com/kokobuncit/status/1973003149553402082,https://x.com/IndoPopBase/status/1972999818126704712,0
2025-09-30 12:44:25+00:00,manusahalu,bukannya NIKI di lowkey duluan ya? yaa ga seheboh every summertime sih,0,0,0,304,https://x.com/manusahalu/status/1973006017060589649,https://x.com/IndoPopBase/status/1972999818126704712,0
2025-09-30 13:44:02+00:00,the_nolep,Sherina breakout hitsnya umur 17 tahun??? Bukannya jauh sebelum itu dia udah populer banget karena film petualangan sherina beserta lagu-lagunya?,0,0,0,716,https://x.com/the_nolep/status/1973021017208701125,https://x.com/IndoPopBase/status/1972999818126704712,0
2025-09-30 12:38:35+00:00,bukanverdonk,where's romaria - malu sama kucing?,0,0,0,778,https://x.com/bukanverdonk/status/1973004546902507728,https://x.com/IndoPopBase/status/1972999818126704712,0
2025-09-30 13:04:34+00:00,yohkkubi,"BCL tuh hits paling pertama bukannya Sunny ya, bukan Kecewa?",0,0,0,526,https://x.com/yohkkubi/status/1973011087407907029,https://x.com/IndoPopBase/status/1972999818126704712,0
2025-09-30 14:15:16+00:00,jstgnaniii,Salma ,0,0,0,141,https://x.com/jstgnaniii/status/1973028878588547248,https://x.com/IndoPopBase/status/1972999818126704712,0
2025-10-01 05:41:06+00:00,rioaditomo,Reza brokeout even in her debut with Pertama. Video gesek pantat and everything. She was huge from the get go. Pertama-Dia-Satu Yang Tak Bisa Lepas were huge. Also so many inaccurate things in this list.,0,0,0,246,https://x.com/rioaditomo/status/1973261873580745013,https://x.com/IndoPopBase/status/1972999818126704712,0
2025-09-30 12:35:06+00:00,orgility,"BCL bukannya Cinta Pertama, ya?!",0,0,0,771,https://x.com/orgility/status/1973003671857504383,https://x.com/IndoPopBase/status/1972999818126704712,0
2025-09-30 13:06:32+00:00,pulentembem,We blame Ari Bias so you couldn't mention Bilang Saja as Agnes' 1st breakout hits,1,0,0,489,https://x.com/pulentembem/status/1973011581622755359,https://x.com/IndoPopBase/status/1972999818126704712,1
2025-09-30 12:39:38+00:00,MAIL99FIGHTER,Melinda - Cinta satu malam,0,0,0,183,https://x.com/MAIL99FIGHTER/status/1973004813249180022,https://x.com/IndoPopBase/status/1972999818126704712,0
2025-09-30 16:51:32+00:00,lPosumA0209,"@pikaso_me
 screenshot this",1,0,0,96,https://x.com/lPosumA0209/status/1973068205250723930,https://x.com/IndoPopBase/status/1972999818126704712,1
2025-09-30 12:52:10+00:00,notforb1tch,where's ziva?,0,0,0,12,https://x.com/notforb1tch/status/1973007964652048452,https://x.com/IndoPopBase/status/1972999818126704712,0
2025-09-30 13:01:39+00:00,weyezblod,danilla,0,0,0,38,https://x.com/weyezblod/status/1973010354222559276,https://x.com/IndoPopBase/status/1972999818126704712,0
2025-09-30 19:21:03+00:00,void_cure,"NIKI breakout di summertime? Perasaan dari Lowkey, la la lost you, bahkan i like u udah booming deh",0,0,0,278,https://x.com/void_cure/status/1973105832645763296,https://x.com/IndoPopBase/status/1972999818126704712,0
2025-09-30 14:30:19+00:00,kitty_gandalf,"Umur 15 dan udah rilis masterpiece macem ""Bintang Kehidupan""  ril Lady Rocker

ga kebayang kalo almarhumah Nike Ardila masih hidup ampe sekarang, bakal sebanyak apa lagu hit beliau",0,0,0,405,https://x.com/kitty_gandalf/status/1973032665298440269,https://x.com/IndoPopBase/status/1972999818126704712,0
2025-09-30 13:05:12+00:00,subzerotea,And where is my fave pink glaze donut mambo?,0,0,0,261,https://x.com/subzerotea/status/1973011247391195170,https://x.com/IndoPopBase/status/1972999818126704712,0
2025-09-30 12:35:10+00:00,baleunn,I think sherina since 10 year old,0,0,0,294,https://x.com/baleunn/status/1973003687414087946,https://x.com/IndoPopBase/status/1972999818126704712,0
2025-09-30 14:18:27+00:00,ggbdlprmn,"Adhitia Sofyan and Cholil ERK, their breakout hits when they were 33 years old",0,1,0,563,https://x.com/ggbdlprmn/status/1973029679536992520,https://x.com/IndoPopBase/status/1972999818126704712,1
2025-09-30 14:26:43+00:00,grandehometown,see? there is no man in this list,0,0,0,155,https://x.com/grandehometown/status/1973031758842212494,https://x.com/IndoPopBase/status/1972999818126704712,0
2025-09-30 12:37:55+00:00,PROSPERDEGREAT,Wild to see how many of them were still teenagers when they broke out. Makes you realize how early the industry pushes talent to the spotlight,0,0,0,226,https://x.com/PROSPERDEGREAT/status/1973004380153770073,https://x.com/IndoPopBase/status/1972999818126704712,0
2025-09-30 12:38:27+00:00,PROSPERDEGREAT,Crazy how many of them blew up before even hitting 20. Makes you wonder how different their careers would look if the big break came later,0,0,0,216,https://x.com/PROSPERDEGREAT/status/1973004515642319024,https://x.com/IndoPopBase/status/1972999818126704712,0
2025-10-01 00:33:55+00:00,onelightson,Where's fatin with aku memilih setia?,0,0,0,102,https://x.com/onelightson/status/1973184566484709592,https://x.com/IndoPopBase/status/1972999818126704712,0
2025-09-30 13:12:09+00:00,pinktragics,Danilla mentioned,0,0,0,185,https://x.com/pinktragics/status/1973012994964783321,https://x.com/IndoPopBase/status/1972999818126704712,0
2025-09-30 14:07:50+00:00,kakaknyaleo,Parah bgt ga mention Dante - Fantasi,0,0,0,368,https://x.com/kakaknyaleo/status/1973027010168660188,https://x.com/IndoPopBase/status/1972999818126704712,0
2025-09-30 15:16:32+00:00,masbimosuryo,Agnes Monica mah masih bocil waktu duetnya sama Eza Yayang ngehits,1,0,0,223,https://x.com/masbimosuryo/status/1973044297210724805,https://x.com/IndoPopBase/status/1972999818126704712,1
2025-09-30 12:47:28+00:00,keanurksh,pantesan sampe ada hari patah hati nasional karena raisa saat itu cuma beda setahun saat pertama kali hits kalo dibandingin dengan hype bernadya sekarang wkwk,1,0,0,2302,https://x.com/keanurksh/status/1973006782454026540,https://x.com/IndoPopBase/status/1972999818126704712,1
2025-10-01 01:25:37+00:00,eca5595,Perempuan semua hehe,0,0,0,65,https://x.com/eca5595/status/1973197578134233545,https://x.com/IndoPopBase/status/1972999818126704712,0
2025-09-30 12:30:51+00:00,ttodoliz,Oh baby pas cinta 15 tahun ,0,0,0,257,https://x.com/ttodoliz/status/1973002602771300823,https://x.com/IndoPopBase/status/1972999818126704712,0
2025-09-30 14:55:30+00:00,Ghi2,Andien mah My Funny Valentine,0,0,0,143,https://x.com/Ghi2/status/1973039004091310115,https://x.com/IndoPopBase/status/1972999818126704712,0
2025-09-30 23:07:11+00:00,Zulzisn,Yang bener rossa apa tegar nih,0,0,0,93,https://x.com/Zulzisn/status/1973162741172224029,https://x.com/IndoPopBase/status/1972999818126704712,0
2025-09-30 22:09:30+00:00,indra_kur03,Sherina dari bocah juga udah breakout hits (album petualangan sherina). Risetnya kurang mendalam min!,0,0,0,233,https://x.com/indra_kur03/status/1973148223188639999,https://x.com/IndoPopBase/status/1972999818126704712,0
2025-09-30 12:52:50+00:00,BANANAKAKUMEl,and JKT48?,1,0,0,411,https://x.com/BANANAKAKUMEl/status/1973008133091143807,https://x.com/IndoPopBase/status/1972999818126704712,1
2025-09-30 12:25:09+00:00,loenpiambaklien,And Mayangsari?,0,0,0,602,https://x.com/loenpiambaklien/status/1973001166767427988,https://x.com/IndoPopBase/status/1972999818126704712,0
2025-10-01 13:02:45+00:00,ravvemclaw,versi cowo coba min,0,0,0,23,https://x.com/ravvemclaw/status/1973373017368789073,https://x.com/IndoPopBase/status/1972999818126704712,0
2025-10-01 11:19:57+00:00,arieelfa,What my ages again?,0,0,0,49,https://x.com/arieelfa/status/1973347147241377899,https://x.com/IndoPopBase/status/1972999818126704712,0
2025-09-30 13:36:15+00:00,Cpurple83,Reza artamevia bknnya - pertama yg awal dulu bikin dia booming?,1,0,0,313,https://x.com/Cpurple83/status/1973019061660578158,https://x.com/IndoPopBase/status/1972999818126704712,1
2025-10-01 02:46:07+00:00,updatesjekeyti,"JKT48, 12 (Nabilah) — Heavy Rotation",0,0,0,178,https://x.com/updatesjekeyti/status/1973217838287745183,https://x.com/IndoPopBase/status/1972999818126704712,0
2025-09-30 16:08:06+00:00,mengudarabebas,"Gua kalo denger bahasa kalbu langsung kebayang mulai sinetron  wajah pemain cowo nya inget nama artis & nama judul gak tau!!

Seinget gua mulai diatas jam 8 tuh aura nya udah ngantuk kalo mulai lagu itu  2002 apa 2003 gitu kalo gak salah yaa??!!",1,0,0,186,https://x.com/mengudarabebas/status/1973057272356962377,https://x.com/IndoPopBase/status/1972999818126704712,1
2025-09-30 12:57:48+00:00,masreyhaan,"Nike Ardilla, Lyodra, and Sherina start their first hit at the very young ages. Woww

There's still plenty of room for error and to develop themselves",0,0,0,479,https://x.com/masreyhaan/status/1973009382586900674,https://x.com/IndoPopBase/status/1972999818126704712,0
2025-10-01 14:19:11+00:00,Alexx1992xx,"Sorry darling, Agnes Monica achieved success from when she was a child to a teenager",0,0,0,26,https://x.com/Alexx1992xx/status/1973392253226717204,https://x.com/IndoPopBase/status/1972999818126704712,0
2025-09-30 15:21:57+00:00,ur_fave_homeboy,So cita citata at 20 when she was released hits after hits a decade ago ,0,0,0,89,https://x.com/ur_fave_homeboy/status/1973045661580018104,https://x.com/IndoPopBase/status/1972999818126704712,0
2025-10-01 12:05:46+00:00,BaeEvelyn24,1 sneak,0,0,0,25,https://x.com/BaeEvelyn24/status/1973358677232066909,https://x.com/IndoPopBase/status/1972999818126704712,0
2025-09-30 12:35:27+00:00,jackthegon,Wowww cinta laura in her 15?,0,0,0,156,https://x.com/jackthegon/status/1973003758243283305,https://x.com/IndoPopBase/status/1972999818126704712,0
2025-09-30 12:28:27+00:00,Ultractinium,"Denny Caknan, 25 — Kartonyono Medot Janji",0,0,0,344,https://x.com/Ultractinium/status/1973001996300165415,https://x.com/IndoPopBase/status/1972999818126704712,0
2025-09-30 12:40:04+00:00,wilderobot,big day for all indonesian dads that will scream onto the tv in the middle of the night,4,0,0,3276,https://x.com/wilderobot/status/1973004919348273228,https://x.com/IndoPopBase/status/1972990103741153523,4
2025-09-30 13:28:00+00:00,ahmadtr__,"Dulu TVRI beli hak siar Liga Inggris dipermasalahin, sampe Pak Helmy Yahya ""dipecat"". Ladang cuan TV swasta",2,1,0,2503,https://x.com/ahmadtr__/status/1973016983143936476,https://x.com/IndoPopBase/status/1972990103741153523,3
2025-09-30 11:43:25+00:00,ayusekaaar,Big L for MNC Group.,0,0,0,3256,https://x.com/ayusekaaar/status/1972990666709090637,https://x.com/IndoPopBase/status/1972990103741153523,0
2025-09-30 11:53:05+00:00,freqtions,W TVRI,0,0,0,1920,https://x.com/freqtions/status/1972993098419736744,https://x.com/IndoPopBase/status/1972990103741153523,0
2025-09-30 12:37:08+00:00,kucingjantan_07,"Damn! TVRI!?!? Like... The TVRI!?

How TVRI got the money for the World Cup tho!?",2,0,0,3669,https://x.com/kucingjantan_07/status/1973004182102946014,https://x.com/IndoPopBase/status/1972990103741153523,2
2025-09-30 11:58:31+00:00,sporttiaphari,"TVRI kabarnya menayangkan 80 dari 104 laga.

Coba tebak 24 laga sisanya ke mana..
x.com/sporttiaphari/
…",0,0,0,3989,https://x.com/sporttiaphari/status/1972994463061754320,https://x.com/IndoPopBase/status/1972990103741153523,0
2025-09-30 11:45:37+00:00,ursteulyNaveen,Big win for football fans!  The 2026 FIFA World Cup coming to TVRI means everyone gets to enjoy the action live.,0,0,0,2758,https://x.com/ursteulyNaveen/status/1972991218033562045,https://x.com/IndoPopBase/status/1972990103741153523,0
2025-09-30 12:27:37+00:00,Arfianmlna,"Jangan lupa beli jersey timnas ada diskon 10% dari link ini
Link jersey 
s.shopee.co.id/6VEsfk8lkj",0,2,0,982,https://x.com/Arfianmlna/status/1973001789999104057,https://x.com/IndoPopBase/status/1972990103741153523,2
2025-09-30 12:19:30+00:00,·,"TVRI kan bukan TVRI sport?
Kalo TVRI sport nanti bentrok sama bulutangkis aku gak ikhlas ",1,1,0,1285,https://x.com/nami_singkat/status/1972999743447167394,https://x.com/IndoPopBase/status/1972990103741153523,2
2025-10-01 02:27:27+00:00,bsjzju66417,,0,0,0,69,https://x.com/bsjzju66417/status/1973213140348445056,https://x.com/IndoPopBase/status/1972990103741153523,0
2025-09-30 13:11:36+00:00,EvoriaID,Udah mau pildun aja ya ,0,0,0,518,https://x.com/EvoriaID/status/1973012857701994773,https://x.com/IndoPopBase/status/1972990103741153523,0
2025-09-30 13:05:02+00:00,waningccrescent,"Ok laah, kualitas gambarnya TVRI sekarang udah HD banget",0,0,0,452,https://x.com/waningccrescent/status/1973011204563210626,https://x.com/IndoPopBase/status/1972990103741153523,0
2025-09-30 11:56:55+00:00,Prime___TV,,0,0,0,401,https://x.com/Prime___TV/status/1972994063789130090,https://x.com/IndoPopBase/status/1972990103741153523,0
2025-09-30 11:47:23+00:00,Love_3children,Ready to welcome the 2026 World Cup,0,0,0,702,https://x.com/Love_3children/status/1972991664584307110,https://x.com/IndoPopBase/status/1972990103741153523,0
2025-09-30 17:51:27+00:00,bangsamsul_,"mantep sih ini, setidak nya kalo lagi di kantor bisa streaming di tv garden.",0,0,0,294,https://x.com/bangsamsul_/status/1973083284696408381,https://x.com/IndoPopBase/status/1972990103741153523,0
2025-09-30 11:44:19+00:00,admiralkizaruuu,NO MORE EMTEK OR MNC,0,0,0,702,https://x.com/admiralkizaruuu/status/1972990892769493288,https://x.com/IndoPopBase/status/1972990103741153523,0
2025-09-30 12:09:09+00:00,jackthegon,Tvri stunnnn! Nonton indonesia di tvri,0,0,0,289,https://x.com/jackthegon/status/1972997140260737516,https://x.com/IndoPopBase/status/1972990103741153523,0
2025-10-01 04:27:13+00:00,anjiiir7,Ntaps ,0,0,0,40,https://x.com/anjiiir7/status/1973243277278323176,https://x.com/IndoPopBase/status/1972990103741153523,0
2025-09-30 12:23:33+00:00,akhirpekansans,"Jangan lupa beli syal garuda , siapa tau Indonesia masuk piala dunia",0,0,0,214,https://x.com/akhirpekansans/status/1973000765720727899,https://x.com/IndoPopBase/status/1972990103741153523,0
2025-09-30 10:34:15+00:00,sleeplessdewa,Mata langit traumatize me a lot,5,82,0,39484,https://x.com/sleeplessdewa/status/1972973258636181912,https://x.com/IndoPopBase/status/1972968688778392051,87
2025-09-30 11:29:16+00:00,worldofkhaa,"dramatis bgt emg, sebelum gempa ada suara kyk guruh gt dari dlm tanah, abis itu gempa mana lama woi sampai susah buka pintu rumah, pas udh di luar hujan selebat itu, mengungsi dlm keadaan hujan2an",2,8,0,30813,https://x.com/worldofkhaa/status/1972987102922199226,https://x.com/IndoPopBase/status/1972968688778392051,10
2025-09-30 23:18:45+00:00,KeeN93_,Biar inget aja,0,9,0,11047,https://x.com/KeeN93_/status/1973165649309605964,https://x.com/IndoPopBase/status/1972968688778392051,9
2025-09-30 10:38:03+00:00,fizzy_note,"Wait, THAT'S where it's from? Dulu pernah liat video 3gp yg ada lantunan adzan/qur'an-nya, gua kira editan sumpah. ",0,4,0,9268,https://x.com/fizzy_note/status/1972974213821776262,https://x.com/IndoPopBase/status/1972968688778392051,4
2025-09-30 15:38:22+00:00,ltyhc_,inget bgt pas itu untung kita sekampung tuh ada match bola jadi sebagian besar ke lapangan. kalo di inget kebesaran allah kebetulan bgt hari gempa pada kelapangan dan dr itu kampung aku ga ada korban jiwa,1,0,0,6937,https://x.com/ltyhc_/status/1973049791278960776,https://x.com/IndoPopBase/status/1972968688778392051,1
2025-09-30 15:29:28+00:00,ndroe_,"hotel ambacang ambruk korbannya banyak

mereka terjebak di area kolam renang hotel",4,10,0,17325,https://x.com/ndroe_/status/1973047551386636706,https://x.com/IndoPopBase/status/1972968688778392051,14
2025-09-30 12:45:20+00:00,rotiremahan,"Sampe saat ini, gempanya masih nyisain trauma buat warga sumbar, khususnya padang. Selama tinggal di sana, kalau ditanya apa yang bikin trauma, ya umumnya bakalan jawab gempa ini. Sampe aturan ketinggian gedung dibatasi, juga karena gempa ini kalau ngga salah",1,5,0,12049,https://x.com/rotiremahan/status/1973006247361478983,https://x.com/IndoPopBase/status/1972968688778392051,6
2025-09-30 11:47:43+00:00,InaEEWSBMKG,"Today, as part of our continuous commitment to public safety, BMKG is currently developing the prototype of the Indonesia Earthquake Early Warning System (InaEEWS).
Our pilot testing is focused on Jawa Barat, DK Jakarta, Banten, and Lampung. This key initiative is a one-of-a-kind",0,9,0,39691,https://x.com/InaEEWSBMKG/status/1972991746452938773,https://x.com/IndoPopBase/status/1972968688778392051,9
2025-09-30 14:49:09+00:00,ghfrrrr_,this gempa traumatized me as a kid as i can’t go asleep in the night and got so paranoic in the day.,0,4,0,13238,https://x.com/ghfrrrr_/status/1973037404354396540,https://x.com/IndoPopBase/status/1972968688778392051,4
2025-09-30 10:26:51+00:00,PROSPERDEGREAT,It's hard to believe it’s been 16 years already. Padang still carries the weight of that day.,0,0,0,17342,https://x.com/PROSPERDEGREAT/status/1972971396675534921,https://x.com/IndoPopBase/status/1972968688778392051,0
2025-10-01 04:11:15+00:00,escoklatungu,"I was there, and the trauma was still here. Apa lg kalo lg pulang ke padang, jd kyk gelisah tp mau gamau pasti bakal balik lg kesana",0,2,0,1114,https://x.com/escoklatungu/status/1973239261156802752,https://x.com/IndoPopBase/status/1972968688778392051,2
2025-09-30 12:52:42+00:00,mat_pii,ahh yess the infamous mata malaikat/langit,0,0,0,4116,https://x.com/mat_pii/status/1973008099134119968,https://x.com/IndoPopBase/status/1972968688778392051,0
2025-09-30 14:46:10+00:00,satepadangnew,masih teringat jelas kala itu disore itu kejadian yang mengguncangkan dan menjadikan sensitif terhadap goyangan :(,0,0,0,1526,https://x.com/satepadangnew/status/1973036656518484283,https://x.com/IndoPopBase/status/1972968688778392051,0
2025-09-30 15:14:38+00:00,x_reynaldi,"Udah 16 tahun aja ya, jadi keinget gw dan keluarga lari larian dari tugu api simpang haru ke lubeg",0,0,0,2205,https://x.com/x_reynaldi/status/1973043820297351169,https://x.com/IndoPopBase/status/1972968688778392051,0
2025-09-30 12:44:24+00:00,ditontwt,dulu liat mata itu bikin takut pas liat langit.,0,0,0,4157,https://x.com/ditontwt/status/1973006011578659129,https://x.com/IndoPopBase/status/1972968688778392051,0
2025-10-01 04:01:43+00:00,thrfndhrkhdr,"Waktu itu masih tinggal di Sumbar, sampe beberapa minggu gamasuk sekolah, dan pasca pemulihan sempet sekolah dihalaman karna bangunan sekolah retak2, sempat tidur dimobil juga karna beberapa gempa susulan..sampe skrg kalau keinget agak trauma",0,0,0,956,https://x.com/thrfndhrkhdr/status/1973236860806898153,https://x.com/IndoPopBase/status/1972968688778392051,0
2025-09-30 23:39:38+00:00,Jouska_she,"Masih ingat lagi makan sate sama adek gua
Siap gempa mana jadi ninja ngehindari tiang listrik yg robok sama angkat sepeda",0,0,0,2120,https://x.com/Jouska_she/status/1973170907544957424,https://x.com/IndoPopBase/status/1972968688778392051,0
2025-09-30 11:44:49+00:00,gniknus,lebih serem ini drpd kursi goyang tbh,0,0,0,2263,https://x.com/gniknus/status/1972991017327751337,https://x.com/IndoPopBase/status/1972968688778392051,0
2025-09-30 11:37:13+00:00,Yoursweetsugarr,Itu yg mata emang beneran kah? Berkali² tiap liat fotonya emang serem si gimana liat langsung,0,0,0,2702,https://x.com/Yoursweetsugarr/status/1972989105471647861,https://x.com/IndoPopBase/status/1972968688778392051,0
2025-09-30 10:19:09+00:00,Chrollo_lcfr,Ada mata malaikat coyyyy,0,0,0,3559,https://x.com/Chrollo_lcfr/status/1972969459523736004,https://x.com/IndoPopBase/status/1972968688778392051,0
2025-09-30 14:38:06+00:00,xxsyhdxn,anjir masih merinding liat ini wkwkwk,0,0,0,829,https://x.com/xxsyhdxn/status/1973034623249813714,https://x.com/IndoPopBase/status/1972968688778392051,0
2025-09-30 14:05:45+00:00,seralaayo,Moga aman aman aja sekarang sampe nanti,0,0,0,1431,https://x.com/seralaayo/status/1973026485469593650,https://x.com/IndoPopBase/status/1972968688778392051,0
2025-09-30 11:47:06+00:00,rifaldiaye,Bangsat lah. Gara gara ini gua jadi takut keluar rumah wkwkwk,0,0,0,3232,https://x.com/rifaldiaye/status/1972991589808324901,https://x.com/IndoPopBase/status/1972968688778392051,0
2025-09-30 13:52:19+00:00,IkmahFauzan,Masih terasa pedihnya sampai skrg,0,0,0,6488,https://x.com/IkmahFauzan/status/1973023105087107523,https://x.com/IndoPopBase/status/1972968688778392051,0
2025-09-30 10:34:39+00:00,_BudionoSiregar,video legend,0,0,0,1890,https://x.com/_BudionoSiregar/status/1972973359509164276,https://x.com/IndoPopBase/status/1972968688778392051,0
2025-09-30 14:54:00+00:00,juIianzzz11,sampai sekarang masih trauma aku bang,0,0,0,5376,https://x.com/juIianzzz11/status/1973038627291799926,https://x.com/IndoPopBase/status/1972968688778392051,0
2025-09-30 13:54:14+00:00,cnns26,ini dulu creepy bgt anjir,0,0,0,848,https://x.com/cnns26/status/1973023586966532127,https://x.com/IndoPopBase/status/1972968688778392051,0
2025-09-30 11:42:25+00:00,jackalevm,Waduh jaman² warnet hahaha,0,0,0,10841,https://x.com/jackalevm/status/1972990411024327114,https://x.com/IndoPopBase/status/1972968688778392051,0
2025-09-30 13:51:36+00:00,holayinn,Nggak bisa lupa itu gambar mata ,0,0,0,355,https://x.com/holayinn/status/1973022921980625096,https://x.com/IndoPopBase/status/1972968688778392051,0
2025-09-30 14:44:38+00:00,is_pelssy,Semoga tetap aman Indonesiaku,0,0,0,6573,https://x.com/is_pelssy/status/1973036268645953583,https://x.com/IndoPopBase/status/1972968688778392051,0
2025-10-02 10:48:45+00:00,abittermeringue,This 40second earthquake truly traumatized me despite im living 60km away from the centre. Satu bulan setelah gempa ambulans ga berhenti2 lewat kotaku. Sampai skrg masih trauma denger suara ambulans,1,0,0,203,https://x.com/abittermeringue/status/1973701684733096341,https://x.com/IndoPopBase/status/1972968688778392051,1
2025-09-30 16:28:43+00:00,KFarrel59751,trauma anjir gw sampe skrng ga nyaman liat tu mata langit,0,0,0,1800,https://x.com/KFarrel59751/status/1973062463558922531,https://x.com/IndoPopBase/status/1972968688778392051,0
2025-09-30 22:50:40+00:00,zaqqqqq0,"Waktu kejadian gw lagi di Bukittinggi jenguk Sodara bapak ke RS, eh malah bantuin dia dorong tempat tidurnya keluar, ingat banget tuh kuat banget getaran nya",0,0,0,2532,https://x.com/zaqqqqq0/status/1973158581760565347,https://x.com/IndoPopBase/status/1972968688778392051,0
2025-09-30 15:44:21+00:00,ditrotoarjalan,"16 thn pula gw kirim sms ke mantan ""Za, rumah aman?"" Cuma dijawab sedikit ""alhamdulillah gpp"" ",0,0,0,1288,https://x.com/ditrotoarjalan/status/1973051299248623688,https://x.com/IndoPopBase/status/1972968688778392051,0
2025-09-30 12:52:57+00:00,NRadeshka34297,"masi ada video nya gaa, pengen liattt",0,0,0,1230,https://x.com/NRadeshka34297/status/1973008163910894048,https://x.com/IndoPopBase/status/1972968688778392051,0
2025-09-30 11:34:18+00:00,windaberdelapan,"Kalo diingat, masih ngeri  tp abis gempa rumah ku direnovasi ",0,0,0,3251,https://x.com/windaberdelapan/status/1972988370780553679,https://x.com/IndoPopBase/status/1972968688778392051,0
2025-09-30 17:18:19+00:00,Falahzen,Bisa pas gini ya hari ini juga terjadi gempa besar dibeberapa tempat,0,0,0,1109,https://x.com/Falahzen/status/1973074945249808483,https://x.com/IndoPopBase/status/1972968688778392051,0
2025-09-30 12:01:17+00:00,myworldin_words,"Here's your trauma 
@hafidzerdityo",1,0,0,1702,https://x.com/myworldin_words/status/1972995160113086733,https://x.com/IndoPopBase/status/1972968688778392051,1
2025-09-30 13:00:19+00:00,Edenadle11,"Itu sebenrnya mataku guys, aku emg punya kekuatan melihat dunia dari langit",0,0,0,1335,https://x.com/Edenadle11/status/1973010016971219413,https://x.com/IndoPopBase/status/1972968688778392051,0
2025-09-30 14:06:55+00:00,AkadeMichie,"udah tau kalo emg abis bencana, tp bru tau kalo di Padang wkwk",0,0,0,905,https://x.com/AkadeMichie/status/1973026779645563054,https://x.com/IndoPopBase/status/1972968688778392051,0
2025-10-01 01:03:18+00:00,·,Jing ini bikin gw gamau masuk rumah karena mama nyetel tvnya berita ini semua.,0,0,0,671,https://x.com/myunfjae/status/1973191961055207713,https://x.com/IndoPopBase/status/1972968688778392051,0
2025-10-01 06:49:32+00:00,kkulzone3,"udah 16 tahun berlalu ternyata, tapi memorinya masih terekam jelas di kepala ",0,0,0,303,https://x.com/kkulzone3/status/1973279094608670755,https://x.com/IndoPopBase/status/1972968688778392051,0
2025-10-02 06:20:10+00:00,mauditommy,Most terrifying moment,0,0,0,27,https://x.com/mauditommy/status/1973634092383297651,https://x.com/IndoPopBase/status/1972968688778392051,0
2025-09-30 14:52:30+00:00,_diskuyy,"sore2 banget ini dlu, pohon kelapa pada headbang",0,0,0,4980,https://x.com/_diskuyy/status/1973038249674449265,https://x.com/IndoPopBase/status/1972968688778392051,0
2025-10-01 00:02:52+00:00,rot1gabin,momen dimana menunda mandi sore dan memilih ngaso di teras rumah adalah hal yang sangat tepat....,0,0,0,877,https://x.com/rot1gabin/status/1973176755285639556,https://x.com/IndoPopBase/status/1972968688778392051,0
2025-09-30 11:24:14+00:00,Falahzen,The creepiest 3gp childhood video,0,0,0,1446,https://x.com/Falahzen/status/1972985836502475086,https://x.com/IndoPopBase/status/1972968688778392051,0
2025-09-30 16:01:16+00:00,bodoamamat,Saye masih kicik waktu tu,0,0,0,1512,https://x.com/bodoamamat/status/1973055555804528758,https://x.com/IndoPopBase/status/1972968688778392051,0
2025-10-01 06:43:27+00:00,Asyv96,16 tahun yg lalu itu ternyata 2009,0,0,0,277,https://x.com/Asyv96/status/1973277563909972066,https://x.com/IndoPopBase/status/1972968688778392051,0
2025-09-30 15:48:24+00:00,fleursaltr,sampe sekarang masih trauma,1,0,0,2133,https://x.com/fleursaltr/status/1973052316312883309,https://x.com/IndoPopBase/status/1972968688778392051,1
2025-10-01 01:38:43+00:00,carielaaa,trauma liat pic kedua,0,0,0,360,https://x.com/carielaaa/status/1973200875339522362,https://x.com/IndoPopBase/status/1972968688778392051,0
2025-09-30 06:42:47+00:00,SaddamWeb3,"fyi global sumud flotilla itu konvoi kapal sipil internasional yang bawa bantuan kemanusiaan ke Gaza.

nama sumud artinya keteguhan.
beberapa negara ikut dukung tapi nggak semuanya sampe Gaza",0,11,0,4603,https://x.com/SaddamWeb3/status/1972915007861277025,https://x.com/IndoPopBase/status/1972912494349017434,11
2025-09-30 11:57:35+00:00,mbacip,"Desak pemerintahan kita untuk melindungi WNI yang ikut berlayar bareng GSF
globalsumudflotilla.org/contact-offici
…",1,9,0,591,https://x.com/mbacip/status/1972994229711540540,https://x.com/IndoPopBase/status/1972912494349017434,10
2025-09-30 07:22:41+00:00,Jajang_Saha,Why do people keep using that aigen picture?,1,0,0,972,https://x.com/Jajang_Saha/status/1972925049192751407,https://x.com/IndoPopBase/status/1972912494349017434,1
2025-09-30 23:12:44+00:00,tatchankiss,Indopopbase the left pic is ai generated image pls I expect u to do better,1,0,0,140,https://x.com/tatchankiss/status/1973164137674092569,https://x.com/IndoPopBase/status/1972912494349017434,1
2025-09-30 06:44:52+00:00,ursteulyNaveen,Prayers for a safe journey  this mission could mean so much for the people in Gaza.,0,0,0,900,https://x.com/ursteulyNaveen/status/1972915531029328043,https://x.com/IndoPopBase/status/1972912494349017434,0
2025-09-30 07:52:06+00:00,narya_agnynusa,Gambar kiri tuh hasil AI jangan dipake min,0,0,0,608,https://x.com/narya_agnynusa/status/1972932453250777512,https://x.com/IndoPopBase/status/1972912494349017434,0
2025-09-30 07:13:49+00:00,amirariff134,Shalom Israelnesia,4,0,0,472,https://x.com/amirariff134/status/1972922818028519771,https://x.com/IndoPopBase/status/1972912494349017434,4
2025-10-01 12:51:49+00:00,Ahrifkys,ini gw yang salah data apa gimana ya gambar ini? Serius ini Indonesia cuma ngirim 1? Malaysia aja 27 delegasi,0,0,0,72,https://x.com/Ahrifkys/status/1973370264756035684,https://x.com/IndoPopBase/status/1972912494349017434,0
2025-09-30 06:34:29+00:00,EVM0x_nads,hati hati dan selamat sampai tujuan,0,0,0,735,https://x.com/EVM0x_nads/status/1972912917046788407,https://x.com/IndoPopBase/status/1972912494349017434,0
2025-09-30 09:27:27+00:00,PROSPERDEGREAT,Two days out curious to see if they actually make it through without being blocked.,0,0,0,735,https://x.com/PROSPERDEGREAT/status/1972956446896816539,https://x.com/IndoPopBase/status/1972912494349017434,0
2025-09-30 07:17:32+00:00,jackalevm,Mereka bawa apa aja ya? Banyakan kapal kecil gitu ya,1,0,0,1212,https://x.com/jackalevm/status/1972923751756124671,https://x.com/IndoPopBase/status/1972912494349017434,1
2025-09-30 07:30:30+00:00,deepublishstore,Semogaaaa senantiasa diberi perlindungannn ,1,0,0,427,https://x.com/deepublishstore/status/1972927015436329412,https://x.com/IndoPopBase/status/1972912494349017434,1
2025-09-30 09:37:15+00:00,sorryworld_u,"Gak ya, dua hari lagi, baru mau masuk Zona merah.",0,0,0,224,https://x.com/sorryworld_u/status/1972958913193763137,https://x.com/IndoPopBase/status/1972912494349017434,0
2025-10-01 02:55:24+00:00,JavaJimmyMaukar,jika kapal itu tenggelam maka kita harus jatuhkan bom rudal rudal ke Tel Aviv,0,0,0,47,https://x.com/JavaJimmyMaukar/status/1973220172443033630,https://x.com/IndoPopBase/status/1972912494349017434,0
2025-09-30 09:53:17+00:00,Boyvulations,is that AI?,0,0,0,153,https://x.com/Boyvulations/status/1972962948961444296,https://x.com/IndoPopBase/status/1972912494349017434,0
2025-09-30 06:34:08+00:00,Seung_ha_,"What is the Global Sumud Flotilla’s mission as it approaches Gaza?
@grok",0,0,0,946,https://x.com/Seung_ha_/status/1972912829188694016,https://x.com/IndoPopBase/status/1972912494349017434,0
2025-09-30 10:16:11+00:00,FstrongW,"Dr kmrn2 pantau ini, Alhamdulillah Turkey ikut kawal jg akhirny, selain Italy and Spain. 

Pemerintah Italy malah paling dluan krim kapal buat guard 

Klo perihal sumud flotilla lewat d beranda kalian, trtma dr luar, bantu like aja, biar mrk tau, dunia ttap concern perihal ini.",0,0,0,203,https://x.com/FstrongW/status/1972968709875728634,https://x.com/IndoPopBase/status/1972912494349017434,0
2025-09-30 07:02:00+00:00,Love_3children,"""May the Global Sumud Flotilla humanitarian mission arrive safely in Gaza and bring hope and aid to those in need. Stay strong and safe on your journey! #SumudFlotilla #GazaSolidarity""",0,0,0,388,https://x.com/Love_3children/status/1972919843231068348,https://x.com/IndoPopBase/status/1972912494349017434,0
2025-09-30 08:43:42+00:00,SS1574597214037,Mereka akan sampai di Gaza dalam waktu 5 menit lagi. ,0,0,0,100,https://x.com/SS1574597214037/status/1972945436152660110,https://x.com/IndoPopBase/status/1972912494349017434,0
2025-09-30 06:41:50+00:00,FeranRepom,"Sebagai pelaut, saya akan bilang perwira jaga dan AB jaga tetap pantau sekeliling.. utamakan safety first",0,0,0,283,https://x.com/FeranRepom/status/1972914769624768615,https://x.com/IndoPopBase/status/1972912494349017434,0
2025-09-30 06:41:03+00:00,FeranRepom,Semoga selamat sampai tujuan,0,0,0,304,https://x.com/FeranRepom/status/1972914573209682287,https://x.com/IndoPopBase/status/1972912494349017434,0
2025-09-30 04:59:12+00:00,sampurno999,Dia kalo masih ada pasti bisa bikin adem masalah royalti lagu,0,1,0,619,https://x.com/sampurno999/status/1972888938865103209,https://x.com/IndoPopBase/status/1972885431755899333,1
2025-09-30 04:52:25+00:00,firzafp,"G.F.D.L. (Glenn Fredly . Glenn Fredly Devano Latuihamallo . G.F.D. Latuihamallo)

1975-2020

Sebuah merek dagang resmi ""Era Musik Indonesia Generasi Baru [21 Mei 1998 hingga 31 Desember 2005]""

Menyukseskan Bubung Utha, Bubung Harvey, Bubung Marantika, dkk.....",0,0,0,467,https://x.com/firzafp/status/1972887234543333490,https://x.com/IndoPopBase/status/1972885431755899333,0
2025-09-30 05:18:06+00:00,PROSPERDEGREAT,Still hard to believe we lost him so young. Which of his songs hits you the hardest even today,0,0,0,569,https://x.com/PROSPERDEGREAT/status/1972893694945828868,https://x.com/IndoPopBase/status/1972885431755899333,0
2025-09-30 04:55:40+00:00,hawsk13jakut,"Habissss semuaaa uang rakyat, selamat tinggal kisah WNI ku",0,0,0,219,https://x.com/hawsk13jakut/status/1972888049010061432,https://x.com/IndoPopBase/status/1972885431755899333,0
2025-09-30 05:17:41+00:00,PROSPERDEGREAT,50 already? His music still hits harder than most new releases today,0,0,0,585,https://x.com/PROSPERDEGREAT/status/1972893590113423848,https://x.com/IndoPopBase/status/1972885431755899333,0
2025-09-30 04:59:08+00:00,EVM0x_nads,sedih tak berujung ,0,0,0,308,https://x.com/EVM0x_nads/status/1972888923086160172,https://x.com/IndoPopBase/status/1972885431755899333,0
2025-09-30 04:56:14+00:00,·,....dan pas bgt lagi dengerin glen fredlyy huhu,0,0,0,420,https://x.com/buahahahhha/status/1972888193629634725,https://x.com/IndoPopBase/status/1972885431755899333,0
2025-09-30 06:14:09+00:00,alif_akil_1998,Happy heavenly birthday to a legend. ,0,0,0,112,https://x.com/alif_akil_1998/status/1972907800268603597,https://x.com/IndoPopBase/status/1972885431755899333,0
2025-09-30 05:36:22+00:00,abangndaa,"Rindu hasil karyamu, Legend ",0,0,0,165,https://x.com/abangndaa/status/1972898294046298419,https://x.com/IndoPopBase/status/1972885431755899333,0
2025-09-30 04:57:42+00:00,PemudaMaluku___,KING!!,0,0,0,193,https://x.com/PemudaMaluku___/status/1972888562346697159,https://x.com/IndoPopBase/status/1972885431755899333,0
2025-09-30 04:50:39+00:00,asyiqshackshock,Biar cinta hidup s’kali ini saja ,0,0,0,475,https://x.com/asyiqshackshock/status/1972886790584643678,https://x.com/IndoPopBase/status/1972885431755899333,0
2025-09-30 04:53:32+00:00,tebaroktebarok,Tulisnya harus late,0,0,0,375,https://x.com/tebaroktebarok/status/1972887514995376606,https://x.com/IndoPopBase/status/1972885431755899333,0
2025-09-30 05:17:53+00:00,barba_dian,Gone too soon ,0,0,0,190,https://x.com/barba_dian/status/1972893641795617244,https://x.com/IndoPopBase/status/1972885431755899333,0
2025-09-30 05:44:48+00:00,KurniawanRicho,Lah bareng ultah gw ternyata .. ,0,0,0,120,https://x.com/KurniawanRicho/status/1972900414174769416,https://x.com/IndoPopBase/status/1972885431755899333,0
2025-09-30 08:47:49+00:00,zavgia,my goat,0,0,0,100,https://x.com/zavgia/status/1972946474553229719,https://x.com/IndoPopBase/status/1972885431755899333,0
2025-09-30 04:46:30+00:00,ursteulyNaveen,"Happy heavenly 50th to the legend, Glenn Fredly  His music still touches hearts and lives on forever. What’s your favorite Glenn Fredly song? ",0,0,0,710,https://x.com/ursteulyNaveen/status/1972885742084079856,https://x.com/IndoPopBase/status/1972885431755899333,0
2025-09-30 14:44:57+00:00,is_pelssy,RIP Glen,0,0,0,184,https://x.com/is_pelssy/status/1973036347964485724,https://x.com/IndoPopBase/status/1972885431755899333,0
2025-09-30 05:45:30+00:00,hitmealone,"HBD Legend, lagunya masterpiece semua ",0,0,0,286,https://x.com/hitmealone/status/1972900591392502230,https://x.com/IndoPopBase/status/1972885431755899333,0
2025-09-30 05:19:17+00:00,Prime___TV,Happy birthday to him ,0,0,0,78,https://x.com/Prime___TV/status/1972893995211829680,https://x.com/IndoPopBase/status/1972885431755899333,0
2025-09-30 05:00:17+00:00,quigon_ndronkz,"pernah duduk semeja di sebuah angkringan dengan beliau. yg membuat tambah rispek adalah visi misi beliau soal kebudayaan Indonesia, terutama musik dari segala jaman.",0,0,0,130,https://x.com/quigon_ndronkz/status/1972889212967158187,https://x.com/IndoPopBase/status/1972885431755899333,0
2025-09-30 04:50:52+00:00,yuyunmando,Hbd,0,0,0,15,https://x.com/yuyunmando/status/1972886844665938247,https://x.com/IndoPopBase/status/1972885431755899333,0
2025-09-30 04:54:41+00:00,achiavellian,Bruno Mars of Indonesian pop,0,0,0,136,https://x.com/achiavellian/status/1972887804062617751,https://x.com/IndoPopBase/status/1972885431755899333,0
2025-09-30 04:54:54+00:00,achiavellian,GOAT,0,0,0,105,https://x.com/achiavellian/status/1972887856990622048,https://x.com/IndoPopBase/status/1972885431755899333,0
2025-10-09 17:55:26+00:00,barengwarga,"Empat puluh dua hari sejak aksi,
Farhan dan Reno masih hilang.",6,4106,0,120018,https://x.com/barengwarga/status/1976345775572681068,https://x.com/IndoPopBase/status/1972885431755899333,4112
2025-10-09 03:23:14+00:00,perupadata,"Dear Japanese friends, we saw this movie before.",179,5085,0,1043100,https://x.com/perupadata/status/1976126278857261445,https://x.com/IndoPopBase/status/1972885431755899333,5264
2025-10-09 10:14:11+00:00,gotch_akg,,204,9280,0,1118399,https://x.com/gotch_akg/status/1976229699413025143,https://x.com/IndoPopBase/status/1972885431755899333,9484
2025-10-09 01:25:11+00:00,johncusack,Pure evil .,11609,59475,0,10859006,https://x.com/johncusack/status/1976096571382194402,https://x.com/IndoPopBase/status/1972885431755899333,71084
2025-09-30 04:34:43+00:00,kiokio878,Poor them but people also remember how many people Indonesia government killed because they accusing so many civilians as a PKI without concrete evidence. PKI is disgusting but what Indonesia government and military do is nothing different than what PKI do.,5,268,0,36764,https://x.com/kiokio878/status/1972882778669908188,https://x.com/IndoPopBase/status/1972879494454427833,273
2025-09-30 08:19:15+00:00,whoisrifkiii,"kegiatan mengheningkan cipta seharusnya bukan hanya untuk para jenderal yang meninggal di lubang buaya, tapi juga untuk ratusan ribu masyarakat yang dibunuh karena dituduh pki. tak ada yang berhak membunuh atau dibunuh karena ideologi yang ia percaya.",10,294,0,74380,https://x.com/whoisrifkiii/status/1972939284102697153,https://x.com/IndoPopBase/status/1972879494454427833,304
2025-09-30 04:43:25+00:00,andijuliantooo,,1,187,0,31158,https://x.com/andijuliantooo/status/1972884966108516820,https://x.com/IndoPopBase/status/1972879494454427833,188
2025-09-30 06:33:07+00:00,romario_aja,anjay,3,126,0,23511,https://x.com/romario_aja/status/1972912573818519810,https://x.com/IndoPopBase/status/1972879494454427833,129
2025-09-30 04:37:14+00:00,Ramarmdhn__,"Selalu jadi bacaan yg menarik, dari pengalaman (Alm) Prof. Salim Said",11,66,0,32241,https://x.com/Ramarmdhn__/status/1972883410076242062,https://x.com/IndoPopBase/status/1972879494454427833,77
2025-09-30 05:23:33+00:00,nekosalim_,"September s-nya apa? Sebaiknya tidak usah mandi jendral, bapak Presiden sudah menunggu",1,63,0,20801,https://x.com/nekosalim_/status/1972895066919416042,https://x.com/IndoPopBase/status/1972879494454427833,64
2025-09-30 06:56:16+00:00,freddieshoover,"Yang konflik tentara, yang bunuh tentara, yang dibunuh tentara, tapi yang dibantai & dipersekusi ratusan ribu rakyat",0,70,0,13373,https://x.com/freddieshoover/status/1972918401757794440,https://x.com/IndoPopBase/status/1972879494454427833,70
2025-09-30 15:33:25+00:00,Travel_Jepara,Malam ini tadi Gugur Bunga dilantunkan untuk mengenang Affan dan 9 orang lain yang gugur belum lama berselang.,0,0,0,1474,https://x.com/Travel_Jepara/status/1973048545377960340,https://x.com/IndoPopBase/status/1972879494454427833,0
2025-09-30 06:17:57+00:00,Ramarmdhn__,"Pertemuan terakhir Aidit dan Mao Zedong di Beijing, sebulan sebelum terjadinya gestapu. membahas soal kondisi perpolitikan di Indonesia dan kondisi kesehatan BK yg pada saat itu sudah divonis sakit, khawatir yg menggantikanya adalah dari sayap kanan, yaitu Jenderal A.H Nasution.",1,6,0,5831,https://x.com/Ramarmdhn__/status/1972908756301492460,https://x.com/IndoPopBase/status/1972879494454427833,7
2025-09-30 04:51:53+00:00,ernikeginting07,Makin pengen baca bukunya Bu Soe Tjen yang Dari dalam Kubur,1,2,0,5240,https://x.com/ernikeginting07/status/1972887098974998773,https://x.com/IndoPopBase/status/1972879494454427833,3
2025-09-30 06:56:33+00:00,AdhaRiyadhul,Salah satu tragedi yg cukup bersejarah juga,0,4,0,2222,https://x.com/AdhaRiyadhul/status/1972918473702756437,https://x.com/IndoPopBase/status/1972879494454427833,4
2025-09-30 09:03:15+00:00,cangporcang1,"tepatnya 01 Oktober, karena Oktober merupakan bulan sakralnya Komunisme, ingat Revolusi Russia dan China terjadi dibulan Oktober. PKI nyaris mengikuti dua negara besar itu namun kepleset, Soeharto yg dikira ikut mendukung ternyata berbalik Arah.",0,1,0,2730,https://x.com/cangporcang1/status/1972950359057551366,https://x.com/IndoPopBase/status/1972879494454427833,1
2025-09-30 10:19:58+00:00,Ixipizi193564,"Cc : 
@me",1,1,0,888,https://x.com/Ixipizi193564/status/1972969663505244508,https://x.com/IndoPopBase/status/1972879494454427833,2
2025-09-30 07:13:53+00:00,Jamrd_fuzui,,1,3,0,2592,https://x.com/Jamrd_fuzui/status/1972922835854356580,https://x.com/IndoPopBase/status/1972879494454427833,4
2025-09-30 04:26:27+00:00,krimmullet,wake me up when september end,0,0,0,3156,https://x.com/krimmullet/status/1972880696462192786,https://x.com/IndoPopBase/status/1972879494454427833,0
2025-09-30 05:44:32+00:00,sayurebung,Happy Soeharto Supremacy Day ,1,0,0,5231,https://x.com/sayurebung/status/1972900346776457304,https://x.com/IndoPopBase/status/1972879494454427833,1
2025-09-30 05:10:21+00:00,Sandrianisme,Ada peran CIA di lain sisi. Ehehe,0,0,0,5494,https://x.com/Sandrianisme/status/1972891745102057498,https://x.com/IndoPopBase/status/1972879494454427833,0
2025-09-30 06:03:03+00:00,Aqmarichy,Malem Minggu kemarin dah diputer filmnya di tipiwan min,0,0,0,2344,https://x.com/Aqmarichy/status/1972905006941786311,https://x.com/IndoPopBase/status/1972879494454427833,0
2025-09-30 13:22:10+00:00,Chevy_Kalos,PKI yang sesungguhnya,0,1,0,641,https://x.com/Chevy_Kalos/status/1973015515884106132,https://x.com/IndoPopBase/status/1972879494454427833,1
2025-09-30 11:17:15+00:00,livingliwavi,,1,0,0,1791,https://x.com/livingliwavi/status/1972984078480834619,https://x.com/IndoPopBase/status/1972879494454427833,1
2025-09-30 05:16:29+00:00,PROSPERDEGREAT,Looking at these faces on September 30th hits differently. Wonder what stories each of them would tell today,0,0,0,7548,https://x.com/PROSPERDEGREAT/status/1972893287632789510,https://x.com/IndoPopBase/status/1972879494454427833,0
2025-10-01 00:34:12+00:00,jaketkuning_,"Dari 8, yang masih simpang siur akar kematiannya. Jadi entah 500 ribu, entah 2 juta, atau bahkan 3 juta. Termasuk kakek buyut gua yang gak tau apa-apa. Mati pelan-pelan karena disiksa aparat tolol",0,0,0,444,https://x.com/jaketkuning_/status/1973184638131818804,https://x.com/IndoPopBase/status/1972879494454427833,0
2025-09-30 11:15:59+00:00,ASolomonic,"To be honest~ its dawn at 1-3 am of 1st October. And all of them should remembered as ""Victims of Failed Coup"". Five generals, a 1st LT and a kid (of Gen. A. H. Nasution, Ade Irma Suryani Nasution) were just victims. But in Indonesian lore, those Gen + 1 LT are heroes for reason.",0,0,0,1988,https://x.com/ASolomonic/status/1972983761051742347,https://x.com/IndoPopBase/status/1972879494454427833,0
2025-09-30 11:00:07+00:00,meltedheated,Propaganda to paint parjo as heroes ,1,0,0,1361,https://x.com/meltedheated/status/1972979767919182092,https://x.com/IndoPopBase/status/1972879494454427833,1
2025-09-30 04:22:18+00:00,xAvellesch,ah,0,1,0,4813,https://x.com/xAvellesch/status/1972879652659277947,https://x.com/IndoPopBase/status/1972879494454427833,1
2025-09-30 04:33:06+00:00,2029GantiRezim,Celebration of the death of judeo-bolshevik in Indonesia hell yeah,0,0,0,1137,https://x.com/2029GantiRezim/status/1972882373336608901,https://x.com/IndoPopBase/status/1972879494454427833,0
2025-09-30 13:26:27+00:00,InvestigatorMOI,Max Verstappen's birthday,0,0,0,449,https://x.com/InvestigatorMOI/status/1973016591844651019,https://x.com/IndoPopBase/status/1972879494454427833,0
2025-09-30 06:01:01+00:00,SUARAKRISTEN1,"@grok
 , mana lebih bahaya dampaknya PKI atau kepemimpinan soeharto selama 32 tahun di Indonesia?",1,0,0,2057,https://x.com/SUARAKRISTEN1/status/1972904498411737422,https://x.com/IndoPopBase/status/1972879494454427833,1
2025-10-01 09:05:00+00:00,PutraNanda6996,"tragedi masalalu yng trus di tayangkan kehadapn kita, nmun tdk prnah sedikitpun mngambil pelajaran darinya. tntang pengkhianatan mereka sedang menyingkirkan maknanya, yang mereka tahu hari ini adlh membela yg berUang. dan rakyat jelata hanyalah ""remah2 di gerbong politik rusak!",0,0,0,399,https://x.com/PutraNanda6996/status/1973313184246403353,https://x.com/IndoPopBase/status/1972879494454427833,0
2025-09-30 14:37:10+00:00,grotis156,Knock knock  bapak dipanggil untuk menghadap ke bapak Presiden jendral,0,0,0,746,https://x.com/grotis156/status/1973034392340799699,https://x.com/IndoPopBase/status/1972879494454427833,0
2025-09-30 15:24:19+00:00,richgoddessdin,They said those people were corrupt generals just like sutowo gangs,0,0,0,421,https://x.com/richgoddessdin/status/1973046253933219869,https://x.com/IndoPopBase/status/1972879494454427833,0
2025-09-30 16:48:48+00:00,radentegars,"""Coba itu dokternya Aidit tanya (kesehatan Bung Karno) sama kita, belum akan mati itu Bung Karno"" - Mantan Waperdam II Dr. Leimena. Akibat kepanikan Aidit yg mengambil tindakan mendahului sebelum didahului, akibatnya fatal: PKI & Anggotanya hancur lebur & dirinya dibedil tentara.",0,0,0,719,https://x.com/radentegars/status/1973067516730573229,https://x.com/IndoPopBase/status/1972879494454427833,0
2025-09-30 16:21:27+00:00,B_ilbong,"dulu tiap taun wajib nonton filmnya, anak2 sekarang pada tau ga ya kisah beliau2 ini",0,0,0,626,https://x.com/B_ilbong/status/1973060633609290014,https://x.com/IndoPopBase/status/1972879494454427833,0
2025-09-30 05:22:34+00:00,hellowsunx,JAS MERAH ,0,0,0,1328,https://x.com/hellowsunx/status/1972894822114771241,https://x.com/IndoPopBase/status/1972879494454427833,0
2025-09-30 06:07:38+00:00,pmancinghandal,dan lucunya masih ada aja yg peduli sama pki,0,0,0,1193,https://x.com/pmancinghandal/status/1972906160106938396,https://x.com/IndoPopBase/status/1972879494454427833,0
2025-09-30 15:09:23+00:00,tio71092401,"dokumenter yg muncul ketika bangkitnya diktator. penulis mentri dan militer, didanai dan ditayangkan oleh negara.",1,0,0,1094,https://x.com/tio71092401/status/1973042496466018803,https://x.com/IndoPopBase/status/1972879494454427833,1
2025-09-30 04:26:02+00:00,_yoko13,but they're killed in october 1st?,1,0,0,5639,https://x.com/_yoko13/status/1972880591596196267,https://x.com/IndoPopBase/status/1972879494454427833,1
2025-09-30 06:57:12+00:00,marjoramturner,Mari kita bangunkan Green Day,0,0,0,2064,https://x.com/marjoramturner/status/1972918637385388196,https://x.com/IndoPopBase/status/1972879494454427833,0
2025-09-30 23:30:20+00:00,morgenlich666,CIA agent whos create this kudeta,0,0,0,265,https://x.com/morgenlich666/status/1973168566909411597,https://x.com/IndoPopBase/status/1972879494454427833,0
2025-09-30 11:54:06+00:00,notKdash,"Also, my birthday",0,0,0,566,https://x.com/notKdash/status/1972993353898950989,https://x.com/IndoPopBase/status/1972879494454427833,0
2025-09-30 07:29:29+00:00,lPosumA0209,"@pikaso_me
 screenshot this",1,0,0,498,https://x.com/lPosumA0209/status/1972926761827729521,https://x.com/IndoPopBase/status/1972879494454427833,1
2025-09-30 05:32:37+00:00,karufakembala,maaf mau bertanya ujung kanan bawah pahlawan a/n siapa ya ?,2,0,0,9368,https://x.com/karufakembala/status/1972897348306227711,https://x.com/IndoPopBase/status/1972879494454427833,2
2025-09-30 05:37:58+00:00,kochongg,who's that poor kid and what happened to her?,2,0,0,3252,https://x.com/kochongg/status/1972898696716247210,https://x.com/IndoPopBase/status/1972879494454427833,2
2025-09-30 04:32:30+00:00,sugar_6378,Swelamar hari pahlawan,1,0,0,6235,https://x.com/sugar_6378/status/1972882222874304829,https://x.com/IndoPopBase/status/1972879494454427833,1
2025-09-30 04:32:37+00:00,sugar_6378,Selamat,0,0,0,4965,https://x.com/sugar_6378/status/1972882252041486590,https://x.com/IndoPopBase/status/1972879494454427833,0
2025-10-01 00:23:38+00:00,Loveinloveyz,,0,0,0,26,https://x.com/Loveinloveyz/status/1973181980767560169,https://x.com/IndoPopBase/status/1972879494454427833,0
2025-10-02 02:43:46+00:00,Hak2015iim,"Teori yang selalu ditekan: dalang yang membunuh jendral2 dan masyarakat yang dituduh kiri saat kejadian itu adalah sama.
Satu hal yang harus selalu ditanyakan ketika ada peristiwa besar adalah ""siapa yang paling diuntungkan?""",0,0,0,80,https://x.com/Hak2015iim/status/1973579631812084024,https://x.com/IndoPopBase/status/1972879494454427833,0
2025-09-30 05:25:27+00:00,podkeft,Wow ,0,0,0,215,https://x.com/podkeft/status/1972895545854406938,https://x.com/IndoPopBase/status/1972879494454427833,0
2025-09-30 11:08:52+00:00,kamupastitau17,"yang benar itu gestapo (gerakan 1 okotober)

entah kapan berubah dan kenapa jadi S30.

cerita2 dari orang yang mengalami tahun2 itu selalu cerita.",0,0,0,1154,https://x.com/kamupastitau17/status/1972981969756840282,https://x.com/IndoPopBase/status/1972879494454427833,0
2025-10-01 22:16:39+00:00,FebriEdhi,Mereka para pejabat militer dgn gaya hidup yg fantastis di era 60an itu rakyat masih ngenes2 nyaa....wajar jd target kemarahan dan kecumburuan sosial,0,0,0,75,https://x.com/FebriEdhi/status/1973512411954172390,https://x.com/IndoPopBase/status/1972879494454427833,0
2025-09-30 04:29:04+00:00,sinefrom_above,Hasan Nasbi adalah potret kebobrokan sistem di Indonesia. Hanya penjilat nirkompetensi yang bisa jadi pejabat. Ujung2nya yang rugi adalah rakyat,6,204,0,31515,https://x.com/sinefrom_above/status/1972881358142980461,https://x.com/IndoPopBase/status/1972877699422281921,210
2025-09-30 04:35:21+00:00,PHN316,yang gw bingung... kok bisa ya bangga being mentally corrupted kek gini in public..?,9,27,0,32722,https://x.com/PHN316/status/1972882938502283465,https://x.com/IndoPopBase/status/1972877699422281921,36
2025-09-30 04:24:35+00:00,edwardbrgr,"Presidennya aja pelanggar HAM, gimana bawahannya nggak bloon? Bangga banget jadi penjilat, hidup cuma numpang jongkok doang ",1,8,0,8350,https://x.com/edwardbrgr/status/1972880227505414239,https://x.com/IndoPopBase/status/1972877699422281921,9
2025-09-30 05:10:37+00:00,jannahseeker99,"Guys mending kalian mute dan block hasan nasbi, orang kayak dia, ade armando, dll itu tugasnya emang buat jadi pusat perhatian sehingga isu majikannya (mulyono, bowo, gibran beler) teralihkan makanya dia bikin pernyataan kontroversial mulu #nepalkan",2,41,0,8812,https://x.com/jannahseeker99/status/1972891815180394917,https://x.com/IndoPopBase/status/1972877699422281921,43
2025-09-30 10:07:51+00:00,carlando_mcl35,"Fedi nih gak bisa vokal sendirian. Teman² dia yg punya previllege kenapa gak berani kayak dia. Fedi masih dapat projek film meski galak banget ke politikus tai ledig, filmnya gak flop juga dan dia ngasih pandangan kalau goverment harusnya begini begitu",4,21,0,13856,https://x.com/carlando_mcl35/status/1972966615638741008,https://x.com/IndoPopBase/status/1972877699422281921,25
2025-09-30 04:44:18+00:00,merenunglagi,"Selalu seru melihat penjilat2nya. Dlu karena dukung jokowi jdi ngejelekin pak wowo, skrang pak jkwi dan pak wowo sudah merger, jadi pendukungnya jg skrang harus jilat pak wowo pdhal dlu diberakin",3,0,0,16666,https://x.com/merenunglagi/status/1972885190944116919,https://x.com/IndoPopBase/status/1972877699422281921,3
2025-09-30 04:20:41+00:00,orgility,Suka heran kenapa disini yang dapat jabatan orang-orang yang rerata problematik?,10,5,0,11045,https://x.com/orgility/status/1972879247321784748,https://x.com/IndoPopBase/status/1972877699422281921,15
2025-09-30 04:58:06+00:00,Emtiyy,Kayak gini jadi komisirasis... jangan harap pertamina bisa bagus ya,1,0,0,1704,https://x.com/Emtiyy/status/1972888662254981511,https://x.com/IndoPopBase/status/1972877699422281921,1
2025-09-30 06:05:06+00:00,olisykess_,,0,1,0,1534,https://x.com/olisykess_/status/1972905526251164151,https://x.com/IndoPopBase/status/1972877699422281921,1
2025-09-30 04:45:50+00:00,sefa_zulfikar,"Sebagai komisaris kalo lagi meeting pasti ada kata2 penyemangat buat bawahanya, dan dia berkata"" di negara bobrok ini tidak perlu pintar, yg penting bisa menjilat yg sedang berkuasa dijamin posisi kalian aman"".",1,1,0,2054,https://x.com/sefa_zulfikar/status/1972885575272386871,https://x.com/IndoPopBase/status/1972877699422281921,2
2025-09-30 04:15:15+00:00,ursteulyNaveen,Old tweets never die… they just wait for the right drama to resurface ,0,0,0,25423,https://x.com/ursteulyNaveen/status/1972877880922415500,https://x.com/IndoPopBase/status/1972877699422281921,0
2025-09-30 05:00:35+00:00,vicko_twitt,Pejabat jalur buzzer itu ibarat anjing yg akan selalu mengikuti orang yang memberi nya tulang,1,0,0,2832,https://x.com/vicko_twitt/status/1972889289043411260,https://x.com/IndoPopBase/status/1972877699422281921,1
2025-09-30 05:53:47+00:00,Haecarol_,"Baru kali ini liat penjilat bangga bgt ngeklaim dirinya ""oh gw berhasil menjilat pemerintah yg sekarang"" anjir. Gatau malu",0,0,0,485,https://x.com/Haecarol_/status/1972902678197059625,https://x.com/IndoPopBase/status/1972877699422281921,0
2025-09-30 11:03:47+00:00,anusange,"jangan lupakan antriannya
mereka2 yg ga pantes cm dg dipecat",0,1,0,1218,https://x.com/anusange/status/1972980689068081261,https://x.com/IndoPopBase/status/1972877699422281921,1
2025-09-30 04:21:55+00:00,alasgosokan,"Nicki and Barney B fighting, wheres the update sist?",1,0,0,1214,https://x.com/alasgosokan/status/1972879558329426418,https://x.com/IndoPopBase/status/1972877699422281921,1
2025-09-30 08:17:25+00:00,popoktokki,Ada bestie penyepongnya belain klo itu namanya dunia politik seni dalam berpolitik ,1,0,0,1068,https://x.com/popoktokki/status/1972938824960647515,https://x.com/IndoPopBase/status/1972877699422281921,1
2025-09-30 06:12:57+00:00,bukanverdonk,lebih parah dari fufufafa ngatain wowonya ,0,0,0,1117,https://x.com/bukanverdonk/status/1972907501260869918,https://x.com/IndoPopBase/status/1972877699422281921,0
2025-09-30 16:55:31+00:00,pianjuli,"Hati-hati, pak 
@prabowo
, kalau udah ga ada yg bisa dijilat biasanya digigit ",0,0,0,504,https://x.com/pianjuli/status/1973069205156274600,https://x.com/IndoPopBase/status/1972877699422281921,0
2025-09-30 05:05:33+00:00,chann_kunnn,Bisa-bisanya orang begitu ada jabatan dan tinggi pula di perusahaan negara,1,0,0,900,https://x.com/chann_kunnn/status/1972890538140733885,https://x.com/IndoPopBase/status/1972877699422281921,1
2025-09-30 13:10:19+00:00,baaabaron,Kualitas pejabat Indonesia memang patut diacungi kontol ,0,0,0,421,https://x.com/baaabaron/status/1973012532609871907,https://x.com/IndoPopBase/status/1972877699422281921,0
2025-09-30 07:04:40+00:00,AmancioJagau,"Kemarin kepala Babi disuruh masak, sekarang urusan jilat menjilat.",0,0,0,13189,https://x.com/AmancioJagau/status/1972920515670192191,https://x.com/IndoPopBase/status/1972877699422281921,0
2025-09-30 11:01:03+00:00,madleenmavimarm,hasan nasbitch,0,0,0,65,https://x.com/madleenmavimarm/status/1972980004264038660,https://x.com/IndoPopBase/status/1972877699422281921,0
2025-10-01 01:30:27+00:00,RaditoPutr24493,Even a dog wont brag its ability to lick,0,0,0,54,https://x.com/RaditoPutr24493/status/1973198795669373138,https://x.com/IndoPopBase/status/1972877699422281921,0
2025-09-30 04:45:47+00:00,incitates,prambowo aja kena sarkas trump dua kali cik ,1,0,0,4825,https://x.com/incitates/status/1972885563813629954,https://x.com/IndoPopBase/status/1972877699422281921,1
2025-09-30 05:45:35+00:00,MihaelKheel__,"Jadi penjabat nggak perlu kompeten, cukup menjilat pantat rejimm",0,0,0,1393,https://x.com/MihaelKheel__/status/1972900611697086498,https://x.com/IndoPopBase/status/1972877699422281921,0
2025-10-01 03:06:08+00:00,TalkiWong,Penjilat bahasa inggrisnya apa? Licker? ,0,0,0,19,https://x.com/TalkiWong/status/1973222874191368514,https://x.com/IndoPopBase/status/1972877699422281921,0
2025-09-30 06:01:23+00:00,laileave,"Is that you 
@NasbiHasan
 ? ",0,0,0,1658,https://x.com/laileave/status/1972904591114342471,https://x.com/IndoPopBase/status/1972877699422281921,0
2025-10-01 10:36:19+00:00,dewiadwinda,Jejak digital,0,0,0,35,https://x.com/dewiadwinda/status/1973336166322872778,https://x.com/IndoPopBase/status/1972877699422281921,0
2025-09-30 07:34:27+00:00,BVMac,Pertamina sampai kapan di Garong terus. Cape dweh.,0,0,0,135,https://x.com/BVMac/status/1972928010719551815,https://x.com/IndoPopBase/status/1972877699422281921,0
2025-09-30 11:44:15+00:00,alyaRF,Dia ngaku penjilat dan menjabat dr hasil jilatannya. Ga punya malu kok bangga. Tol*l!,0,0,0,367,https://x.com/alyaRF/status/1972990874268418163,https://x.com/IndoPopBase/status/1972877699422281921,0
2025-09-30 04:44:44+00:00,heylday,Istigfar kata gue ya allah Hasan,1,0,0,1263,https://x.com/heylday/status/1972885297705914375,https://x.com/IndoPopBase/status/1972877699422281921,1
2025-09-30 22:21:48+00:00,kikideliveryyy,"tolong jelaskan 
@NasbiHasan",0,0,0,58,https://x.com/kikideliveryyy/status/1973151320598368300,https://x.com/IndoPopBase/status/1972877699422281921,0
2025-10-01 02:52:37+00:00,BukanBuming,Jadi penjilat kok bangga dan terang terangan. Harga dirinya aja minus ini mah,0,0,0,28,https://x.com/BukanBuming/status/1973219472803864734,https://x.com/IndoPopBase/status/1972877699422281921,0
2025-09-30 09:03:33+00:00,aidinku,"Dari postingan ini, kamu memang penjilat, San.",0,0,0,67,https://x.com/aidinku/status/1972950431233196190,https://x.com/IndoPopBase/status/1972877699422281921,0
2025-09-30 06:09:33+00:00,ReinWithYou,ancrit malu bgt liatnya,0,0,0,329,https://x.com/ReinWithYou/status/1972906643714445734,https://x.com/IndoPopBase/status/1972877699422281921,0
2025-09-30 06:45:35+00:00,mindofmorons,HASAN HASBI'S DOWNFALL HERE WE GO,0,0,0,141,https://x.com/mindofmorons/status/1972915712391012507,https://x.com/IndoPopBase/status/1972877699422281921,0
2025-09-30 22:32:17+00:00,kumis_miaw,"@prabowo
 Lihat nih, bobrok!!!!!",0,0,0,55,https://x.com/kumis_miaw/status/1973153958442287132,https://x.com/IndoPopBase/status/1972877699422281921,0
2025-09-30 05:01:45+00:00,An_Kurniawan78,"Jijik banget org ky gini, ewh",1,0,0,815,https://x.com/An_Kurniawan78/status/1972889582623768980,https://x.com/IndoPopBase/status/1972877699422281921,1
2025-09-30 08:53:29+00:00,ogiffology,Anaknya pantes gitu ya,0,0,0,66,https://x.com/ogiffology/status/1972947898704023595,https://x.com/IndoPopBase/status/1972877699422281921,0
2025-09-30 04:53:42+00:00,lanakaminisama, fufufafa.2,1,0,0,404,https://x.com/lanakaminisama/status/1972887556896514140,https://x.com/IndoPopBase/status/1972877699422281921,1
2025-09-30 05:58:01+00:00,hrwnkh,Jejak digital broooooo,0,0,0,877,https://x.com/hrwnkh/status/1972903741495128488,https://x.com/IndoPopBase/status/1972877699422281921,0
2025-09-30 05:08:55+00:00,Dararendah,"11 12 sama yg dijilat 
Jijieekkk",0,0,0,606,https://x.com/Dararendah/status/1972891385809527169,https://x.com/IndoPopBase/status/1972877699422281921,0
2025-09-30 12:19:35+00:00,akmalope,"Tweet hasan nasbi yang tentang prabowo ngewe apa benar 
@grok
 ?",0,0,0,220,https://x.com/akmalope/status/1972999765337247830,https://x.com/IndoPopBase/status/1972877699422281921,0
2025-09-30 06:14:29+00:00,wonderstruck_sh,"shame 
@NasbiHasan",0,0,0,279,https://x.com/wonderstruck_sh/status/1972907885589151983,https://x.com/IndoPopBase/status/1972877699422281921,0
2025-09-30 05:58:23+00:00,tangeirines,Embarassing,0,0,0,251,https://x.com/tangeirines/status/1972903832394043394,https://x.com/IndoPopBase/status/1972877699422281921,0
2025-09-30 06:18:16+00:00,PemudaMaluku___,"Juicy ass beef, lmao.",0,0,0,169,https://x.com/PemudaMaluku___/status/1972908838170038708,https://x.com/IndoPopBase/status/1972877699422281921,0
2025-09-30 06:10:23+00:00,estroile,DISGUSTING,0,0,0,337,https://x.com/estroile/status/1972906855581286699,https://x.com/IndoPopBase/status/1972877699422281921,0
2025-09-30 15:13:14+00:00,fallin4jin,HAH baru tau kalo hasan2 itu dapet jabatan di pertamina… bjir,0,0,0,57,https://x.com/fallin4jin/status/1973043466017083591,https://x.com/IndoPopBase/status/1972877699422281921,0
2025-09-30 05:57:57+00:00,Ijenosasing,,0,0,0,132,https://x.com/Ijenosasing/status/1972903724969574504,https://x.com/IndoPopBase/status/1972877699422281921,0
2025-09-30 12:09:27+00:00,RagnarokSteve,RAJA FEDIIIII SEDANG MEMASAK ,0,0,0,1066,https://x.com/RagnarokSteve/status/1972997214948769820,https://x.com/IndoPopBase/status/1972877699422281921,0
2025-09-29 14:53:47+00:00,nyamukbtina,"Anies look stuning in his new post 

Prabs looks stunting in his new statement about palestine and mbg",7,196,0,30208,https://x.com/nyamukbtina/status/1972676182715023714,https://x.com/IndoPopBase/status/1972674647780212790,203
2025-09-29 18:02:10+00:00,AlexHardy8409,Makin inget nilai 11 teros ,0,30,0,9935,https://x.com/AlexHardy8409/status/1972723594330554784,https://x.com/IndoPopBase/status/1972674647780212790,30
2025-09-29 15:07:53+00:00,7thGloss,Ended that zionist Fraudflopwo Subiassto.,0,43,0,12047,https://x.com/7thGloss/status/1972679731213693273,https://x.com/IndoPopBase/status/1972674647780212790,43
2025-09-29 14:54:28+00:00,dramatugy,flopfraudbowo could never,0,26,0,13048,https://x.com/dramatugy/status/1972676354953941022,https://x.com/IndoPopBase/status/1972674647780212790,26
2025-09-29 15:02:01+00:00,purebahan,ended fraudbowo for me nies,0,28,0,10698,https://x.com/purebahan/status/1972678255221370979,https://x.com/IndoPopBase/status/1972674647780212790,28
2025-09-29 23:04:56+00:00,Chrysalyze,"@netanyahu
 be lyke:

Siapa elu?",7,0,0,11127,https://x.com/Chrysalyze/status/1972799785829867803,https://x.com/IndoPopBase/status/1972674647780212790,7
2025-09-29 18:43:37+00:00,McrMaverick,inget nies negara lo pernah jadi pelaku genosida juga. jadi jangan cuma nyusun kosa kata doang. tindakan riil lah anies koplak,54,5,0,16592,https://x.com/McrMaverick/status/1972734022330794037,https://x.com/IndoPopBase/status/1972674647780212790,59
2025-09-29 20:13:26+00:00,daulisious,"im sorry but… ngapain sih masih ikut2an??  who are you? bacotanmu no value no bargain ga ada tujuan apa2 selain CARI MUKA? disgusting  
@aniesbaswedan",15,1,0,2084,https://x.com/daulisious/status/1972756628232610097,https://x.com/IndoPopBase/status/1972674647780212790,16
2025-09-29 16:27:24+00:00,uyuuuuuuupxz,"nentanyahok : "" Siapa nie bocahhh????""",2,0,0,13975,https://x.com/uyuuuuuuupxz/status/1972699744695996427,https://x.com/IndoPopBase/status/1972674647780212790,2
2025-09-30 02:15:35+00:00,PutRa__K,"Bjir caper  EMG cm modal omon2 ni bapa atu, seruan PBB aja ga didenger, apalagi ini capres gagal, dan udah bnyk yg ngebacot KY gini ga menghentikan ribuan anak2 dan wanita yg d bunuh dipalestina. Shame on you",2,1,0,1798,https://x.com/PutRa__K/status/1972847762686488775,https://x.com/IndoPopBase/status/1972674647780212790,3
2025-09-30 10:10:20+00:00,kullbed,,0,2,0,599,https://x.com/kullbed/status/1972967239499620707,https://x.com/IndoPopBase/status/1972674647780212790,2
2025-09-29 21:24:45+00:00,bang_aim600,"Anies pengen tenar lg!!!!
Anies tukang mancing di air keruh",1,1,0,331,https://x.com/bang_aim600/status/1972774573771997491,https://x.com/IndoPopBase/status/1972674647780212790,2
2025-09-29 22:40:42+00:00,AhmadFa30061519,"Keberpihakan beliau kepada   menjadi salah satu sebab beliau dibenci cebong mulyono seperti 
@_MbakSri_
 @HuluSungai2025
 @kadrunmampos
 @kadrunibli17616",0,0,0,340,https://x.com/AhmadFa30061519/status/1972793688909881523,https://x.com/IndoPopBase/status/1972674647780212790,0
2025-09-30 06:50:09+00:00,marthinsin,"Emang anis ini siapa? Representasi pemerintah, bukan. Organisasi relawan dukung Palestina, bukan juga. Ikut rombongan flotilla, kagak.

Oo maksudnya merubah dunia lewat omon omon ya? Jagonya sih kalo itu",14,2,0,1517,https://x.com/marthinsin/status/1972916861764596085,https://x.com/IndoPopBase/status/1972674647780212790,16
2025-09-29 20:32:46+00:00,h_radite,"Didengar? Ya gak lah. Yg ada dibilang, kowe ki sopoooo?
Jadi Presiden dulu aja pak. Trus bantu perjuangan Palestine dg nyata.",7,1,0,2815,https://x.com/h_radite/status/1972761492220268923,https://x.com/IndoPopBase/status/1972674647780212790,8
2025-09-29 15:41:40+00:00,is_pelssy,Setanyahu the real Nazi,0,2,0,9796,https://x.com/is_pelssy/status/1972688232925057415,https://x.com/IndoPopBase/status/1972674647780212790,2
2025-09-29 18:12:51+00:00,Best_Arek,Dari dl cm omon omon doang apa kabar angin ber KTP,2,1,0,1561,https://x.com/Best_Arek/status/1972726280211878364,https://x.com/IndoPopBase/status/1972674647780212790,3
2025-09-29 15:00:51+00:00,anotherbeennn,ended tankedbowo,0,1,0,998,https://x.com/anotherbeennn/status/1972677961796006318,https://x.com/IndoPopBase/status/1972674647780212790,1
2025-09-29 16:18:30+00:00,Entytaz,"Now imagine that very statement, at the UN.",0,0,0,2801,https://x.com/Entytaz/status/1972697503893279209,https://x.com/IndoPopBase/status/1972674647780212790,0
2025-09-29 15:20:09+00:00,MyfavMeerkat,Louder mr. Anies,0,1,0,4178,https://x.com/MyfavMeerkat/status/1972682818938417353,https://x.com/IndoPopBase/status/1972674647780212790,1
2025-09-29 15:17:35+00:00,kanamewl,ini baru  representasi rakyat,0,2,0,3882,https://x.com/kanamewl/status/1972682174815191185,https://x.com/IndoPopBase/status/1972674647780212790,2
2025-09-29 16:33:07+00:00,AnggiiNat58480,"Min ayo suarakan Pembantaian umat Kristen di nigeria, media indo gada yg spek up",1,0,0,786,https://x.com/AnggiiNat58480/status/1972701181471592860,https://x.com/IndoPopBase/status/1972674647780212790,1
2025-09-29 14:50:43+00:00,SNmasterpiece,Ended fatbowo,0,1,0,1525,https://x.com/SNmasterpiece/status/1972675410468217222,https://x.com/IndoPopBase/status/1972674647780212790,1
2025-09-29 22:02:59+00:00,JigJag444,"Kontra sm Prabowo. 

Saat Prabowo dihujat, dia masuk ambil simpati.

Politician ",0,0,0,268,https://x.com/JigJag444/status/1972784197741039751,https://x.com/IndoPopBase/status/1972674647780212790,0
2025-09-30 10:08:54+00:00,yudiardianns,Cuma zionis laknat  yang ga setuju dengan pernyataan keadilan dari Anies di atas.,0,0,0,305,https://x.com/yudiardianns/status/1972966877032046694,https://x.com/IndoPopBase/status/1972674647780212790,0
2025-09-29 22:56:58+00:00,hendrikk168,Penunggang panggung nongol,0,1,0,156,https://x.com/hendrikk168/status/1972797782118568298,https://x.com/IndoPopBase/status/1972674647780212790,1
2025-09-29 18:13:11+00:00,ARKA6661,"Tolong dong, kalau mau ngelawak, kasi kode biar pembaca paham.

Tuntut me untut nya nanti saja, kalau udh benar benar kepilih jadi SEKJEN PBB ala Dr Tiva.

Saat ini fokus saja dulu cari peluang untuk bisa gabung di pemerintahan yg sekarang.",0,1,0,652,https://x.com/ARKA6661/status/1972726363053592708,https://x.com/IndoPopBase/status/1972674647780212790,1
2025-09-29 22:55:37+00:00,xyzxyzdudu,"Sekarang baru bacot... kemana aja ente...dulu waktu israel gak boleh ikut pildun, support gak?

Bentar lg anak abah mau keluar goa ini...muhahaha",0,1,0,129,https://x.com/xyzxyzdudu/status/1972797440547008531,https://x.com/IndoPopBase/status/1972674647780212790,1
2025-10-01 06:13:20+00:00,BTCdotG,"Ururusin polusi udara ga bisa,patung bambu noh urusin lagi,sok sok an bahas genosida,yaman yaman,dasar gembel.",0,4,0,32,https://x.com/BTCdotG/status/1973269983921942946,https://x.com/IndoPopBase/status/1972674647780212790,4
2025-09-29 15:05:54+00:00,fadhilmusrofi,ended fraudbowo,0,1,0,994,https://x.com/fadhilmusrofi/status/1972679233773412361,https://x.com/IndoPopBase/status/1972674647780212790,1
2025-09-30 05:26:59+00:00,BuitenzorgFiets,"Fuckass buzzers keep saying ""yang penting konflik berakhir""

1. Ini bukan konflik, tapi penjajahan dan genosida
2. Pelaku gak dihukum",0,0,0,478,https://x.com/BuitenzorgFiets/status/1972895933269680149,https://x.com/IndoPopBase/status/1972674647780212790,0
2025-09-29 22:33:05+00:00,stellapelll,Lebih warasan warga sipil nya ketimbang presiden wkwk,0,0,0,353,https://x.com/stellapelll/status/1972791770711982585,https://x.com/IndoPopBase/status/1972674647780212790,0
2025-09-30 14:50:22+00:00,bocahdotco,"Inget gw dulu wkt kampanye dki, jelas2 dia blg stop Reklamasi, pas jadi gubernur jln terus dan tunduk tuh, talk is cheap, mANIES di bibir",0,1,0,130,https://x.com/bocahdotco/status/1973037713571160430,https://x.com/IndoPopBase/status/1972674647780212790,1
2025-09-29 16:12:15+00:00,·,"Ini baru presidenku
Walau kalah pemilihan",0,0,0,892,https://x.com/nami_singkat/status/1972695931482222673,https://x.com/IndoPopBase/status/1972674647780212790,0
2025-09-30 03:01:52+00:00,shoutoutbiatch,END THAT FAT ONE BALLED HOE,0,1,0,120,https://x.com/shoutoutbiatch/status/1972859414240793061,https://x.com/IndoPopBase/status/1972674647780212790,1
2025-09-30 12:45:29+00:00,yudiwibowo976,So... who are you???,1,1,0,82,https://x.com/yudiwibowo976/status/1973006282157412494,https://x.com/IndoPopBase/status/1972674647780212790,2
2025-09-29 22:59:24+00:00,FollowersGirl,"Orang kayak gitu disuruh tanggung jawab nanti jawabannya ""loh, itu bukan saya yg melakukan, tapi pasukan tentara"" mirip2 pemerintah sini klo ngeles pas ada kesalahan",0,1,0,1462,https://x.com/FollowersGirl/status/1972798391488016632,https://x.com/IndoPopBase/status/1972674647780212790,1
2025-09-29 23:54:25+00:00,Chen28394745,Kadrun konohay SDM di bawah 78 kebayakan . Palestine hanya debu . Free Palestine ndasmu . Warga +62 byk miskin melarat kurang nutrisi faktanya byk yg SDM 78,1,0,0,489,https://x.com/Chen28394745/status/1972812237229469753,https://x.com/IndoPopBase/status/1972674647780212790,1
2025-09-29 14:59:05+00:00,allhope_abandon,Gak kebayang tweet ini nyampe tiktok,0,0,0,1150,https://x.com/allhope_abandon/status/1972677519074808126,https://x.com/IndoPopBase/status/1972674647780212790,0
2025-09-30 00:21:35+00:00,ayenhen,Nethanyahok : Lu bapak politik identitas,0,1,0,160,https://x.com/ayenhen/status/1972819077300359260,https://x.com/IndoPopBase/status/1972674647780212790,1
2025-09-30 00:26:04+00:00,kangtholei,Siapa anies...?,0,1,0,136,https://x.com/kangtholei/status/1972820205094236355,https://x.com/IndoPopBase/status/1972674647780212790,1
2025-09-29 23:50:00+00:00,FajriGrahaArtha,"Who's gonna execute that idea? 

Israel & the USA no longer need the UN, as it has become a liability rather than an asset for them. 
They plan to stop funding the UN to gradually paralyze it. Consider this from the perspective of Islamic international geopolitics & history",0,0,0,5507,https://x.com/FajriGrahaArtha/status/1972811129421180942,https://x.com/IndoPopBase/status/1972674647780212790,0
2025-10-01 04:14:50+00:00,derrysapone,"komentarnya rata2 personal wkwk.
ngebela palestina mah dari siapa aja, rangkul semua bukan malah lu siapa lu siapa. 
coba dah otaknya dipake, coba lu bilang free palestine tapi malah dibilang sama temen lu, lu ngapain? lu siapa? ga ngefek. TOLOL",0,0,0,117,https://x.com/derrysapone/status/1973240161896112558,https://x.com/IndoPopBase/status/1972674647780212790,0
2025-09-30 03:20:08+00:00,srape_,Lu ikut nyapres bukan berarti lu jadi sosok penting di kalangan internasional. Emang lau sokap? wkwkwk,0,1,0,147,https://x.com/srape_/status/1972864008308056147,https://x.com/IndoPopBase/status/1972674647780212790,1
2025-09-29 17:31:58+00:00,Marco_Alfa20,Fokus bikin parpol ajaduluuu,0,0,0,7535,https://x.com/Marco_Alfa20/status/1972715991307292716,https://x.com/IndoPopBase/status/1972674647780212790,0
2025-09-30 12:38:55+00:00,yefando3,modal politik identitas bisa apa lu nis,0,1,0,111,https://x.com/yefando3/status/1973004630880907735,https://x.com/IndoPopBase/status/1972674647780212790,1
2025-09-29 15:05:11+00:00,utdstewie,Our president,1,1,0,3726,https://x.com/utdstewie/status/1972679054613778728,https://x.com/IndoPopBase/status/1972674647780212790,2
2025-09-30 11:19:02+00:00,babitermonuklir,buset rame buzzer fraudwowo,0,0,0,80,https://x.com/babitermonuklir/status/1972984526826844445,https://x.com/IndoPopBase/status/1972674647780212790,0
2025-09-30 01:59:44+00:00,0xRuUd1,Pinter banget nyari panggung ,0,1,0,83,https://x.com/0xRuUd1/status/1972843776331944086,https://x.com/IndoPopBase/status/1972674647780212790,1
2025-09-30 13:27:53+00:00,daddodiddo,"Benjamin Netanyahu: ""Anies who?""",1,1,0,192,https://x.com/daddodiddo/status/1973016954727510526,https://x.com/IndoPopBase/status/1972674647780212790,2
2025-09-29 14:42:57+00:00,The_RedsIndo,"LESGOWWW MBA NANA, PROUD!",0,0,0,2370,https://x.com/The_RedsIndo/status/1972673459730719149,https://x.com/IndoPopBase/status/1972672333417431283,0
2025-09-29 14:38:50+00:00,SaddamWeb3,wao kelas mba najwa,0,0,0,520,https://x.com/SaddamWeb3/status/1972672419799122411,https://x.com/IndoPopBase/status/1972672333417431283,0
2025-09-29 15:08:39+00:00,0xpolynesia_,coba tanya ... itu dapet penghargaan gara2 nyumbang duit ke indo sama uji vaksin ya ?,0,0,0,1172,https://x.com/0xpolynesia_/status/1972679927397773369,https://x.com/IndoPopBase/status/1972672333417431283,0
2025-09-29 15:31:33+00:00,hadilocoboy,Gokilll. ga sabar pen denger,1,0,0,155,https://x.com/hadilocoboy/status/1972685690057216082,https://x.com/IndoPopBase/status/1972672333417431283,1
2025-09-29 14:46:48+00:00,·,Ask him why he is in the Epstein's file,0,2,0,3296,https://x.com/aintnowayne/status/1972674428120035706,https://x.com/IndoPopBase/status/1972672333417431283,2
2025-09-29 14:39:59+00:00,Rumahdepok_,"Tolong mba Nana tanyain, ""kemarin pak Prabowo minjem berapa duit Ama bang bill gates""?",0,0,0,1263,https://x.com/Rumahdepok_/status/1972672711764635832,https://x.com/IndoPopBase/status/1972672333417431283,0
2025-09-29 14:42:44+00:00,PROSPERDEGREAT,Najwa is asking Bill Gates questions is going to be must-watch TV. Wonder what unexpected insights he’ll drop this time.,0,0,0,519,https://x.com/PROSPERDEGREAT/status/1972673401761202194,https://x.com/IndoPopBase/status/1972672333417431283,0
2025-09-30 15:32:22+00:00,BetySyaiful,"Wow, kereen.",0,0,0,32,https://x.com/BetySyaiful/status/1973048283556982804,https://x.com/IndoPopBase/status/1972672333417431283,0
2025-09-29 14:45:13+00:00,ahmadtr__,"Coba tanya ""Sudah BEP belum pak?""",0,0,0,1762,https://x.com/ahmadtr__/status/1972674027773673946,https://x.com/IndoPopBase/status/1972672333417431283,0
2025-09-29 16:27:21+00:00,RedCliff256,Semoga ga nothing burger please,1,0,0,133,https://x.com/RedCliff256/status/1972699730259140671,https://x.com/IndoPopBase/status/1972672333417431283,1
2025-09-30 02:16:10+00:00,gilaqlo,Info windows bajakan,0,0,0,111,https://x.com/gilaqlo/status/1972847912918065566,https://x.com/IndoPopBase/status/1972672333417431283,0
2025-09-29 20:38:42+00:00,Getitrights,Hmmm,0,0,0,189,https://x.com/Getitrights/status/1972762983270113357,https://x.com/IndoPopBase/status/1972672333417431283,0
2025-09-29 16:43:58+00:00,EVM0x_nads,kelazzz banget emg mba nana,0,0,0,136,https://x.com/EVM0x_nads/status/1972703913787924778,https://x.com/IndoPopBase/status/1972672333417431283,0
2025-09-29 23:44:04+00:00,karipiw,woww,0,0,0,283,https://x.com/karipiw/status/1972809635943080181,https://x.com/IndoPopBase/status/1972672333417431283,0
2025-09-29 14:40:24+00:00,ursteulyNaveen,That’s a big one  Najwa Shihab sitting down with Bill Gates on Mata Najwa is going to be a must-watch conversation ,0,0,0,343,https://x.com/ursteulyNaveen/status/1972672815787602325,https://x.com/IndoPopBase/status/1972672333417431283,0
2025-09-30 06:24:57+00:00,SumandoGaek,"@MataNajwa
 coba tanyakan soal bisnis vaksin BG dan banyak kejadian KIPI (VAERS) yg banyak terjadi. Dan pertanyaan kunci soal keterlibatan BG di sirkel pedof*l elite Jeffrey Epstein.",1,0,0,179,https://x.com/SumandoGaek/status/1972910519591043108,https://x.com/IndoPopBase/status/1972672333417431283,1
2025-09-29 15:06:39+00:00,kiokio878,She will interviewing ZIONIST pedophile who doing so many horrible thing around the world . Hope she give him real question not sugar coating kind of question,0,0,0,123,https://x.com/kiokio878/status/1972679423733182850,https://x.com/IndoPopBase/status/1972672333417431283,0
2025-09-29 14:46:02+00:00,loeyma2717,wahhhh can't wait ,0,0,0,131,https://x.com/loeyma2717/status/1972674232854487237,https://x.com/IndoPopBase/status/1972672333417431283,0
2025-09-29 14:46:02+00:00,itssrmmm,WAHHHH,0,0,0,152,https://x.com/itssrmmm/status/1972674233072566274,https://x.com/IndoPopBase/status/1972672333417431283,0
2025-09-29 14:50:51+00:00,Love_3children,"Wow, so exciting! Najwa Shihab will be interviewing Bill Gates on Mata Najwa. There will definitely be lots of interesting insights from their conversation. Can't wait! #MataNajwa #BillGates",0,0,0,144,https://x.com/Love_3children/status/1972675444676649015,https://x.com/IndoPopBase/status/1972672333417431283,0
2025-09-29 06:47:45+00:00,SaddamWeb3,wah,0,0,0,2836,https://x.com/SaddamWeb3/status/1972553868958691639,https://x.com/IndoPopBase/status/1972553818585080239,0
2025-09-29 11:27:41+00:00,Somethinc4u,WELL DESERVE,0,0,0,1543,https://x.com/Somethinc4u/status/1972624317323346379,https://x.com/IndoPopBase/status/1972553818585080239,0
2025-09-29 11:58:52+00:00,widiastrie,"well deserved!! such a beautifully written movie, people can definitely see parts of their loved ones in it",0,1,0,1817,https://x.com/widiastrie/status/1972632163708448966,https://x.com/IndoPopBase/status/1972553818585080239,1
2025-09-29 07:44:39+00:00,daramdhn,Bakal tayang lagi ga di netflix? udah puas nonton di bioskop,1,1,0,2489,https://x.com/daramdhn/status/1972568187884765594,https://x.com/IndoPopBase/status/1972553818585080239,2
2025-09-29 07:02:21+00:00,keboydayaan,karena koordinasi buzzer atau karena memang bangsa besar ini segitunya terminally online?,8,2,0,6000,https://x.com/keboydayaan/status/1972557544230158500,https://x.com/IndoPopBase/status/1972553818585080239,10
2025-09-29 07:01:21+00:00,WitheredShulker,ended kkn d-ass-a powndari,0,0,0,1182,https://x.com/WitheredShulker/status/1972557292928450863,https://x.com/IndoPopBase/status/1972553818585080239,0
2025-09-29 06:58:18+00:00,bioplacenton13,Pabrik Gula ender,0,0,0,1137,https://x.com/bioplacenton13/status/1972556523189788685,https://x.com/IndoPopBase/status/1972553818585080239,0
2025-09-29 14:48:21+00:00,kikooott,"Cocok bgt sih mrk berdua beradu akting.
Visualnya juga cakep 22nya, aktingnya pun bagus.
Aku pas nonton sore, hatiku terenyuh ",0,0,0,1252,https://x.com/kikooott/status/1972674817532026908,https://x.com/IndoPopBase/status/1972553818585080239,0
2025-09-29 07:46:35+00:00,PROSPERDEGREAT,"Not surprised, that film sticks with you. Does anyone else think it deserved top 5 instead of #10?",0,0,0,3029,https://x.com/PROSPERDEGREAT/status/1972568673937461754,https://x.com/IndoPopBase/status/1972553818585080239,0
2025-09-29 16:20:47+00:00,EVM0x_nads,congrats film favorit,0,0,0,1534,https://x.com/EVM0x_nads/status/1972698078223462516,https://x.com/IndoPopBase/status/1972553818585080239,0
2025-09-29 07:00:57+00:00,Love_3children,A film that is worth watching and must be on your list,0,0,0,1095,https://x.com/Love_3children/status/1972557190260236625,https://x.com/IndoPopBase/status/1972553818585080239,0
2025-09-29 07:45:37+00:00,PROSPERDEGREAT,Am not surprised. The concept sounds wild. Has anyone actually seen it and can confirm it lives up to the hype?,2,0,0,3676,https://x.com/PROSPERDEGREAT/status/1972568430843937044,https://x.com/IndoPopBase/status/1972553818585080239,2
2025-09-29 09:09:05+00:00,sancicak,masuk bioskop lagi flisssss,0,0,0,740,https://x.com/sancicak/status/1972589439055741066,https://x.com/IndoPopBase/status/1972553818585080239,0
2025-09-29 12:01:56+00:00,rafafadhilaa,deserved.,0,0,0,504,https://x.com/rafafadhilaa/status/1972632935129125161,https://x.com/IndoPopBase/status/1972553818585080239,0
2025-09-30 04:08:31+00:00,chocolococrunch,deserved,0,0,0,81,https://x.com/chocolococrunch/status/1972876185744154864,https://x.com/IndoPopBase/status/1972553818585080239,0
2025-09-30 01:54:53+00:00,sssalmon69,well deserved,0,0,0,155,https://x.com/sssalmon69/status/1972842554413740483,https://x.com/IndoPopBase/status/1972553818585080239,0
2025-09-30 03:27:35+00:00,cathraphine,as it should,0,0,0,98,https://x.com/cathraphine/status/1972865885779185887,https://x.com/IndoPopBase/status/1972553818585080239,0
2025-09-29 18:11:04+00:00,lychcoat,"yes!!! iloveethisfilmsomuch, pls tayangin lg di netflix karna nonton 10x pun gacukup",0,0,0,427,https://x.com/lychcoat/status/1972725832197312614,https://x.com/IndoPopBase/status/1972553818585080239,0
2025-09-29 12:20:13+00:00,HPrasyad,"@grok
 which else on the top 10 list?",1,0,0,1107,https://x.com/HPrasyad/status/1972637536934846570,https://x.com/IndoPopBase/status/1972553818585080239,1
2025-09-29 08:53:27+00:00,idiotsandbeach,what's the #1,0,0,0,709,https://x.com/idiotsandbeach/status/1972585501703205176,https://x.com/IndoPopBase/status/1972553818585080239,0
2025-09-29 11:59:57+00:00,febycahyaa,They deserve it ,0,0,0,631,https://x.com/febycahyaa/status/1972632438242525577,https://x.com/IndoPopBase/status/1972553818585080239,0
2025-09-29 06:51:51+00:00,randussyy,chop,2,1,0,1410,https://x.com/randussyy/status/1972554900149346557,https://x.com/IndoPopBase/status/1972553818585080239,3
2025-10-01 02:42:07+00:00,BluuBluuu155320,Wah jadi penasaran pgn nonton,0,0,0,24,https://x.com/BluuBluuu155320/status/1973216830035730535,https://x.com/IndoPopBase/status/1972553818585080239,0
2025-09-29 07:32:08+00:00,Fourtless1,no 1 KKN,0,0,0,828,https://x.com/Fourtless1/status/1972565039820480561,https://x.com/IndoPopBase/status/1972553818585080239,0
2025-09-29 07:14:43+00:00,dwater129cool,i rate it bcs Sheila,0,0,0,1079,https://x.com/dwater129cool/status/1972560654415606193,https://x.com/IndoPopBase/status/1972553818585080239,0
2025-09-29 07:19:15+00:00,f0rrealzies,ate,0,0,0,1394,https://x.com/f0rrealzies/status/1972561797279522850,https://x.com/IndoPopBase/status/1972553818585080239,0
2025-09-29 06:47:49+00:00,JavaJimmyMaukar,"@sheiladaisha
 WE DID IT",0,0,0,1578,https://x.com/JavaJimmyMaukar/status/1972553886780293529,https://x.com/IndoPopBase/status/1972553818585080239,0
2025-09-30 03:12:44+00:00,emddeeff,Deserved,0,0,0,97,https://x.com/emddeeff/status/1972862146250977472,https://x.com/IndoPopBase/status/1972553818585080239,0
2025-09-29 09:11:53+00:00,Th3Tr4vel3r,congrat ya,0,0,0,2021,https://x.com/Th3Tr4vel3r/status/1972590140192362787,https://x.com/IndoPopBase/status/1972553818585080239,0
2025-09-29 06:16:55+00:00,CISDI_ID,Pengurus program ini tidak boleh main2 statistik angka soalnya  1 Kasus = 1 Korban = 1 nyawa,1,1,0,3910,https://x.com/CISDI_ID/status/1972546108653207793,https://x.com/IndoPopBase/status/1972543528451600508,2
2025-09-29 06:56:41+00:00,SistersInDanger,"Di Jabar sampai 2.945 korban???
Ya Allah, semoga mereka segera sembuh & tidak ada keluhan sakit lanjutan gara-gara keracunan ini ",0,4,0,2151,https://x.com/SistersInDanger/status/1972556119492178060,https://x.com/IndoPopBase/status/1972543528451600508,4
2025-09-29 06:39:18+00:00,SaddamWeb3,more to come ehehe,0,1,0,216,https://x.com/SaddamWeb3/status/1972551744740880780,https://x.com/IndoPopBase/status/1972543528451600508,1
2025-09-29 06:19:32+00:00,dodisegrovee,"Korban CISDI: 2.945
Korban BGN: 989

Yang keracunan bukan cuma perut, tapi juga cara ngitungnya Versi BGN",1,6,0,3659,https://x.com/dodisegrovee/status/1972546767444234701,https://x.com/IndoPopBase/status/1972543528451600508,7
2025-09-29 06:14:22+00:00,·,"Dan si gemoy ttp bilang ""mungkin mereka makannya tdk pake sendok""",0,0,0,1846,https://x.com/whiterosestea/status/1972545470431134182,https://x.com/IndoPopBase/status/1972543528451600508,0
2025-09-29 06:10:18+00:00,sunshinetally4,"JUST STOP THIS MBG SHIT, ITS POISONING INDONESIAN KIDS!!!!

mind you its CASES not the number people who get poisoned by it istg",0,1,0,762,https://x.com/sunshinetally4/status/1972544446668656913,https://x.com/IndoPopBase/status/1972543528451600508,1
2025-09-29 07:53:52+00:00,advocalyps,"Adik gue sempet mual-mual, temennya malah gak sekolah 3 hari tapi gak ada di list tsb",0,0,0,187,https://x.com/advocalyps/status/1972570507175461325,https://x.com/IndoPopBase/status/1972543528451600508,0
2025-09-29 08:20:11+00:00,BearryBlush,west java won the chart omg,0,0,0,156,https://x.com/BearryBlush/status/1972577132351258813,https://x.com/IndoPopBase/status/1972543528451600508,0
2025-09-29 07:20:57+00:00,CakRedi,Stop MBG before it's fatal.,0,0,0,198,https://x.com/CakRedi/status/1972562225924862046,https://x.com/IndoPopBase/status/1972543528451600508,0
2025-09-29 06:23:35+00:00,93mygloss,just make it stop NEOW,0,0,0,268,https://x.com/93mygloss/status/1972547786634883535,https://x.com/IndoPopBase/status/1972543528451600508,0
2025-09-29 06:43:05+00:00,HmsReaper,Allah is punishing infidels or something.,0,0,0,124,https://x.com/HmsReaper/status/1972552696277479449,https://x.com/IndoPopBase/status/1972543528451600508,0
2025-09-29 18:31:52+00:00,achmadimas,"Merata kayak gini yang udah jelas management failure, tapi pendukung gemoy di toktok pasti masih nganggep ini konspirasi untuk menjatuhkan junjungannya yang hatinya gak boleh disakiti sedikitpun itu ",0,0,0,293,https://x.com/achmadimas/status/1972731068257378330,https://x.com/IndoPopBase/status/1972543528451600508,0
2025-09-29 06:18:08+00:00,PROSPERDEGREAT,Are local authorities doing enough to track and prevent MBG poisoning?,0,0,0,587,https://x.com/PROSPERDEGREAT/status/1972546416351572304,https://x.com/IndoPopBase/status/1972543528451600508,0
2025-09-29 06:17:39+00:00,PROSPERDEGREAT,"West Java taking the lead with nearly 3,000 cases is alarming. Are authorities doing enough to prevent MBG poisoning, or is this just the tip of the iceberg?",0,0,0,1016,https://x.com/PROSPERDEGREAT/status/1972546294003703943,https://x.com/IndoPopBase/status/1972543528451600508,0
2025-09-29 16:50:01+00:00,popezcuu,buka jg dong jumlah penerima manfaat berapa gtu?,0,0,0,117,https://x.com/popezcuu/status/1972705436202828228,https://x.com/IndoPopBase/status/1972543528451600508,0
2025-09-29 13:41:09+00:00,amoureuxdumpz,"0,00017%",0,0,0,96,https://x.com/amoureuxdumpz/status/1972657904496021827,https://x.com/IndoPopBase/status/1972543528451600508,0
2025-09-29 20:30:08+00:00,ideradikal,di bangka belitung ada kasus serupa,0,0,0,135,https://x.com/ideradikal/status/1972760829834703350,https://x.com/IndoPopBase/status/1972543528451600508,0
2025-09-29 12:00:36+00:00,ifwebiengreal,gila anjing,0,0,0,111,https://x.com/ifwebiengreal/status/1972632603112144953,https://x.com/IndoPopBase/status/1972543528451600508,0
2025-09-29 09:12:17+00:00,Th3Tr4vel3r,Makanan Beracun Gratis = MBG,0,0,0,233,https://x.com/Th3Tr4vel3r/status/1972590243724578893,https://x.com/IndoPopBase/status/1972543528451600508,0
2025-09-29 05:37:38+00:00,SaddamWeb3,duo legend DKI,0,0,0,251,https://x.com/SaddamWeb3/status/1972536225555947861,https://x.com/IndoPopBase/status/1972527548207870169,0
2025-09-29 05:16:48+00:00,0xpolynesia_,"wah ada bapak nepo ! 
and we are doom sama yg kotak2 ! era di mana buzzer mendominasi hampir memecah belah bangsa",0,0,0,303,https://x.com/0xpolynesia_/status/1972530980792783200,https://x.com/IndoPopBase/status/1972527548207870169,0
2025-09-29 05:09:46+00:00,adriaInsight,semua ini diawali oleh hal ini...,1,1,0,1624,https://x.com/adriaInsight/status/1972529212998508732,https://x.com/IndoPopBase/status/1972527548207870169,2
2025-09-29 05:25:24+00:00,hoomanturtle,Jokowi Ahok is a partner written by a man and Anies Tom is a partner written by a women,3,0,0,1111,https://x.com/hoomanturtle/status/1972533146320335321,https://x.com/IndoPopBase/status/1972527548207870169,3
2025-09-29 05:10:15+00:00,gddxnzjscj,And we fell for the kotak-kotak propaganda.,0,0,0,1324,https://x.com/gddxnzjscj/status/1972529334478057960,https://x.com/IndoPopBase/status/1972527548207870169,0
2025-09-29 05:05:58+00:00,·,this is like when nicki minaj still get along with cardi b.,0,1,0,1095,https://x.com/AngeloCalissto/status/1972528255766089949,https://x.com/IndoPopBase/status/1972527548207870169,1
2025-09-29 07:36:54+00:00,prastayo_aja,Moment epik mereka berdua waktu jd gubernur jakarta ,0,0,0,572,https://x.com/prastayo_aja/status/1972566237566943708,https://x.com/IndoPopBase/status/1972527548207870169,0
2025-09-29 05:16:32+00:00,lavenderswift93,The beginning of our doomsday,0,0,0,528,https://x.com/lavenderswift93/status/1972530914325586396,https://x.com/IndoPopBase/status/1972527548207870169,0
2025-09-29 05:35:04+00:00,arsaputraaa,awal mula,0,0,0,123,https://x.com/arsaputraaa/status/1972535577074630772,https://x.com/IndoPopBase/status/1972527548207870169,0
2025-09-29 05:03:54+00:00,ursteulyNaveen,A milestone moment in Jakarta’s political history  13 years since Jokowi and Ahok’s big win ,0,0,0,217,https://x.com/ursteulyNaveen/status/1972527737203241391,https://x.com/IndoPopBase/status/1972527548207870169,0
2025-09-29 05:16:56+00:00,mincedtofu,2 orang pelik,0,0,0,187,https://x.com/mincedtofu/status/1972531015118930412,https://x.com/IndoPopBase/status/1972527548207870169,0
2025-09-29 05:06:08+00:00,Umakraj98,Congratulations ,0,0,0,184,https://x.com/Umakraj98/status/1972528295091785855,https://x.com/IndoPopBase/status/1972527548207870169,0
2025-09-29 05:04:21+00:00,orgility,Awal mula ,0,0,0,591,https://x.com/orgility/status/1972527847060496878,https://x.com/IndoPopBase/status/1972527548207870169,0
2025-09-29 06:06:10+00:00,MIKESrePLAY,We only know ahok,0,0,0,107,https://x.com/MIKESrePLAY/status/1972543404027605464,https://x.com/IndoPopBase/status/1972527548207870169,0
2025-09-29 13:54:25+00:00,itsronyramdan,Yeah. Unfortunately,0,0,0,66,https://x.com/itsronyramdan/status/1972661243258282182,https://x.com/IndoPopBase/status/1972527548207870169,0
2025-09-29 05:15:05+00:00,yume_kinand,Pecah telor,0,0,0,181,https://x.com/yume_kinand/status/1972530549517598781,https://x.com/IndoPopBase/status/1972527548207870169,0
2025-09-29 05:03:33+00:00,sugar_6378,Katanya ada demo ya kamis ini?,0,0,0,276,https://x.com/sugar_6378/status/1972527646690140421,https://x.com/IndoPopBase/status/1972527548207870169,0
2025-09-29 06:58:34+00:00,mengudarabebas,"2 tokoh yg mampu mengubah peta & wajah politik Indonesia secara evolusi  sangat berpengaruh !

Terlepas dari segala keburukan yg mereka perbuat... anda harus mengakui mereka adalah king maker !!",1,0,0,216,https://x.com/mengudarabebas/status/1972556590449582482,https://x.com/IndoPopBase/status/1972527548207870169,1
2025-09-29 08:40:57+00:00,kutangdedemit,Ketika semua berawal dari,0,0,0,81,https://x.com/kutangdedemit/status/1972582359611658672,https://x.com/IndoPopBase/status/1972527548207870169,0
2025-09-29 06:48:28+00:00,pantatkoala,the real kiamat 2012,1,0,0,606,https://x.com/pantatkoala/status/1972554051935244605,https://x.com/IndoPopBase/status/1972527548207870169,1
2025-09-29 05:09:14+00:00,Azmathura,That was some happy times,0,0,0,249,https://x.com/Azmathura/status/1972529075257549141,https://x.com/IndoPopBase/status/1972527548207870169,0
2025-09-29 06:22:55+00:00,dprfrzni,dark ages,0,0,0,114,https://x.com/dprfrzni/status/1972547620376805733,https://x.com/IndoPopBase/status/1972527548207870169,0
2025-09-29 05:48:56+00:00,lastjulliette,Awal mula kehancuran indo,0,0,0,157,https://x.com/lastjulliette/status/1972539068451041343,https://x.com/IndoPopBase/status/1972527548207870169,0
2025-09-29 06:40:19+00:00,saatiru,Dosa jariyah orang jakarta ke seluruh masyarakat NKRI,0,0,0,161,https://x.com/saatiru/status/1972551998999613487,https://x.com/IndoPopBase/status/1972527548207870169,0
2025-09-29 06:02:54+00:00,KurniawanRicho,Jokowi - Ahok ,0,0,0,105,https://x.com/KurniawanRicho/status/1972542583684665356,https://x.com/IndoPopBase/status/1972527548207870169,0
2025-09-29 07:03:00+00:00,Love_3children,I'd be at a loss for words if I had to tell it all from the beginning. I'm too tired and weary.,0,0,0,96,https://x.com/Love_3children/status/1972557707715719295,https://x.com/IndoPopBase/status/1972527548207870169,0
2025-09-29 05:10:30+00:00,soundbrowken,The beginning of the dark,0,0,0,473,https://x.com/soundbrowken/status/1972529395412910302,https://x.com/IndoPopBase/status/1972527548207870169,0
2025-09-29 06:19:35+00:00,lawoyers,Awal dari segala awal,0,0,0,134,https://x.com/lawoyers/status/1972546783109931073,https://x.com/IndoPopBase/status/1972527548207870169,0
2025-09-29 05:30:29+00:00,f_zh19,The beginning of this country's destruction for the next 100 years.,0,0,0,74,https://x.com/f_zh19/status/1972534423020261883,https://x.com/IndoPopBase/status/1972527548207870169,0
2025-09-29 07:13:52+00:00,ElangxJawa,A debut that left primitive Indon folks dazzled & totally head over heels,0,0,0,41,https://x.com/ElangxJawa/status/1972560443161076189,https://x.com/IndoPopBase/status/1972527548207870169,0
2025-09-29 06:19:39+00:00,jackthegon,The downfall era started here,0,0,0,55,https://x.com/jackthegon/status/1972546797685063776,https://x.com/IndoPopBase/status/1972527548207870169,0
2025-09-29 09:13:22+00:00,Th3Tr4vel3r,They are the beginning of the nation’s division,0,0,0,68,https://x.com/Th3Tr4vel3r/status/1972590517457482108,https://x.com/IndoPopBase/status/1972527548207870169,0
2025-09-28 16:04:27+00:00,optimuswixlaa,"no cap, her name, face, vocals, and her whole attitude will always be an icon to me ",0,0,0,2306,https://x.com/optimuswixlaa/status/1972331580942430326,https://x.com/IndoPopBase/status/1972328287776190805,0
2025-09-28 22:11:18+00:00,·,happy birthday mother,0,1,0,2484,https://x.com/nonawvs/status/1972423899909619909,https://x.com/IndoPopBase/status/1972328287776190805,1
2025-09-28 18:41:32+00:00,fariswiuwiu,banyak bot cenblu sekarang,1,0,0,860,https://x.com/fariswiuwiu/status/1972371110839885830,https://x.com/IndoPopBase/status/1972328287776190805,1
2025-09-29 10:55:55+00:00,koganenohikari,tahun depan gabisa daftar kerja entry level,0,0,0,309,https://x.com/koganenohikari/status/1972616322430509222,https://x.com/IndoPopBase/status/1972328287776190805,0
2025-09-28 15:54:47+00:00,ursteulyNaveen,"Happy 24th birthday to Baila!  Wishing you endless success, joy, and beautiful moments ahead. ",0,0,0,2179,https://x.com/ursteulyNaveen/status/1972329148736815531,https://x.com/IndoPopBase/status/1972328287776190805,0
2025-09-28 17:07:14+00:00,billyiskandar05,,0,0,0,2351,https://x.com/billyiskandar05/status/1972347378121470093,https://x.com/IndoPopBase/status/1972328287776190805,0
2025-09-28 15:52:54+00:00,PROSPERDEGREAT,24 and already making big moves. I'm curious to see where she takes it next,0,0,0,3029,https://x.com/PROSPERDEGREAT/status/1972328673761231242,https://x.com/IndoPopBase/status/1972328287776190805,0
2025-09-28 15:52:28+00:00,PROSPERDEGREAT,It's hard to believe she’s only 24 with how much she’s already done. Bright future ahead,0,0,0,2018,https://x.com/PROSPERDEGREAT/status/1972328565061702029,https://x.com/IndoPopBase/status/1972328287776190805,0
2025-09-28 17:08:26+00:00,rosseaint,MY SHAYLAAAA. HAPPI BIRTHDAY CINTAKUU ,0,0,0,23,https://x.com/rosseaint/status/1972347681810116922,https://x.com/IndoPopBase/status/1972328287776190805,0
2025-09-28 23:31:25+00:00,nonationradio,Happy Bday Baila ,0,0,0,939,https://x.com/nonationradio/status/1972444064936305073,https://x.com/IndoPopBase/status/1972328287776190805,0
2025-09-29 12:26:22+00:00,evertowonder,setiap liat foto orang ini gw kira anya geraldine,0,0,0,334,https://x.com/evertowonder/status/1972639087548043325,https://x.com/IndoPopBase/status/1972328287776190805,0
2025-09-30 12:19:47+00:00,ayambutek,Uh queen ,0,0,0,18,https://x.com/ayambutek/status/1972999815010374029,https://x.com/IndoPopBase/status/1972328287776190805,0
2025-09-29 02:56:46+00:00,balanceshxxt,hbd queen,0,0,0,556,https://x.com/balanceshxxt/status/1972495741110435931,https://x.com/IndoPopBase/status/1972328287776190805,0
2025-09-29 01:30:20+00:00,sopipipipipip,HAPPY BIRTHDAYY MOTHER BAILA ,0,0,0,396,https://x.com/sopipipipipip/status/1972473987482714112,https://x.com/IndoPopBase/status/1972328287776190805,0
2025-09-28 16:35:22+00:00,falleiden,Happy birthday kakak baila,0,0,0,1047,https://x.com/falleiden/status/1972339360931647948,https://x.com/IndoPopBase/status/1972328287776190805,0
2025-09-29 00:33:51+00:00,nawttyourboy,Kyak pda mepet ultahnya member no na,1,0,0,1290,https://x.com/nawttyourboy/status/1972459774001418670,https://x.com/IndoPopBase/status/1972328287776190805,1
2025-09-29 10:44:44+00:00,gatauu_bingung,kirain dia lebih muda dari gue ternyata seumuran,0,0,0,259,https://x.com/gatauu_bingung/status/1972613510334202080,https://x.com/IndoPopBase/status/1972328287776190805,0
2025-09-28 16:02:33+00:00,zzzwitterion,my shayla,0,0,0,824,https://x.com/zzzwitterion/status/1972331101269209096,https://x.com/IndoPopBase/status/1972328287776190805,0
2025-09-29 03:43:51+00:00,consideredlucky,Hbd Bailaaaaaa,0,0,0,468,https://x.com/consideredlucky/status/1972507590497272082,https://x.com/IndoPopBase/status/1972328287776190805,0
2025-09-28 23:24:45+00:00,JavaJimmyMaukar,OUR DIVAAAA,0,0,0,514,https://x.com/JavaJimmyMaukar/status/1972442384475857305,https://x.com/IndoPopBase/status/1972328287776190805,0
2025-09-28 15:55:06+00:00,·,happy birthday baila ,1,0,0,374,https://x.com/msustang/status/1972329225576452578,https://x.com/IndoPopBase/status/1972328287776190805,1
2025-09-29 00:21:14+00:00,thehatredonee,hbd sygkuuu,0,0,0,760,https://x.com/thehatredonee/status/1972456599399936083,https://x.com/IndoPopBase/status/1972328287776190805,0
2025-09-29 09:14:45+00:00,Th3Tr4vel3r,Sukses selalu ya kak,0,0,0,664,https://x.com/Th3Tr4vel3r/status/1972590861574930615,https://x.com/IndoPopBase/status/1972328287776190805,0
2025-09-28 15:56:44+00:00,AmberSaira95910,Hmmmm,0,0,0,610,https://x.com/AmberSaira95910/status/1972329638719606858,https://x.com/IndoPopBase/status/1972328287776190805,0
2025-09-28 17:51:31+00:00,ali_nelson05,"88 rising tolong perbanyak promosi mereka, katseye 1 tahun aja udah populer bngt bngt bngt !!!",4,8,0,11914,https://x.com/ali_nelson05/status/1972358523691651294,https://x.com/IndoPopBase/status/1972326731836194857,12
2025-09-28 16:53:13+00:00,_sichengod_,"Christy cantik bgt ya, cantik yg manis bgt gitu kayak ga bakal bosen liat mukanya. ",0,2,0,8346,https://x.com/_sichengod_/status/1972343853698216119,https://x.com/IndoPopBase/status/1972326731836194857,2
2025-09-29 12:59:36+00:00,ecommurz,,0,0,0,3766,https://x.com/ecommurz/status/1972647448477941921,https://x.com/IndoPopBase/status/1972326731836194857,0
2025-09-29 01:54:50+00:00,kejutam,"elok, ayu, whatever you name it",0,0,0,3289,https://x.com/kejutam/status/1972480154762166515,https://x.com/IndoPopBase/status/1972326731836194857,0
2025-09-28 15:48:24+00:00,negativegateee,where's the stun ? i miss them,0,0,0,4274,https://x.com/negativegateee/status/1972327540888109375,https://x.com/IndoPopBase/status/1972326731836194857,0
2025-09-29 02:17:08+00:00,Kintakun_ID,ohhh they are geulis ,0,0,0,9882,https://x.com/Kintakun_ID/status/1972485767395234105,https://x.com/IndoPopBase/status/1972326731836194857,0
2025-09-29 08:31:43+00:00,happinesornaver,"christy kadang mirip tzuyu, sana, sullyoon. kok bisa yaa mukanya artis jyp bgt",1,0,0,2553,https://x.com/happinesornaver/status/1972580035791147150,https://x.com/IndoPopBase/status/1972326731836194857,1
2025-09-28 16:52:20+00:00,haikarrll85,"""Janjian abis nganter anak ke BIMBA """,0,0,0,1653,https://x.com/haikarrll85/status/1972343630406000775,https://x.com/IndoPopBase/status/1972326731836194857,0
2025-09-29 01:11:36+00:00,beautiaf,"gue Baila, jangan sama.",0,0,0,11866,https://x.com/beautiaf/status/1972469275261882716,https://x.com/IndoPopBase/status/1972326731836194857,0
2025-09-28 18:49:02+00:00,datuyulianto,nona2 ini kian meresahkan eloknya ya,1,0,0,6251,https://x.com/datuyulianto/status/1972372997689446902,https://x.com/IndoPopBase/status/1972326731836194857,1
2025-09-29 04:43:43+00:00,WhateverYeollie,"Christy cantik, baila chenthyl, shaz kalem, Esther goddess",0,0,0,1152,https://x.com/WhateverYeollie/status/1972522653719421025,https://x.com/IndoPopBase/status/1972326731836194857,0
2025-09-28 15:50:48+00:00,tclrockk,"Mereka stunning, aq butuh waktu untuk hafal mukanya RT 
.",0,0,0,4818,https://x.com/tclrockk/status/1972328145996153182,https://x.com/IndoPopBase/status/1972326731836194857,0
2025-09-29 11:59:49+00:00,Skeptysme,Baila bisa gitu ya mukanya effortless beauty,0,0,0,256,https://x.com/Skeptysme/status/1972632405430374721,https://x.com/IndoPopBase/status/1972326731836194857,0
2025-09-30 13:32:46+00:00,pisamggoreng,Padahal kemarin kemarin masih liat titi di rota,0,0,0,76,https://x.com/pisamggoreng/status/1973018183494943036,https://x.com/IndoPopBase/status/1972326731836194857,0
2025-09-30 02:13:06+00:00,f_otherside,izin nikung @devano,0,0,0,86,https://x.com/f_otherside/status/1972847140344037820,https://x.com/IndoPopBase/status/1972326731836194857,0
2025-09-30 08:20:03+00:00,Haoranghaae,christyy cakep bgttt,0,0,0,39,https://x.com/Haoranghaae/status/1972939487551574328,https://x.com/IndoPopBase/status/1972326731836194857,0
2025-09-29 15:07:54+00:00,·,bailaaa,0,0,0,64,https://x.com/twiterniii/status/1972679736984846666,https://x.com/IndoPopBase/status/1972326731836194857,0
2025-09-29 21:53:26+00:00,rizalsimmint,Yg kanan no wa nya brp,1,0,0,149,https://x.com/rizalsimmint/status/1972781791951139314,https://x.com/IndoPopBase/status/1972326731836194857,1
2025-09-30 05:07:58+00:00,christofeljs,mana stun stun nya min ? ,0,0,0,78,https://x.com/christofeljs/status/1972891144645435535,https://x.com/IndoPopBase/status/1972326731836194857,0
2025-09-30 05:42:09+00:00,akunnyanabila,christy cantikk bgt,0,0,0,75,https://x.com/akunnyanabila/status/1972899750799458477,https://x.com/IndoPopBase/status/1972326731836194857,0
2025-09-30 07:11:33+00:00,·,cantik² banget buset,0,0,0,57,https://x.com/MlfnnaaD/status/1972922247032832071,https://x.com/IndoPopBase/status/1972326731836194857,0
2025-09-29 15:08:32+00:00,kijlaf,CANTIK CANTIK BGTT,0,0,0,73,https://x.com/kijlaf/status/1972679895353643315,https://x.com/IndoPopBase/status/1972326731836194857,0
2025-09-29 15:28:37+00:00,whoisheroz,cantik bgt bai,0,0,0,79,https://x.com/whoisheroz/status/1972684952128090123,https://x.com/IndoPopBase/status/1972326731836194857,0
2025-09-29 13:22:51+00:00,cinephileeeee,wow,0,0,0,64,https://x.com/cinephileeeee/status/1972653297925521911,https://x.com/IndoPopBase/status/1972326731836194857,0
2025-09-29 13:34:13+00:00,rosyiposyi,Mamah gue yang sebelah kanan tuh,0,0,0,133,https://x.com/rosyiposyi/status/1972656159208202732,https://x.com/IndoPopBase/status/1972326731836194857,0
2025-09-29 16:24:47+00:00,·,yg depan cantik bgtsjdk,0,0,0,150,https://x.com/jupwiteer/status/1972699086328619179,https://x.com/IndoPopBase/status/1972326731836194857,0
2025-09-30 00:27:07+00:00,1sf3sbs,SO ELOK,0,0,0,55,https://x.com/1sf3sbs/status/1972820470111342762,https://x.com/IndoPopBase/status/1972326731836194857,0
2025-09-29 14:22:00+00:00,dotofdust,elok,0,0,0,40,https://x.com/dotofdust/status/1972668183870878023,https://x.com/IndoPopBase/status/1972326731836194857,0
2025-10-02 10:20:20+00:00,sekar_epku,ini LC di mana?,0,0,0,6,https://x.com/sekar_epku/status/1973694530491929058,https://x.com/IndoPopBase/status/1972326731836194857,0
2025-09-28 16:53:22+00:00,ammarkive,wait caption ATE,0,0,0,515,https://x.com/ammarkive/status/1972343889819508916,https://x.com/IndoPopBase/status/1972326731836194857,0
2025-09-29 09:14:59+00:00,Th3Tr4vel3r,very cute,0,0,0,2209,https://x.com/Th3Tr4vel3r/status/1972590923575115781,https://x.com/IndoPopBase/status/1972326731836194857,0
2025-09-29 06:54:04+00:00,Leonaderune,"""elak elok elak elok
gaada kosakata lain apa??"" says the dumb",0,0,0,29,https://x.com/Leonaderune/status/1972555461200388338,https://x.com/IndoPopBase/status/1972326731836194857,0
2025-09-28 15:34:06+00:00,93mygloss,"thank you, but we still NEED NEW MUSIC SIRRRRRR, it's been YEARS",1,28,0,7952,https://x.com/93mygloss/status/1972323944175956409,https://x.com/IndoPopBase/status/1972320387968200734,29
2025-09-29 13:41:13+00:00,byu_id,cung yang fansnya Tulus ,0,0,0,756,https://x.com/byu_id/status/1972657923034677356,https://x.com/IndoPopBase/status/1972320387968200734,0
2025-09-29 03:17:40+00:00,AlvChrist,Glad to be the part of their behind the scene team!,3,0,0,3038,https://x.com/AlvChrist/status/1972500998930448463,https://x.com/IndoPopBase/status/1972320387968200734,3
2025-09-28 15:46:18+00:00,troublemaekers,Beliau ini kapan menjatuhkan album lagi yes?,0,0,0,3601,https://x.com/troublemaekers/status/1972327012208623946,https://x.com/IndoPopBase/status/1972320387968200734,0
2025-09-28 17:08:45+00:00,zmwklpz1,"not me crying over this mv

TULUS - Remedi (Official Music Video)",1,3,0,6358,https://x.com/zmwklpz1/status/1972347761409634473,https://x.com/IndoPopBase/status/1972320387968200734,4
2025-09-28 15:22:58+00:00,dontolicious_,Finally he released something,0,0,0,3022,https://x.com/dontolicious_/status/1972321140187238839,https://x.com/IndoPopBase/status/1972320387968200734,0
2025-09-28 15:45:27+00:00,Evanescent_03,mau nonton besoo aja laaahh takut nangis malem-malem pas denger lirik Remidi udh bikin nyeess ,0,0,0,3596,https://x.com/Evanescent_03/status/1972326797762232425,https://x.com/IndoPopBase/status/1972320387968200734,0
2025-09-29 05:16:51+00:00,·,"youtube.com/watch?v=Wc2yky
… liat mv nya makin semakin kerasa kosong ",0,1,0,1777,https://x.com/kecoaterbang103/status/1972530994940162123,https://x.com/IndoPopBase/status/1972320387968200734,1
2025-09-28 15:34:01+00:00,amiumiaw,abanggg,0,0,0,645,https://x.com/amiumiaw/status/1972323919765143703,https://x.com/IndoPopBase/status/1972320387968200734,0
2025-09-28 15:22:27+00:00,PROSPERDEGREAT,Man’s celebrating 14 years the right way. Four videos at once are wild.,0,0,0,5169,https://x.com/PROSPERDEGREAT/status/1972321011501768722,https://x.com/IndoPopBase/status/1972320387968200734,0
2025-09-28 15:22:51+00:00,ursteulyNaveen,14 years of timeless music  Tulus celebrates by dropping 4 new music videos from Manusia  a gift straight to the fans’ hearts ,0,0,0,3734,https://x.com/ursteulyNaveen/status/1972321112983060897,https://x.com/IndoPopBase/status/1972320387968200734,0
2025-09-28 15:22:22+00:00,Law_of_manifest,This album going to be amazing,0,0,0,1772,https://x.com/Law_of_manifest/status/1972320990823936249,https://x.com/IndoPopBase/status/1972320387968200734,0
2025-09-28 21:34:11+00:00,pengennpinter,album barunya mana,0,0,0,204,https://x.com/pengennpinter/status/1972414561535017400,https://x.com/IndoPopBase/status/1972320387968200734,0
2025-09-28 17:16:45+00:00,·,Eh jatuh suka ada mv nya ,0,0,0,497,https://x.com/aulialiya_/status/1972349775795401158,https://x.com/IndoPopBase/status/1972320387968200734,0
2025-09-28 22:55:24+00:00,adbluemiing,"Niatnya mau liat mv terbarunya Tulus yang baru diupload, trus baru tau kalo ternyata lagu Interaksi ada mvnya, lagu favoritku  selama ini cuma dengerin yang liriknya doang ",1,0,0,1211,https://x.com/adbluemiing/status/1972435001091531172,https://x.com/IndoPopBase/status/1972320387968200734,1
2025-09-28 16:49:33+00:00,klavierika,Woah rispek,0,0,0,419,https://x.com/klavierika/status/1972342929244197129,https://x.com/IndoPopBase/status/1972320387968200734,0
2025-09-28 15:25:13+00:00,usernamenotfun,Jatuh suka and the ramayana tale ,0,0,0,993,https://x.com/usernamenotfun/status/1972321706699334069,https://x.com/IndoPopBase/status/1972320387968200734,0
2025-09-28 15:21:24+00:00,pivtapearce,is it good?,0,0,0,766,https://x.com/pivtapearce/status/1972320747843666061,https://x.com/IndoPopBase/status/1972320387968200734,0
2025-09-28 15:32:32+00:00,helloseakun,uda tulus,0,0,0,360,https://x.com/helloseakun/status/1972323547612848165,https://x.com/IndoPopBase/status/1972320387968200734,0
2025-09-28 16:09:10+00:00,sucirmdiani,please drop your new album!!!11,0,0,0,785,https://x.com/sucirmdiani/status/1972332765770297819,https://x.com/IndoPopBase/status/1972320387968200734,0
2025-09-28 15:57:01+00:00,vakasyong,a music industry,0,0,0,322,https://x.com/vakasyong/status/1972329709653639209,https://x.com/IndoPopBase/status/1972320387968200734,0
2025-09-28 21:52:56+00:00,riweuhihmaneh,"Sir thank you, but where the new album 
@tulusm",0,0,0,520,https://x.com/riweuhihmaneh/status/1972419276775845997,https://x.com/IndoPopBase/status/1972320387968200734,0
2025-09-28 17:35:17+00:00,·,pelan2 bang tulus ,0,0,0,545,https://x.com/uzkyxo/status/1972354438011748391,https://x.com/IndoPopBase/status/1972320387968200734,0
2025-09-28 23:44:44+00:00,zeroncese,FATHER,0,0,0,184,https://x.com/zeroncese/status/1972447412297109860,https://x.com/IndoPopBase/status/1972320387968200734,0
2025-09-29 03:30:13+00:00,kuacikupad,WOWOWOWWW,0,0,0,115,https://x.com/kuacikupad/status/1972504158218731586,https://x.com/IndoPopBase/status/1972320387968200734,0
2025-09-29 01:33:02+00:00,aukseen,Yah pasti relate lagi nih ,0,0,0,40,https://x.com/aukseen/status/1972474668742500833,https://x.com/IndoPopBase/status/1972320387968200734,0
2025-09-29 09:06:47+00:00,Prime___TV,Well deserved honor ,0,0,0,48,https://x.com/Prime___TV/status/1972588859281281516,https://x.com/IndoPopBase/status/1972320387968200734,0
2025-09-28 15:29:20+00:00,lovedbytrees,OMGGGGGG WAIT,0,0,0,757,https://x.com/lovedbytrees/status/1972322743044784192,https://x.com/IndoPopBase/status/1972320387968200734,0
2025-09-28 17:10:22+00:00,jaeycck,KURANG GAK SIH,0,0,0,299,https://x.com/jaeycck/status/1972348169045651958,https://x.com/IndoPopBase/status/1972320387968200734,0
2025-09-29 00:49:09+00:00,oofygoofyyy,KONSEPNYA GITU YH BAIKKK AKU TONTONN,0,0,0,127,https://x.com/oofygoofyyy/status/1972463626591281193,https://x.com/IndoPopBase/status/1972320387968200734,0
2025-09-29 06:30:36+00:00,hhadeeh,album baru manaaa,0,0,0,128,https://x.com/hhadeeh/status/1972549554404048912,https://x.com/IndoPopBase/status/1972320387968200734,0
2025-09-29 08:28:25+00:00,yhdvn,ttp menunggu album baru!,0,0,0,91,https://x.com/yhdvn/status/1972579202219298896,https://x.com/IndoPopBase/status/1972320387968200734,0
2025-09-29 03:52:16+00:00,bloomaeth,AAAAAA kapan album baruu ,0,0,0,222,https://x.com/bloomaeth/status/1972509706578211216,https://x.com/IndoPopBase/status/1972320387968200734,0
2025-09-29 04:02:06+00:00,finasaadha,Lagu barunya mana,0,0,0,88,https://x.com/finasaadha/status/1972512181943185861,https://x.com/IndoPopBase/status/1972320387968200734,0
2025-09-29 03:44:37+00:00,womenlovinwomn,"i love you, kamu lah satu satunya laki laki yang aku cintai, setelah abang aku",0,0,0,805,https://x.com/womenlovinwomn/status/1972507784693645749,https://x.com/IndoPopBase/status/1972320387968200734,0
2025-09-29 08:01:01+00:00,bbangdeokkiejoa,,0,0,0,62,https://x.com/bbangdeokkiejoa/status/1972572309811765456,https://x.com/IndoPopBase/status/1972320387968200734,0
2025-09-29 04:35:11+00:00,frankoceau,kapaaan album baru …..,0,0,0,135,https://x.com/frankoceau/status/1972520508945244427,https://x.com/IndoPopBase/status/1972320387968200734,0
2025-09-29 06:01:03+00:00,cuacuacia15,Please please soon new album!!,0,0,0,144,https://x.com/cuacuacia15/status/1972542115440971938,https://x.com/IndoPopBase/status/1972320387968200734,0
2025-09-29 08:47:38+00:00,adraniiss,Jatuh Suka akhirnya ,0,0,0,94,https://x.com/adraniiss/status/1972584039501709405,https://x.com/IndoPopBase/status/1972320387968200734,0
2025-09-29 09:54:25+00:00,sidiwidiy,"We still need new music, Sir",0,0,0,86,https://x.com/sidiwidiy/status/1972600846086295562,https://x.com/IndoPopBase/status/1972320387968200734,0
2025-09-29 03:56:52+00:00,rivierrra,bikin lagu kayak adu rayu lagi dong om tulus,0,0,0,322,https://x.com/rivierrra/status/1972510866450039016,https://x.com/IndoPopBase/status/1972320387968200734,0
2025-09-29 12:12:11+00:00,heiyoww,eh jujur nangis liat yang jatuh suka,1,0,0,8,https://x.com/heiyoww/status/1972635517826281828,https://x.com/IndoPopBase/status/1972320387968200734,1
2025-09-28 15:32:57+00:00,bioplacenton13,Afgan ender,0,0,0,312,https://x.com/bioplacenton13/status/1972323653032501266,https://x.com/IndoPopBase/status/1972320387968200734,0
2025-09-29 10:54:40+00:00,rrubrofuscuss,HABIS INI NONTON,0,0,0,48,https://x.com/rrubrofuscuss/status/1972616006343549102,https://x.com/IndoPopBase/status/1972320387968200734,0
2025-09-29 04:47:00+00:00,textraxcv,New album very soon A1,0,0,0,103,https://x.com/textraxcv/status/1972523482891403330,https://x.com/IndoPopBase/status/1972320387968200734,0
2025-09-29 07:23:03+00:00,aihtafff,ih ada jatuh suka..,0,0,0,80,https://x.com/aihtafff/status/1972562753417265287,https://x.com/IndoPopBase/status/1972320387968200734,0
2025-09-29 06:51:40+00:00,astroboboiboy,"@henip_
 idola muuuu",1,0,0,84,https://x.com/astroboboiboy/status/1972554857434452167,https://x.com/IndoPopBase/status/1972320387968200734,1
2025-09-29 05:57:44+00:00,cupang_fish,"Manusia - manusia kuat, itu limbad~",0,1,0,419,https://x.com/cupang_fish/status/1972541281084784861,https://x.com/IndoPopBase/status/1972320387968200734,1
2025-09-29 01:03:05+00:00,citokcit,Sangat terkaget kaget langsung 4biji,0,0,0,436,https://x.com/citokcit/status/1972467130907103329,https://x.com/IndoPopBase/status/1972320387968200734,0
2025-09-29 06:27:22+00:00,penaka_naka,Cinta banget REMEDI ada emvi nya,0,0,0,159,https://x.com/penaka_naka/status/1972548738561540425,https://x.com/IndoPopBase/status/1972320387968200734,0
2025-09-28 15:20:35+00:00,PROSPERDEGREAT,Crazy how that album still feels fresh today. Tulus really set the tone for modern Indonesian pop with that drop.,0,1,0,1142,https://x.com/PROSPERDEGREAT/status/1972320539130904594,https://x.com/IndoPopBase/status/1972320216572105060,1
2025-09-28 15:55:46+00:00,meLmoriess,(+) Mengagumimu dari jauh,2,0,0,1241,https://x.com/meLmoriess/status/1972329393885474986,https://x.com/IndoPopBase/status/1972320216572105060,2
2025-09-28 15:36:20+00:00,amphoterist,Go stream his newest music videos!!!,0,0,0,1184,https://x.com/amphoterist/status/1972324505000485300,https://x.com/IndoPopBase/status/1972320216572105060,0
2025-09-28 15:20:58+00:00,PROSPERDEGREAT,Tulus really set the tone for the next wave of Indonesian pop.,0,0,0,922,https://x.com/PROSPERDEGREAT/status/1972320638959526068,https://x.com/IndoPopBase/status/1972320216572105060,0
2025-09-28 15:23:35+00:00,ursteulyNaveen,14 years since Tulus first blessed us with his debut album  The journey from then till now has been nothing short of iconic.,0,0,0,698,https://x.com/ursteulyNaveen/status/1972321295607214463,https://x.com/IndoPopBase/status/1972320216572105060,0
2025-09-28 16:13:30+00:00,93mygloss,one of the best debut album everrrr,0,0,0,334,https://x.com/93mygloss/status/1972333857740632157,https://x.com/IndoPopBase/status/1972320216572105060,0
2025-09-28 15:19:44+00:00,AnnafiBG,Jirrrr album jaman SMP ,0,0,0,781,https://x.com/AnnafiBG/status/1972320325456281817,https://x.com/IndoPopBase/status/1972320216572105060,0
2025-09-28 15:55:04+00:00,ink__phoric,And remains his best album,0,0,0,312,https://x.com/ink__phoric/status/1972329216709677271,https://x.com/IndoPopBase/status/1972320216572105060,0
2025-09-28 15:56:07+00:00,_BudionoSiregar,Sewindu GOATED,0,0,0,279,https://x.com/_BudionoSiregar/status/1972329484075585540,https://x.com/IndoPopBase/status/1972320216572105060,0
2025-09-28 16:08:42+00:00,wdya_np,And I still listening that songs,0,0,0,293,https://x.com/wdya_np/status/1972332649617477998,https://x.com/IndoPopBase/status/1972320216572105060,0
2025-09-28 15:19:54+00:00,Law_of_manifest,We grown up man,0,0,0,580,https://x.com/Law_of_manifest/status/1972320366703087912,https://x.com/IndoPopBase/status/1972320216572105060,0
2025-09-29 03:52:08+00:00,womenlovinwomn,merdu untukmu.... masterpiece..,0,0,0,108,https://x.com/womenlovinwomn/status/1972509675020243235,https://x.com/IndoPopBase/status/1972320216572105060,0
2025-09-28 15:26:41+00:00,salmannalfrsi,14?!,0,0,0,294,https://x.com/salmannalfrsi/status/1972322074799886566,https://x.com/IndoPopBase/status/1972320216572105060,0
2025-09-29 06:02:15+00:00,distinctv_,"udah 14 tahun tuh Sewindu, udah kelar belom?",1,0,0,183,https://x.com/distinctv_/status/1972542420266152397,https://x.com/IndoPopBase/status/1972320216572105060,1
2025-09-29 14:32:41+00:00,ujanyaa,diorama is the best track! sewindu my personal fav,0,0,0,28,https://x.com/ujanyaa/status/1972670872306475475,https://x.com/IndoPopBase/status/1972320216572105060,0
2025-09-29 03:43:48+00:00,AArul28,makasih buat temen masa kecil yang ngenalin tulus,0,0,0,122,https://x.com/AArul28/status/1972507577088159852,https://x.com/IndoPopBase/status/1972320216572105060,0
2025-09-29 02:05:18+00:00,3usri,Masterpiece ,0,0,0,91,https://x.com/3usri/status/1972482788491440554,https://x.com/IndoPopBase/status/1972320216572105060,0
2025-09-29 01:03:29+00:00,aptwewontshare_,tim sewindu,0,0,0,115,https://x.com/aptwewontshare_/status/1972467231444664824,https://x.com/IndoPopBase/status/1972320216572105060,0
2025-09-28 15:34:39+00:00,itsokayifyoudie,waw sewindu,0,0,0,224,https://x.com/itsokayifyoudie/status/1972324081187049500,https://x.com/IndoPopBase/status/1972320216572105060,0
2025-09-28 15:30:03+00:00,forgottendiplo,14????yearss???,0,0,0,252,https://x.com/forgottendiplo/status/1972322921684369626,https://x.com/IndoPopBase/status/1972320216572105060,0
2025-09-28 11:33:43+00:00,bioplacenton13,The nuguta slavepemerintahna shade,5,14,0,4025,https://x.com/bioplacenton13/status/1972263446273286349,https://x.com/IndoPopBase/status/1972261857890361424,19
2025-09-28 11:38:27+00:00,SaddamWeb3,"sabar nul, ternak mulyono emang barbar",0,0,0,1281,https://x.com/SaddamWeb3/status/1972264637312995577,https://x.com/IndoPopBase/status/1972261857890361424,0
2025-09-28 11:36:45+00:00,B4n6_H4n5,"Inul belum ngebor minyak, 
Dia baru ngebor tempat pertunjukkannya...",4,9,0,6461,https://x.com/B4n6_H4n5/status/1972264211742073036,https://x.com/IndoPopBase/status/1972261857890361424,13
2025-09-28 11:38:40+00:00,kiokio878,Bro she's inul daratista not R*fi Ah**d,0,3,0,2940,https://x.com/kiokio878/status/1972264692698730541,https://x.com/IndoPopBase/status/1972261857890361424,3
2025-09-28 13:46:12+00:00,keringatan,"She only gets the bag pas lagi ngebor on stage, not money laundry-ing on backstage. 

She's not Raphishing A-Money-Laundrahmad",0,1,0,3814,https://x.com/keringatan/status/1972296789765300606,https://x.com/IndoPopBase/status/1972261857890361424,1
2025-09-28 15:46:19+00:00,midnightpulse__,"Why we addressing her instead of Rafi Ahmad yg jelas2 money laundry? Ga usah sibuk nargetin org lain, karena yg jelas depan mata aja ga diapa-apain juga.",0,0,0,2007,https://x.com/midnightpulse__/status/1972327015836795069,https://x.com/IndoPopBase/status/1972261857890361424,0
2025-09-28 13:01:56+00:00,anginmalammmmmm,"mantap, hidup punya prinsip dan punya sikap
ga kayak rapi sama cahyadi",0,2,0,2998,https://x.com/anginmalammmmmm/status/1972285649433874605,https://x.com/IndoPopBase/status/1972261857890361424,2
2025-09-28 13:56:28+00:00,Ramarmdhn__,The Queen of Drilling Dance.,1,1,0,2961,https://x.com/Ramarmdhn__/status/1972299370818388140,https://x.com/IndoPopBase/status/1972261857890361424,2
2025-09-28 11:37:57+00:00,Love_3children,The only ones who know for sure the source of their finances are themselves and their God.,0,0,0,3168,https://x.com/Love_3children/status/1972264513258098969,https://x.com/IndoPopBase/status/1972261857890361424,0
2025-09-28 14:47:12+00:00,rayvenbaby,nuguta flopina and raflop assmad could never be this,0,0,0,1156,https://x.com/rayvenbaby/status/1972312139227689455,https://x.com/IndoPopBase/status/1972261857890361424,0
2025-09-28 11:36:25+00:00,guesswho1333,Bisnis karaoke nya dia masih ga sih?,7,0,0,4971,https://x.com/guesswho1333/status/1972264127956713509,https://x.com/IndoPopBase/status/1972261857890361424,7
2025-09-28 12:02:40+00:00,imlookingfor32,"Iklan dia sama mas ada dimana2, nyadar ga sih mas adam mukanya dimana2",2,0,0,2839,https://x.com/imlookingfor32/status/1972270733775757605,https://x.com/IndoPopBase/status/1972261857890361424,2
2025-09-28 12:44:52+00:00,weyezblod,her bob is fye!,0,0,0,916,https://x.com/weyezblod/status/1972281353271124203,https://x.com/IndoPopBase/status/1972261857890361424,0
2025-09-28 11:50:43+00:00,hearterekl,BUNDA RATU,0,0,0,1435,https://x.com/hearterekl/status/1972267724857540639,https://x.com/IndoPopBase/status/1972261857890361424,0
2025-09-28 15:03:27+00:00,gaeulcyrus,They should address nagita slavepmerintahna and raffi ahMID,0,0,0,523,https://x.com/gaeulcyrus/status/1972316227055046733,https://x.com/IndoPopBase/status/1972261857890361424,0
2025-09-29 06:33:48+00:00,zalicylicacid,oh the rafraud assmad and nuguta slavepemerintahna shade,0,0,0,98,https://x.com/zalicylicacid/status/1972550360486269323,https://x.com/IndoPopBase/status/1972261857890361424,0
2025-09-28 19:49:05+00:00,Awanset85499945,"Yg jelas money laundry itu..
Yg artis uangnya katanya milyaran bahkan triliun, tapi bisnis kuliner ala-ala tenda / food court biasa dan sepi 
Tahukan maksudku..",0,0,0,682,https://x.com/Awanset85499945/status/1972388112136581593,https://x.com/IndoPopBase/status/1972261857890361424,0
2025-09-28 14:42:41+00:00,estelersatu,who's disrespecting my diva????,0,0,0,363,https://x.com/estelersatu/status/1972311002319585773,https://x.com/IndoPopBase/status/1972261857890361424,0
2025-09-28 14:07:45+00:00,baber168,salah satu orang terkenal yg masih waras prinsip hidupnya,0,0,0,573,https://x.com/baber168/status/1972302212492914908,https://x.com/IndoPopBase/status/1972261857890361424,0
2025-09-28 11:28:34+00:00,·,"Kalau semua masalah bisa dicuci pakai goyang ngebor, mungkin iya money laundry. Tapi sayangnya ini cuma honor manggung, bos ",0,0,0,295,https://x.com/akhsayur/status/1972262152833794505,https://x.com/IndoPopBase/status/1972261857890361424,0
2025-09-28 12:15:31+00:00,theanglosaxons,"yess mother, speak your truth",0,0,0,567,https://x.com/theanglosaxons/status/1972273967391293529,https://x.com/IndoPopBase/status/1972261857890361424,0
2025-09-28 14:02:25+00:00,·,"She been doing karaoke business long before everyone started, so we believe in her",0,0,0,611,https://x.com/asibhoney/status/1972300867392209138,https://x.com/IndoPopBase/status/1972261857890361424,0
2025-09-28 12:11:24+00:00,pulankantor,look at that bob tho,0,0,0,1195,https://x.com/pulankantor/status/1972272932991946960,https://x.com/IndoPopBase/status/1972261857890361424,0
2025-09-28 12:07:04+00:00,hardhene,"no one can write her off, even Raja Dangdut Indonesia, Rhoma Irama",0,0,0,1349,https://x.com/hardhene/status/1972271839784411467,https://x.com/IndoPopBase/status/1972261857890361424,0
2025-09-29 08:22:55+00:00,eireine9,Sebelum gembar-gembor money laundry artis kan dia udh tajir dr hasil ngebor blm bisnis2nya,0,0,0,87,https://x.com/eireine9/status/1972577821223768111,https://x.com/IndoPopBase/status/1972261857890361424,0
2025-09-28 22:38:01+00:00,superheronmixx,queen mother,0,0,0,125,https://x.com/superheronmixx/status/1972430623613796460,https://x.com/IndoPopBase/status/1972261857890361424,0
2025-09-29 09:18:58+00:00,cowbalagi,yang mau baca cerita lengkapnya:,0,0,0,11,https://x.com/cowbalagi/status/1972591922893160668,https://x.com/IndoPopBase/status/1972261857890361424,0
2025-09-28 15:30:38+00:00,felixputrinoble,Spill siapa yg kena aliran uang partai & cuci-cuci...,0,0,0,334,https://x.com/felixputrinoble/status/1972323069709660356,https://x.com/IndoPopBase/status/1972261857890361424,0
2025-09-28 13:47:41+00:00,allesdemonde,ya kalau inul cuma nerima fee yg laundering ya bukan inul,0,0,0,665,https://x.com/allesdemonde/status/1972297161502257206,https://x.com/IndoPopBase/status/1972261857890361424,0
2025-09-29 01:41:52+00:00,afucado,mother,0,0,0,92,https://x.com/afucado/status/1972476890654167355,https://x.com/IndoPopBase/status/1972261857890361424,0
2025-09-28 11:27:43+00:00,JavaJimmyMaukar,,0,0,0,1572,https://x.com/JavaJimmyMaukar/status/1972261936210542991,https://x.com/IndoPopBase/status/1972261857890361424,0
2025-09-29 01:03:48+00:00,PicalG,"Ini emang contoh artis yg mulai dari nol, jatuh bangun, berdarah-darah membangun karir dan bisnis.
Mudah-mudahan tetap konsisten",0,0,0,152,https://x.com/PicalG/status/1972467312113643809,https://x.com/IndoPopBase/status/1972261857890361424,0
2025-09-29 11:07:23+00:00,rouvenoir,queen inul,0,0,0,51,https://x.com/rouvenoir/status/1972619210661728340,https://x.com/IndoPopBase/status/1972261857890361424,0
2025-10-08 09:33:42+00:00,JengTk94099,Good life,0,0,0,0,https://x.com/JengTk94099/status/1975857122572173611,https://x.com/IndoPopBase/status/1972261857890361424,0
2025-09-28 11:52:06+00:00,iknowmyfeel,"Penyanyi dangdut paling glamour 
Paling konsisten dari awal karir sampe sekarang ga pernah redup ",0,0,0,535,https://x.com/iknowmyfeel/status/1972268075228803246,https://x.com/IndoPopBase/status/1972261857890361424,0
2025-09-28 11:30:37+00:00,AmberSaira95910,Wow awesome,0,0,0,723,https://x.com/AmberSaira95910/status/1972262665931342165,https://x.com/IndoPopBase/status/1972261857890361424,0
2025-09-28 10:04:47+00:00,majikanpenjabat,termasuk dengan cara maksa sekolah2 yg sebelumnya udah ada program makan sendiri ya?,24,167,0,13614,https://x.com/majikanpenjabat/status/1972241068591899000,https://x.com/IndoPopBase/status/1972237830702366795,191
2025-09-28 09:55:38+00:00,carlosbumn,Why feed them poison when you could invest in education and health?,3,46,0,4533,https://x.com/carlosbumn/status/1972238765633716550,https://x.com/IndoPopBase/status/1972237830702366795,49
2025-09-28 10:15:36+00:00,SaddamWeb3,saya mengucapkan terimakasih atas kepercayaannya ,2,0,0,3903,https://x.com/SaddamWeb3/status/1972243790401597452,https://x.com/IndoPopBase/status/1972237830702366795,2
2025-09-28 09:55:55+00:00,vladsyarif13,"Uang segitu besarnya akan lebih bagus dan bermanfaat jika dipakai untuk membangun dan perbaikan infrastruktur, peningkatan kualitas kesehatan, menggaji Guru dengan layak (jangan ada Guru honorer baik di negeri maupun swasta), dan peningkatan alutista militer.",0,13,0,2943,https://x.com/vladsyarif13/status/1972238835800285621,https://x.com/IndoPopBase/status/1972237830702366795,13
2025-09-28 10:45:05+00:00,janeuphoriarmy,"Makanan bergizi, untuk oligarki. ",0,15,0,3872,https://x.com/janeuphoriarmy/status/1972251207449354552,https://x.com/IndoPopBase/status/1972237830702366795,15
2025-09-28 10:35:16+00:00,yudhabjnugroho,"Seharusnya pengelola dapur MBG ini sebaiknya magang dahulu di dapur Pondok Pesantren. Bagaimana cara memasak, timeline waktu yg pas agar tidak basi, karena apa?

Terkait dengan program Makan Bergizi Gratis (MBG), belakangan ini ramai dibahas. Namun bukan karena keberhasilan",1,12,0,7986,https://x.com/yudhabjnugroho/status/1972248738551976368,https://x.com/IndoPopBase/status/1972237830702366795,13
2025-09-28 10:05:13+00:00,·,Ya beginilah bangsa besar dan kaya raya,0,0,0,590,https://x.com/yoonirey/status/1972241176117027155,https://x.com/IndoPopBase/status/1972237830702366795,0
2025-09-28 12:12:55+00:00,jerukcheseebun,"@grok
 kalo 1.2triliun perhari dipake untuk ngegaji guru honorer biar gajinya setara umr, bisa berapa guru yang dapet?",1,0,0,1099,https://x.com/jerukcheseebun/status/1972273313163731256,https://x.com/IndoPopBase/status/1972237830702366795,1
2025-09-28 18:30:05+00:00,JeremyahRome,"dear babi gendut 
@prabowo
  ,

percaya deh , 
dari 1,2 T  tsb , 
yg cuman 500 M yg berbentuk mbg , yg tentunya no bergizi

sisanya , 
pasti berbentuk rekening , 
either E wallet , or common bank",1,0,0,70,https://x.com/JeremyahRome/status/1972368229202112619,https://x.com/IndoPopBase/status/1972237830702366795,1
2025-09-28 12:26:09+00:00,krispiiiiii,Logonya jelek. Fak,0,0,0,24,https://x.com/krispiiiiii/status/1972276642522517725,https://x.com/IndoPopBase/status/1972237830702366795,0
2025-09-28 10:19:45+00:00,mfrandika,Mega project bagi2 duit ,0,0,0,71,https://x.com/mfrandika/status/1972244835081077101,https://x.com/IndoPopBase/status/1972237830702366795,0
2025-09-28 13:07:54+00:00,bilalhanzhalah,"Tlglah pa infrastruktur sekolahnya dulu dibenerin, gaji guru tenaga pendidik di sesuaikan dg asn kementrian keuangan minimal, baru dah mbg. Jomplang bgt pa dtambah lg smartv, indonesia bkn jawa doank pa",0,0,0,468,https://x.com/bilalhanzhalah/status/1972287148016754693,https://x.com/IndoPopBase/status/1972237830702366795,0
2025-09-28 10:52:43+00:00,_RayNotHere,Could've been used for free education and livable wages for teachers.,2,0,0,211,https://x.com/_RayNotHere/status/1972253131254923276,https://x.com/IndoPopBase/status/1972237830702366795,2
2025-09-28 12:11:34+00:00,raytiq_99,Spending that much for what basically amounts to a glorified pre-alpha testing…,0,0,0,277,https://x.com/raytiq_99/status/1972272975002120314,https://x.com/IndoPopBase/status/1972237830702366795,0
2025-09-28 10:00:31+00:00,GobloSayaBilang,Mubazir blog gblg,0,0,0,218,https://x.com/GobloSayaBilang/status/1972239995202318628,https://x.com/IndoPopBase/status/1972237830702366795,0
2025-09-28 12:39:14+00:00,Sara96583195,Cuan cuan,0,0,0,12,https://x.com/Sara96583195/status/1972279936619811211,https://x.com/IndoPopBase/status/1972237830702366795,0
2025-09-28 17:49:33+00:00,bani78gblk,Kok buat pendidikan gratis dan kesejahteraan guru ngga bisa ya….,0,0,0,34,https://x.com/bani78gblk/status/1972358029732704332,https://x.com/IndoPopBase/status/1972237830702366795,0
2025-09-28 16:56:11+00:00,urpersonalhades,"Look what your president did 
@Rahvvana",1,0,0,42,https://x.com/urpersonalhades/status/1972344599781019675,https://x.com/IndoPopBase/status/1972237830702366795,1
2025-09-28 10:05:45+00:00,alotsofweird,02 voters emang bajingan asuuuuuu semuanya!!!! ini semua gara-gara kalian njinh anjing!!!!,0,0,0,822,https://x.com/alotsofweird/status/1972241311165206542,https://x.com/IndoPopBase/status/1972237830702366795,0
2025-09-28 09:56:43+00:00,PROSPERDEGREAT,Rp1.2T a day is wild. Curious how long they think that burn rate can stay sustainable,0,0,0,2239,https://x.com/PROSPERDEGREAT/status/1972239038930452561,https://x.com/IndoPopBase/status/1972237830702366795,0
2025-09-29 02:15:57+00:00,bareda,This is all just numbers to the people in the government. They don't really care about our children.,0,0,0,305,https://x.com/bareda/status/1972485471046656001,https://x.com/IndoPopBase/status/1972237830702366795,0
2025-09-29 03:20:33+00:00,udaaaaaangg,sayang bgt ya duit segitu gedenya :(,0,0,0,19,https://x.com/udaaaaaangg/status/1972501727342682482,https://x.com/IndoPopBase/status/1972237830702366795,0
2025-09-28 11:42:44+00:00,Efebeeri,Heh,0,0,0,55,https://x.com/Efebeeri/status/1972265716402577535,https://x.com/IndoPopBase/status/1972237830702366795,0
2025-09-28 09:55:58+00:00,sugar_6378,"Ada perinciannya per daerah gak sih? 
Data publik 1.2 T itu dipake buat apa aja?

Kaya biaya traynya berapa?
Beli bahan makanan per berapa lama?
Gaji karyawan mbg berapa?
dll

Biar masyarakar bisa bantu itung atau kasih usul juga. Kan programnya bagus sebenernya.
@grok
 ?",1,0,0,764,https://x.com/sugar_6378/status/1972238847896613009,https://x.com/IndoPopBase/status/1972237830702366795,1
2025-09-28 10:00:51+00:00,bnababan,Weird calculation,0,0,0,95,https://x.com/bnababan/status/1972240076064325885,https://x.com/IndoPopBase/status/1972237830702366795,0
2025-09-28 22:38:02+00:00,ardddin,BOROSSSS,0,0,0,36,https://x.com/ardddin/status/1972430627237712292,https://x.com/IndoPopBase/status/1972237830702366795,0
2025-09-29 02:13:17+00:00,relisrage2024,per day...?,0,0,0,8,https://x.com/relisrage2024/status/1972484798167064835,https://x.com/IndoPopBase/status/1972237830702366795,0
2025-09-28 10:48:30+00:00,shopeespill__,Gilaaakkk,0,0,0,21,https://x.com/shopeespill__/status/1972252068728676611,https://x.com/IndoPopBase/status/1972237830702366795,0
2025-09-28 12:40:37+00:00,dejapoooh,per day?,0,0,0,25,https://x.com/dejapoooh/status/1972280284671524897,https://x.com/IndoPopBase/status/1972237830702366795,0
2025-09-28 10:04:47+00:00,sazaneia,maksa gile,0,0,0,133,https://x.com/sazaneia/status/1972241065886593426,https://x.com/IndoPopBase/status/1972237830702366795,0
2025-09-28 11:34:20+00:00,Vivalavigor,Mantap uji coba ketahan hidup bersama sama,0,0,0,77,https://x.com/Vivalavigor/status/1972263601584173216,https://x.com/IndoPopBase/status/1972237830702366795,0
2025-09-28 16:47:05+00:00,alchrysoberyl,program tertolol,0,0,0,10,https://x.com/alchrysoberyl/status/1972342307715534880,https://x.com/IndoPopBase/status/1972237830702366795,0
2025-09-29 08:22:30+00:00,raffinyourhead,"daripada aggaran sebanyak itu dipakai buat ngeracunin anak-anak terus, mending di alihkan buat program yg lebih berguna",0,0,0,36,https://x.com/raffinyourhead/status/1972577713803395180,https://x.com/IndoPopBase/status/1972237830702366795,0
2025-09-28 10:31:48+00:00,cluelessoo,gila anjir triliunan per hari?,0,0,0,37,https://x.com/cluelessoo/status/1972247864467480823,https://x.com/IndoPopBase/status/1972237830702366795,0
2025-09-29 05:37:12+00:00,alvianbhakti,,0,0,0,56,https://x.com/alvianbhakti/status/1972536115174535439,https://x.com/IndoPopBase/status/1972237830702366795,0
2025-09-28 11:37:41+00:00,fxxkingvirgo,wallahi were finished,0,0,0,36,https://x.com/fxxkingvirgo/status/1972264444823814296,https://x.com/IndoPopBase/status/1972237830702366795,0
2025-09-28 12:16:24+00:00,icamm_,Uang segitu banyak kalau diarahkan ke peningkatan mutu pendidikan bakal lebih baik daripada buat MBG,0,0,0,280,https://x.com/icamm_/status/1972274190574329981,https://x.com/IndoPopBase/status/1972237830702366795,0
2025-09-28 10:56:37+00:00,roweeasley,Hah? Perhari? Apa ga bener kalau dibilanh 2030 negara bubar kenapasih anjir ga di alokasiin ke hal lain syalan ,0,0,0,154,https://x.com/roweeasley/status/1972254109677011187,https://x.com/IndoPopBase/status/1972237830702366795,0
2025-09-28 10:32:32+00:00,narerurashii_,Si suaminya Sandra Dewi tuh suruhh bayar,0,0,0,76,https://x.com/narerurashii_/status/1972248052003123416,https://x.com/IndoPopBase/status/1972237830702366795,0
2025-09-28 10:06:24+00:00,idiotsandbeach,PER DAY???,0,0,0,108,https://x.com/idiotsandbeach/status/1972241473249906911,https://x.com/IndoPopBase/status/1972237830702366795,0
2025-09-29 09:17:25+00:00,moxziva,Waste of taxpayers money,0,0,0,6,https://x.com/moxziva/status/1972591536497209528,https://x.com/IndoPopBase/status/1972237830702366795,0
2025-09-28 11:57:26+00:00,pritanaya,"Bravo, BGN! Rp1.2 TRILLION a day for MBG in 2026 to serve poisoned meals while gutting the 20% education budget. Who needs schools when we’ve got wasteful spending and sick kids? ",0,0,0,457,https://x.com/pritanaya/status/1972269418236596295,https://x.com/IndoPopBase/status/1972237830702366795,0
2025-09-28 18:39:07+00:00,grumpyygirl,orang yg pada join BGN pake kegiatan semi militer tuh buat apa ya,0,0,0,41,https://x.com/grumpyygirl/status/1972370504964255960,https://x.com/IndoPopBase/status/1972237830702366795,0
2025-09-28 12:04:40+00:00,None88114236,"Najing per day
Buat sesuatu yg ga berguna, bahkan merugikan

Ego lu anjing 
@prabowo
 
Rakyat bakal bahagia klo lu mampus anjing",0,0,0,28,https://x.com/None88114236/status/1972271236093985203,https://x.com/IndoPopBase/status/1972237830702366795,0
2025-09-29 00:51:24+00:00,cocoro_rods,No one wants that bilion dollar Chum Bucket ass slop,0,0,0,23,https://x.com/cocoro_rods/status/1972464192579055746,https://x.com/IndoPopBase/status/1972237830702366795,0
2025-09-28 13:38:58+00:00,afcdevan,bisa adain demo gak sih? gw mau ikutan dasar pemerintah ANJING!,0,0,0,62,https://x.com/afcdevan/status/1972294967717761461,https://x.com/IndoPopBase/status/1972237830702366795,0
2025-09-28 12:43:52+00:00,slpngwthsrns_,"bajingan bukan kue lagi ini mah, pabrik kue ini",0,0,0,58,https://x.com/slpngwthsrns_/status/1972281102028145045,https://x.com/IndoPopBase/status/1972237830702366795,0
2025-09-28 11:09:25+00:00,moodzfix,"udah dong anjir duit pajak kita cuma buat ngeracunin anak doang, mending jadiin transportasi sama infrastruktur",0,0,0,88,https://x.com/moodzfix/status/1972257330797703430,https://x.com/IndoPopBase/status/1972237830702366795,0
2025-09-28 11:16:01+00:00,lemon_taa,Gila,0,0,0,37,https://x.com/lemon_taa/status/1972258992278954111,https://x.com/IndoPopBase/status/1972237830702366795,0
2025-09-28 12:25:02+00:00,CurleeAree,And how much are really going to the kids free food? And how much are going into their pockets??,0,0,0,75,https://x.com/CurleeAree/status/1972276361013424157,https://x.com/IndoPopBase/status/1972237830702366795,0
2025-09-28 09:43:40+00:00,swandieve,"Lalu ada yang belain : ""jadi wartawan harus tau waktu kalau nanya. bapak capek baru sampai dari luar negeri."" 

Gamau capek mah gausah jadi presiden, and mind you dia bolak balik luar negeri juga ga pake pesawat kormesil ekonomi. Yaelah.",15,145,0,11897,https://x.com/swandieve/status/1972235753859232050,https://x.com/IndoPopBase/status/1972224987407974712,160
2025-09-28 09:09:52+00:00,SistersInDanger,"What a blunder, revoking press access is counterproductive & only damages their image of transparency 
Why don’t they realize that?",1,21,0,11271,https://x.com/SistersInDanger/status/1972227244794994699,https://x.com/IndoPopBase/status/1972224987407974712,22
2025-09-28 09:15:34+00:00,haikarrll85,Yang ini bukan sih..??,4,35,0,11598,https://x.com/haikarrll85/status/1972228680014495977,https://x.com/IndoPopBase/status/1972224987407974712,39
2025-09-28 09:17:00+00:00,·,"Pers dibungkam, melakukan kritik dianggap tdk memberikan dukungan. Tinggal di Indonesia miris bgt hidupnya dikendalikan sma pemerintah. Mmng diktator ga akan pernah berubah",0,8,0,2303,https://x.com/whiterosestea/status/1972229042364707185,https://x.com/IndoPopBase/status/1972224987407974712,8
2025-09-28 09:46:46+00:00,janeuphoriarmy,Guess he learned from his genocidal and war criminal teacher. Democracy who? Freedom of press what? It's Negara Komunis Rakyat Indonesia!,1,3,0,4445,https://x.com/janeuphoriarmy/status/1972236531986522162,https://x.com/IndoPopBase/status/1972224987407974712,4
2025-09-28 09:12:22+00:00,popbasephil,kinda same vibe,2,0,0,9132,https://x.com/popbasephil/status/1972227875270189528,https://x.com/IndoPopBase/status/1972224987407974712,2
2025-09-28 11:54:55+00:00,dioz19,Org2 di kabinet Prabowo,0,6,0,1846,https://x.com/dioz19/status/1972268781092458937,https://x.com/IndoPopBase/status/1972224987407974712,6
2025-09-28 13:09:01+00:00,saundezip,"Cupu banget lo woo, ngambekan.",0,0,0,201,https://x.com/saundezip/status/1972287432390549905,https://x.com/IndoPopBase/status/1972224987407974712,0
2025-09-29 01:41:07+00:00,operatorgalang1,cosplay jadi trump haha,0,0,0,32,https://x.com/operatorgalang1/status/1972476701440700516,https://x.com/IndoPopBase/status/1972224987407974712,0
2025-09-28 10:56:27+00:00,capungnagafly,Semakin gilaaaa,0,0,0,161,https://x.com/capungnagafly/status/1972254069185257983,https://x.com/IndoPopBase/status/1972224987407974712,0
2025-09-28 14:36:41+00:00,tobrutt___,Takut Nepal jilid 2 di Indonesia ,1,0,0,108,https://x.com/tobrutt___/status/1972309492483469387,https://x.com/IndoPopBase/status/1972224987407974712,1
2025-09-28 10:55:27+00:00,awasaturn,Astaghfirullah,0,0,0,188,https://x.com/awasaturn/status/1972253819292799427,https://x.com/IndoPopBase/status/1972224987407974712,0
2025-09-28 11:25:32+00:00,arzh_aq,"Tukang bungkam wkwkwk, najis",0,0,0,172,https://x.com/arzh_aq/status/1972261387180372227,https://x.com/IndoPopBase/status/1972224987407974712,0
2025-09-28 12:15:42+00:00,agungtrainer,Wartawan mesti boikot istana.,0,0,0,13,https://x.com/agungtrainer/status/1972274013901840753,https://x.com/IndoPopBase/status/1972224987407974712,0
2025-09-29 02:09:08+00:00,sabgettinwylin,so welcome back Orba(?),0,0,0,49,https://x.com/sabgettinwylin/status/1972483753063944282,https://x.com/IndoPopBase/status/1972224987407974712,0
2025-09-28 11:57:12+00:00,Mynamei08339298,Bazerr waktu dan tempat dipersilahkan,0,0,0,72,https://x.com/Mynamei08339298/status/1972269359491170634,https://x.com/IndoPopBase/status/1972224987407974712,0
2025-09-28 12:28:10+00:00,mentayrice,act surprised everyone,0,0,0,249,https://x.com/mentayrice/status/1972277149303488776,https://x.com/IndoPopBase/status/1972224987407974712,0
2025-09-28 12:39:50+00:00,megicjar,Ntar mbaknya disuruh klarifikasi dengan ancaman buat permintaan maaf. Semoga aman2 ya mbak,0,0,0,158,https://x.com/megicjar/status/1972280086197067913,https://x.com/IndoPopBase/status/1972224987407974712,0
2025-09-28 17:33:55+00:00,DaudCool,Blunder besar sih istana..cari masalah ama pers dan rakyat nih mah,0,0,0,67,https://x.com/DaudCool/status/1972354095303561561,https://x.com/IndoPopBase/status/1972224987407974712,0
2025-09-28 09:50:02+00:00,·,pembungkaman yang nyata!!!,0,0,0,168,https://x.com/piiuta/status/1972237353357091226,https://x.com/IndoPopBase/status/1972224987407974712,0
2025-09-28 09:49:15+00:00,·,usut tuntas!!!,0,0,0,162,https://x.com/piiuta/status/1972237156501618939,https://x.com/IndoPopBase/status/1972224987407974712,0
2025-09-28 14:20:58+00:00,mario_an19,"kek nya orang2 sekeliling wowo, problematik semua ini",0,0,0,70,https://x.com/mario_an19/status/1972305536554250479,https://x.com/IndoPopBase/status/1972224987407974712,0
2025-09-28 11:07:38+00:00,blessedthehell,Damynnn,0,0,0,139,https://x.com/blessedthehell/status/1972256882028052730,https://x.com/IndoPopBase/status/1972224987407974712,0
2025-09-28 12:21:05+00:00,Bearboytxt,"Gua bukan mau belain pak prabowo. Tapi..!
Si gibran kerjanya ngapain aja ??
Kenapa ditumpahkan semuanya permasalahan di indonesia sama presiden prabowo ? 
Kan ada wakil presiden ! Emang gak bisa nanya si gibran selama prabowo kunjungan dinas ke luar negeri ?
Kocak.",2,0,0,810,https://x.com/Bearboytxt/status/1972275366464307397,https://x.com/IndoPopBase/status/1972224987407974712,2
2025-09-28 11:14:49+00:00,muffledpetals,stress kabeh,0,0,0,107,https://x.com/muffledpetals/status/1972258693225095436,https://x.com/IndoPopBase/status/1972224987407974712,0
2025-09-28 09:08:45+00:00,masreyhaan,Ai bapaaa kunaonn,0,0,0,643,https://x.com/masreyhaan/status/1972226964732977237,https://x.com/IndoPopBase/status/1972224987407974712,0
2025-09-28 10:42:52+00:00,AvianmalariaPJ,seremnya,0,0,0,83,https://x.com/AvianmalariaPJ/status/1972250652119335149,https://x.com/IndoPopBase/status/1972224987407974712,0
2025-09-28 14:58:52+00:00,civilsociety_RI,Dih kocak,0,0,0,49,https://x.com/civilsociety_RI/status/1972315076247036414,https://x.com/IndoPopBase/status/1972224987407974712,0
2025-09-28 12:57:30+00:00,nindya311,Sok baperan emang sih iya ,0,0,0,77,https://x.com/nindya311/status/1972284531278533114,https://x.com/IndoPopBase/status/1972224987407974712,0
2025-09-28 21:55:05+00:00,jannahseeker99,"Kalau 
@kompascom
 main 2 kaki kondisi kayak gini parah sih, harus solid pers wartawan / stasiun tv indonesia",0,0,0,85,https://x.com/jannahseeker99/status/1972419818554081419,https://x.com/IndoPopBase/status/1972224987407974712,0
2025-09-28 15:39:46+00:00,jannahseeker99,No viral no justice,0,0,0,46,https://x.com/jannahseeker99/status/1972325368922329224,https://x.com/IndoPopBase/status/1972224987407974712,0
2025-09-28 09:15:22+00:00,jannahseeker99,No viral no justice,0,0,0,635,https://x.com/jannahseeker99/status/1972228629984870843,https://x.com/IndoPopBase/status/1972224987407974712,0
2025-09-28 11:00:49+00:00,Qween_Of_RAP,BYE BITCH!,0,0,0,61,https://x.com/Qween_Of_RAP/status/1972255166884921551,https://x.com/IndoPopBase/status/1972224987407974712,0
2025-09-28 10:11:16+00:00,valdo__13,emang bisa ya? cnn sue them ass,1,0,0,586,https://x.com/valdo__13/status/1972242697948955107,https://x.com/IndoPopBase/status/1972224987407974712,1
2025-09-29 01:36:48+00:00,scroogetheduck,,0,0,0,23,https://x.com/scroogetheduck/status/1972475616068080054,https://x.com/IndoPopBase/status/1972224987407974712,0
2025-09-28 09:58:26+00:00,JavaJimmyMaukar,Asia Tenggara sedang melawan kepala negara korup,0,0,0,291,https://x.com/JavaJimmyMaukar/status/1972239467290501361,https://x.com/IndoPopBase/status/1972224987407974712,0
2025-09-28 10:55:23+00:00,irvinaffandi66,"Kenapa jadi seperti ini 
@grok",1,0,0,93,https://x.com/irvinaffandi66/status/1972253799420240168,https://x.com/IndoPopBase/status/1972224987407974712,1
2025-09-30 05:44:19+00:00,obviouslyaard,they're suppressing everything holy shit,0,0,0,5,https://x.com/obviouslyaard/status/1972900295761166721,https://x.com/IndoPopBase/status/1972224987407974712,0
2025-09-28 09:16:19+00:00,noturacar,"Be a ""jurnalis yang ditunggangi kepentingan"" and find out ",0,0,0,232,https://x.com/noturacar/status/1972228871715230003,https://x.com/IndoPopBase/status/1972224987407974712,0
2025-09-28 09:53:35+00:00,paradox6666666,"Pantesan media mainstream sekarang isi beritanya menjilat rezim semua. 
@KompasTV
 

Ternyata memang wartawan istana hanya boleh mengajukan pertanyaan yang diijinkan rezim.

Welcome to Neo orba. Brought to you by 
@prabowo",0,0,0,127,https://x.com/paradox6666666/status/1972238248383787072,https://x.com/IndoPopBase/status/1972224987407974712,0
2025-09-28 11:49:38+00:00,oneramyeon6,Kartu Identitas wartawan CNN diduga dicabut oleh pihak Biro Pers kesekretariat negara usai ia bertanya soal Program MBG Pada Prabowo.,0,0,0,9,https://x.com/oneramyeon6/status/1972267452370391510,https://x.com/IndoPopBase/status/1972224987407974712,0
2025-09-28 09:09:26+00:00,Caxiope1,Negara tidak akan maju kalau cuman ngurusin orang miskin,0,0,0,68,https://x.com/Caxiope1/status/1972227136980492579,https://x.com/IndoPopBase/status/1972224987407974712,0
2025-09-28 14:59:54+00:00,tobrutt___,"Apa benar jamAn dulu pak Harto pernah melarang seperti majalah untuk memberitakan dugaan korupsi pembelian kapal perang bekas dari jerman 
@grok",1,0,0,35,https://x.com/tobrutt___/status/1972315337145352485,https://x.com/IndoPopBase/status/1972224987407974712,1
2025-09-28 09:37:58+00:00,jujugantz,"Little baby got his pride hurt, do you need a hug, do you need another war criminal to praise you, or do you need you boytoy to comfort you",0,0,0,159,https://x.com/jujugantz/status/1972234317259771939,https://x.com/IndoPopBase/status/1972224987407974712,0
2025-09-28 10:14:10+00:00,Afe60223152,Makanya sukanya keluyuran ke LN karena di dalem negeri kagk bisa apa2.,0,0,0,74,https://x.com/Afe60223152/status/1972243428017852680,https://x.com/IndoPopBase/status/1972224987407974712,0
2025-09-28 13:01:53+00:00,Mudiiinn,,0,0,0,40,https://x.com/Mudiiinn/status/1972285634107818157,https://x.com/IndoPopBase/status/1972224987407974712,0
2025-09-28 09:20:02+00:00,achiavellian,I get jumped when I say Prabowo era itu era Suharto tapi versi media massa lebih banyak jadi pembungkamannya lebih keliatan,0,0,0,180,https://x.com/achiavellian/status/1972229807397302722,https://x.com/IndoPopBase/status/1972224987407974712,0
2025-09-28 09:36:12+00:00,GobloSayaBilang,"Sinaran is already perfect, and it doesn't need to be recycled or shit",2,0,0,512,https://x.com/GobloSayaBilang/status/1972233872973918604,https://x.com/IndoPopBase/status/1972221839821959459,2
2025-09-28 09:01:35+00:00,bitchofprey,stop ruining classics,1,0,0,379,https://x.com/bitchofprey/status/1972225162495086839,https://x.com/IndoPopBase/status/1972221839821959459,1
2025-09-29 01:33:34+00:00,temanamaste,"everyone wants their disco jazz moment until it’s time to write a new disco music 

Why are you, an icon, covering a 100-year-old song? girl write your own music, you are ROSSA ffs",0,1,0,129,https://x.com/temanamaste/status/1972474801882337668,https://x.com/IndoPopBase/status/1972221839821959459,1
2025-09-28 09:04:06+00:00,pelurukuhabis,Kadang ya yg kita cari bukan sinar lampu tapi sinaran mata yang bikin hidup terasa hidup.,0,0,0,467,https://x.com/pelurukuhabis/status/1972225797453906062,https://x.com/IndoPopBase/status/1972221839821959459,0
2025-09-28 09:08:57+00:00,PROSPERDEGREAT,"Covering ‘Sinaran’ is a risky play, that song is iconic. Let’s see if Rossa can bring her own magic to it",0,0,0,446,https://x.com/PROSPERDEGREAT/status/1972227017568649405,https://x.com/IndoPopBase/status/1972221839821959459,0
2025-09-28 09:18:48+00:00,bioplacenton13,We're tired of cover,0,0,0,230,https://x.com/bioplacenton13/status/1972229494238027787,https://x.com/IndoPopBase/status/1972221839821959459,0
2025-09-28 09:05:57+00:00,utdstewie,only tolerable cover is from warna 25 years ago,0,0,0,400,https://x.com/utdstewie/status/1972226259599216730,https://x.com/IndoPopBase/status/1972221839821959459,0
2025-09-28 08:59:01+00:00,andreyjaya,SEATED,0,0,0,311,https://x.com/andreyjaya/status/1972224514424725720,https://x.com/IndoPopBase/status/1972221839821959459,0
2025-09-28 08:48:53+00:00,xAvellesch,teh oca,0,0,0,442,https://x.com/xAvellesch/status/1972221966024413588,https://x.com/IndoPopBase/status/1972221839821959459,0
2025-10-09 09:27:44+00:00,QUEERAUSAHAAN,ammar zoni is the best anti-drug ad cause WTF HAPPENED like oh my god…..,119,850,0,545599,https://x.com/QUEERAUSAHAAN/status/1976218010957512842,https://x.com/IndoPopBase/status/1972221839821959459,969
2025-10-09 03:59:25+00:00,tittydeejay,that won’t stop us,692,3812,0,1873406,https://x.com/tittydeejay/status/1976135383961436339,https://x.com/IndoPopBase/status/1972221839821959459,4504
2025-10-09 14:34:33+00:00,findormeme,bunch of elementary school kids revealing their exam passing status while slipping through my fingers is playing on the background meryl streep tidak lulus anak sd nangis dramatic hasil ujian nangis,373,2168,0,1399337,https://x.com/findormeme/status/1976295222960427487,https://x.com/IndoPopBase/status/1972221839821959459,2541
2025-10-09 11:04:39+00:00,xNortromx,The artist:                      The Art:,248,3353,0,885493,https://x.com/xNortromx/status/1976242398083588583,https://x.com/IndoPopBase/status/1972221839821959459,3601
2025-09-28 08:57:07+00:00,DatoSriRossa,Enough with ballads. It’s time to go back on the dance floor .,0,0,0,376,https://x.com/DatoSriRossa/status/1972224036060156011,https://x.com/IndoPopBase/status/1972219432186651089,0
2025-09-28 08:45:51+00:00,tertusuq,"We need a full album with pure “Malam Pertama” vibes. This time mah no melow melow ya Teh Ocha punten bgt  
@mynameisrossa",0,1,0,4195,https://x.com/tertusuq/status/1972221203269189814,https://x.com/IndoPopBase/status/1972219432186651089,1
2025-09-28 08:58:24+00:00,DatoSriRossa,Tickets tour asmara dansa starting tomorrow,0,1,0,343,https://x.com/DatoSriRossa/status/1972224362192466157,https://x.com/IndoPopBase/status/1972219432186651089,1
2025-09-28 10:13:04+00:00,RossaLegend,Rossa in confession oh the dance floor & future nostalgia era,0,0,0,139,https://x.com/RossaLegend/status/1972243153051914387,https://x.com/IndoPopBase/status/1972219432186651089,0
2025-09-28 08:40:52+00:00,sugar_6378,Retro banget ini keren ih teasernya!,0,0,0,504,https://x.com/sugar_6378/status/1972219948161552830,https://x.com/IndoPopBase/status/1972219432186651089,0
2025-09-28 09:17:16+00:00,mmjussX,"In her confession era , SEATED",0,0,0,197,https://x.com/mmjussX/status/1972229110442385783,https://x.com/IndoPopBase/status/1972219432186651089,0
2025-09-28 09:59:56+00:00,FAMEHOOKER97,Oke rossa peep,0,0,0,71,https://x.com/FAMEHOOKER97/status/1972239845872517276,https://x.com/IndoPopBase/status/1972219432186651089,0
2025-09-29 06:02:27+00:00,blessedthehell,Confessions on a Dance Floor ,0,0,0,14,https://x.com/blessedthehell/status/1972542468030914748,https://x.com/IndoPopBase/status/1972219432186651089,0
2025-09-28 13:46:06+00:00,NeedU2Know_,Minogue vibes ,0,0,0,63,https://x.com/NeedU2Know_/status/1972296764297498907,https://x.com/IndoPopBase/status/1972219432186651089,0
2025-10-01 10:03:07+00:00,heavensbeeeee,Her name ruins the cover ,0,0,0,15,https://x.com/heavensbeeeee/status/1973327812548501729,https://x.com/IndoPopBase/status/1972219432186651089,0
2025-09-28 08:44:25+00:00,hardhene,okay Donna Summer,0,0,0,328,https://x.com/hardhene/status/1972220840793227698,https://x.com/IndoPopBase/status/1972219432186651089,0
2025-09-28 08:53:31+00:00,danuracula,Semua akan kembali retro pada waktunya,0,0,0,160,https://x.com/danuracula/status/1972223133034918039,https://x.com/IndoPopBase/status/1972219432186651089,0
2025-09-28 09:42:42+00:00,3usri,y2k,0,0,0,118,https://x.com/3usri/status/1972235509608104189,https://x.com/IndoPopBase/status/1972219432186651089,0
2025-09-28 08:45:53+00:00,JAKT1M,not her reheating yukika nachos,0,0,0,148,https://x.com/JAKT1M/status/1972221211397739000,https://x.com/IndoPopBase/status/1972219432186651089,0
2025-09-27 11:01:23+00:00,ggaoaoaa,,3,8,0,1572,https://x.com/ggaoaoaa/status/1971892923890651345,https://x.com/IndoPopBase/status/1971864599969644587,11
2025-09-27 09:42:59+00:00,rezkiamda62,Mimpi still on repeat,0,0,0,1013,https://x.com/rezkiamda62/status/1971873192122949772,https://x.com/IndoPopBase/status/1971864599969644587,0
2025-09-27 13:37:02+00:00,sepenggallsadar,"His best album, wake up look alive, gairah and tampopo still in rotation. Terima kasih mas kareem 
@yosubap",0,1,0,627,https://x.com/sepenggallsadar/status/1971932094302720199,https://x.com/IndoPopBase/status/1971864599969644587,1
2025-09-27 10:14:04+00:00,xgrowl91,g0at,0,0,0,847,https://x.com/xgrowl91/status/1971881013631676528,https://x.com/IndoPopBase/status/1971864599969644587,0
2025-09-27 12:34:23+00:00,himynameisIO,Mimpi sih gila,0,0,0,640,https://x.com/himynameisIO/status/1971916325678469439,https://x.com/IndoPopBase/status/1971864599969644587,0
2025-09-27 11:45:08+00:00,dewaningrats,bruxism rly shivered the timbered fr,0,0,0,657,https://x.com/dewaningrats/status/1971903934370611284,https://x.com/IndoPopBase/status/1971864599969644587,0
2025-09-28 09:40:22+00:00,ztrevahiaks,bap apanya zhamm?,0,0,0,132,https://x.com/ztrevahiaks/status/1972234921805762635,https://x.com/IndoPopBase/status/1971864599969644587,0
2025-09-27 23:45:56+00:00,Th3Tr4vel3r,BAP ? siapa ?,0,0,0,279,https://x.com/Th3Tr4vel3r/status/1972085327595819062,https://x.com/IndoPopBase/status/1971864599969644587,0
2025-10-09 13:02:17+00:00,genlib_,10 rilisan indonesia favorit menurut admin 1 genlib,10,75,0,36880,https://x.com/genlib_/status/1976272003184394403,https://x.com/IndoPopBase/status/1971864599969644587,85
2025-10-09 14:48:14+00:00,wildanaufalm,"The Trees and The Wild, 2025",4,146,0,12913,https://x.com/wildanaufalm/status/1976298666278432828,https://x.com/IndoPopBase/status/1971864599969644587,150
2025-10-09 11:23:08+00:00,jkt48baba,the title and cover is IMMACULATE,37,925,0,106204,https://x.com/jkt48baba/status/1976247051785761270,https://x.com/IndoPopBase/status/1971864599969644587,962
2025-10-09 10:34:22+00:00,febrianppkw,Murphy radio ni band gokil ye,71,224,0,37966,https://x.com/febrianppkw/status/1976234779696902406,https://x.com/IndoPopBase/status/1971864599969644587,295
2025-09-27 09:10:21+00:00,hadilocoboy,Mantap min ,0,0,0,936,https://x.com/hadilocoboy/status/1971864978648170981,https://x.com/IndoPopBase/status/1971856446615961852,0
2025-09-27 09:36:59+00:00,SaddamWeb3,respect,0,0,0,1231,https://x.com/SaddamWeb3/status/1971871682848870897,https://x.com/IndoPopBase/status/1971856446615961852,0
2025-09-27 09:11:30+00:00,admiralkizaruuu,,0,7,0,5596,https://x.com/admiralkizaruuu/status/1971865270684995720,https://x.com/IndoPopBase/status/1971856446615961852,7
2025-09-27 08:45:55+00:00,bareda,"Ga salah berarti ya selalu komen di IndoPopBase, ikut ngeramein = meningkatkan revenue.",0,1,0,6737,https://x.com/bareda/status/1971858833216885150,https://x.com/IndoPopBase/status/1971856446615961852,1
2025-09-27 08:46:40+00:00,BearryBlush,word for word bar for bar,19,3,0,9353,https://x.com/BearryBlush/status/1971859021763354749,https://x.com/IndoPopBase/status/1971856446615961852,22
2025-09-27 13:27:27+00:00,billllliiee,Indopopbase,0,0,0,761,https://x.com/billllliiee/status/1971929681743286417,https://x.com/IndoPopBase/status/1971856446615961852,0
2025-09-27 09:07:24+00:00,Souvidancent,"you could also donate to 
instagram.com/directdonation
… because right now the urgent thing is to help prevent starvation especially directly to those who are in the field so they could build tents and kitchens",0,2,0,3438,https://x.com/Souvidancent/status/1971864237011358023,https://x.com/IndoPopBase/status/1971856446615961852,2
2025-09-27 14:43:44+00:00,lucabIight,,0,0,0,57,https://x.com/lucabIight/status/1971948879072596374,https://x.com/IndoPopBase/status/1971856446615961852,0
2025-09-27 08:55:52+00:00,sayaobito,W INDOPOPBASE ,0,0,0,679,https://x.com/sayaobito/status/1971861334041247893,https://x.com/IndoPopBase/status/1971856446615961852,0
2025-09-27 08:59:37+00:00,hugphobic,,0,0,0,313,https://x.com/hugphobic/status/1971862280884355309,https://x.com/IndoPopBase/status/1971856446615961852,0
2025-09-27 16:05:48+00:00,janeuphoriarmy,"After 
@PopBase
 now 
@IndoPopBase
 ",0,0,0,803,https://x.com/janeuphoriarmy/status/1971969530084868112,https://x.com/IndoPopBase/status/1971856446615961852,0
2025-09-27 13:05:10+00:00,findyourcillian,Ohhh you ate,0,0,0,45,https://x.com/findyourcillian/status/1971924072025174369,https://x.com/IndoPopBase/status/1971856446615961852,0
2025-09-27 13:50:58+00:00,Razelius_,,0,0,0,119,https://x.com/Razelius_/status/1971935599079969222,https://x.com/IndoPopBase/status/1971856446615961852,0
2025-09-27 15:46:04+00:00,fauzany90,Jangan kaget lu sayap kiri di Indonesia banyak yang Zionist wkkw,0,0,0,73,https://x.com/fauzany90/status/1971964564343513550,https://x.com/IndoPopBase/status/1971856446615961852,0
2025-09-27 09:13:53+00:00,bakteriyakult00,fck Israel,0,0,0,233,https://x.com/bakteriyakult00/status/1971865867794460730,https://x.com/IndoPopBase/status/1971856446615961852,0
2025-09-27 09:41:56+00:00,hoomanweed,KEREN MINN,0,0,0,349,https://x.com/hoomanweed/status/1971872930826268734,https://x.com/IndoPopBase/status/1971856446615961852,0
2025-09-27 14:20:23+00:00,NotVlrx,Keren min,0,0,0,35,https://x.com/NotVlrx/status/1971943001422446933,https://x.com/IndoPopBase/status/1971856446615961852,0
2025-09-27 17:04:31+00:00,FuadSaputra13,,0,0,0,19,https://x.com/FuadSaputra13/status/1971984309390397592,https://x.com/IndoPopBase/status/1971856446615961852,0
2025-09-27 11:24:58+00:00,vanillablve,"Sederhana tp gak semua petinggi negara bisa sksks anw so proud of you, min!",0,0,0,871,https://x.com/vanillablve/status/1971898857442496736,https://x.com/IndoPopBase/status/1971856446615961852,0
2025-09-27 09:04:16+00:00,distorsimurahan,berita ttg 7 pemain malaysia dibanned mana kocakkk?,3,0,0,433,https://x.com/distorsimurahan/status/1971863450881347664,https://x.com/IndoPopBase/status/1971856446615961852,3
2025-09-27 10:51:15+00:00,pivtapearce,indo pop based,0,0,0,131,https://x.com/pivtapearce/status/1971890371690107383,https://x.com/IndoPopBase/status/1971856446615961852,0
2025-09-27 12:48:22+00:00,pukimakncheese,and fatbowo??,0,0,0,42,https://x.com/pukimakncheese/status/1971919846079451553,https://x.com/IndoPopBase/status/1971856446615961852,0
2025-09-27 09:31:29+00:00,instinct_girl,RESPECT MIN!!! ,0,0,0,446,https://x.com/instinct_girl/status/1971870298447458657,https://x.com/IndoPopBase/status/1971856446615961852,0
2025-09-27 09:13:20+00:00,EverHushed,ATEEEEEEE,0,0,0,129,https://x.com/EverHushed/status/1971865731500528036,https://x.com/IndoPopBase/status/1971856446615961852,0
2025-09-27 13:04:09+00:00,Soraya_0615,,0,0,0,79,https://x.com/Soraya_0615/status/1971923820299932038,https://x.com/IndoPopBase/status/1971856446615961852,0
2025-09-27 11:19:01+00:00,dystudyyy,Rispek atmin,0,0,0,213,https://x.com/dystudyyy/status/1971897360587673729,https://x.com/IndoPopBase/status/1971856446615961852,0
2025-09-27 12:42:34+00:00,·,Always stun ,0,0,0,53,https://x.com/kappaross1234/status/1971918388034523152,https://x.com/IndoPopBase/status/1971856446615961852,0
2025-09-27 08:58:05+00:00,ekoajiw,semoga akunnya makin rame ya bes ,0,0,0,302,https://x.com/ekoajiw/status/1971861892408004742,https://x.com/IndoPopBase/status/1971856446615961852,0
2025-09-27 12:56:05+00:00,LionTheThird,4K USD greatt,0,0,0,26,https://x.com/LionTheThird/status/1971921788218364277,https://x.com/IndoPopBase/status/1971856446615961852,0
2025-09-27 09:17:05+00:00,punkdidikan,ended prabowhore,0,0,0,158,https://x.com/punkdidikan/status/1971866676460507168,https://x.com/IndoPopBase/status/1971856446615961852,0
2025-09-27 10:14:20+00:00,YourBruv,Respect ,0,0,0,186,https://x.com/YourBruv/status/1971881081747263812,https://x.com/IndoPopBase/status/1971856446615961852,0
2025-09-27 10:55:45+00:00,Flashdllah,"W IPB

spam W IPB in comment chat.",0,0,0,107,https://x.com/Flashdllah/status/1971891503976141018,https://x.com/IndoPopBase/status/1971856446615961852,0
2025-09-27 10:30:00+00:00,thesismetrying,QUEEN,0,0,0,339,https://x.com/thesismetrying/status/1971885027157062036,https://x.com/IndoPopBase/status/1971856446615961852,0
2025-09-27 14:28:06+00:00,kimendesss,respect,0,0,0,59,https://x.com/kimendesss/status/1971944944433877259,https://x.com/IndoPopBase/status/1971856446615961852,0
2025-09-28 03:52:13+00:00,amewakasa,Elu aja deh min yg jadi presiden kita,0,0,0,44,https://x.com/amewakasa/status/1972147308197564852,https://x.com/IndoPopBase/status/1971856446615961852,0
2025-09-27 09:08:09+00:00,8eatopia,,0,0,0,177,https://x.com/8eatopia/status/1971864426547671407,https://x.com/IndoPopBase/status/1971856446615961852,0
2025-09-27 10:20:42+00:00,necromanticcs,kenapa malah donate min? kenapa kita tidak menjamin keamanan negara Israel aja seperti kata presiden kita?,0,1,0,611,https://x.com/necromanticcs/status/1971882685087039606,https://x.com/IndoPopBase/status/1971856446615961852,1
2025-09-28 04:24:19+00:00,pilusgarudaen4k,Oke min akan ku komen terus yah biar engagement nya naik wkwkwk,0,0,0,38,https://x.com/pilusgarudaen4k/status/1972155387119128728,https://x.com/IndoPopBase/status/1971856446615961852,0
2025-09-27 09:02:59+00:00,InsNantikaa,,0,0,0,371,https://x.com/InsNantikaa/status/1971863127307555179,https://x.com/IndoPopBase/status/1971856446615961852,0
2025-09-27 12:25:39+00:00,PicuPiee,"W IndoPop""Based""",0,0,0,96,https://x.com/PicuPiee/status/1971914129033314321,https://x.com/IndoPopBase/status/1971856446615961852,0
2025-09-27 08:56:30+00:00,dkvitb,Ended fraudbowo,0,0,0,205,https://x.com/dkvitb/status/1971861493953319386,https://x.com/IndoPopBase/status/1971856446615961852,0
2025-09-27 08:52:04+00:00,Estebusachet,Yeah pop that old man face,0,0,0,225,https://x.com/Estebusachet/status/1971860378721390837,https://x.com/IndoPopBase/status/1971856446615961852,0
2025-09-27 09:10:12+00:00,·,QUEEN BEHAVIOR,0,0,0,249,https://x.com/EVERG0D/status/1971864941004238957,https://x.com/IndoPopBase/status/1971856446615961852,0
2025-09-27 09:01:06+00:00,ketigakalinyaaa,Akan ku ramaikan selalu,0,0,0,148,https://x.com/ketigakalinyaaa/status/1971862651191153154,https://x.com/IndoPopBase/status/1971856446615961852,0
2025-09-27 10:55:56+00:00,matchanepicek,W,0,0,0,207,https://x.com/matchanepicek/status/1971891551782785508,https://x.com/IndoPopBase/status/1971856446615961852,0
2025-09-27 10:50:20+00:00,sadicitrapata,Keren,0,0,0,203,https://x.com/sadicitrapata/status/1971890142421176465,https://x.com/IndoPopBase/status/1971856446615961852,0
2025-09-27 11:32:22+00:00,rottenfication,WE FREAKING LOVE YOU IPB,0,0,0,104,https://x.com/rottenfication/status/1971900719818326436,https://x.com/IndoPopBase/status/1971856446615961852,0
2025-09-28 19:02:23+00:00,arpctic,"so u and 
@PopBase
 are the same person or...",0,0,0,20,https://x.com/arpctic/status/1972376356764909804,https://x.com/IndoPopBase/status/1971856446615961852,0
2025-09-28 04:24:27+00:00,wtrmelonz14_,Gass minn,0,0,0,67,https://x.com/wtrmelonz14_/status/1972155421080395983,https://x.com/IndoPopBase/status/1971856446615961852,0
2025-09-29 13:16:33+00:00,deecsnothere,ohh indo pop base the superior you are,0,0,0,22,https://x.com/deecsnothere/status/1972651713640480792,https://x.com/IndoPopBase/status/1971856446615961852,0
2025-09-27 06:27:59+00:00,irularr_,dipuji zionis adalah titik terendah jadi WNI,59,5384,0,284079,https://x.com/irularr_/status/1971824118971687276,https://x.com/IndoPopBase/status/1971823769816912112,5443
2025-09-27 06:29:34+00:00,Flashdllah,killer recognizing killer,19,1373,0,128152,https://x.com/Flashdllah/status/1971824516654682175,https://x.com/IndoPopBase/status/1971823769816912112,1392
2025-09-27 07:52:58+00:00,ManBehindThe9un,,3,438,0,58473,https://x.com/ManBehindThe9un/status/1971845508022128957,https://x.com/IndoPopBase/status/1971823769816912112,441
2025-09-27 06:31:37+00:00,vicko_twitt,,7,186,0,47768,https://x.com/vicko_twitt/status/1971825034474963038,https://x.com/IndoPopBase/status/1971823769816912112,193
2025-09-27 06:38:25+00:00,wasbrat,,2,151,0,96224,https://x.com/wasbrat/status/1971826746275274816,https://x.com/IndoPopBase/status/1971823769816912112,153
2025-09-27 06:38:45+00:00,hrgila,"F
  　 U
  　　    C
  　　　　 K
  　　　　　    
                            I

  　　              S

  　　       R

  　　   A

  　　　  E

                         L
                 ｡  ･
         ｡°*.",0,175,0,26736,https://x.com/hrgila/status/1971826829582553297,https://x.com/IndoPopBase/status/1971823769816912112,175
2025-09-27 06:44:32+00:00,JakkuFurosto_,,0,0,0,7636,https://x.com/JakkuFurosto_/status/1971828286604169290,https://x.com/IndoPopBase/status/1971823769816912112,0
2025-09-27 06:54:49+00:00,sfakmal,"Penjahat perang akan selalu saling mengenali, mengakui, dan membenarkan.",0,5,0,6828,https://x.com/sfakmal/status/1971830870744223928,https://x.com/IndoPopBase/status/1971823769816912112,5
2025-09-27 07:29:41+00:00,janeuphoriarmy,"Birds of a feather flock together. Come Wowo, dont be shy, kiss the wall!",3,6,0,9280,https://x.com/janeuphoriarmy/status/1971839648126456221,https://x.com/IndoPopBase/status/1971823769816912112,9
2025-09-27 07:25:29+00:00,bisot,Haduh ,0,6,0,3527,https://x.com/bisot/status/1971838589056196642,https://x.com/IndoPopBase/status/1971823769816912112,6
2025-09-27 06:51:35+00:00,anjungkookism,you know when you’re sooooooooooo pissed that all you can do is laugh? ,0,1,0,2191,https://x.com/anjungkookism/status/1971830060257890309,https://x.com/IndoPopBase/status/1971823769816912112,1
2025-09-27 08:57:23+00:00,SEAGamethetic,??,0,1,0,1673,https://x.com/SEAGamethetic/status/1971861717903987181,https://x.com/IndoPopBase/status/1971823769816912112,1
2025-09-27 08:37:10+00:00,abracabunna29,"Eh Ben, statement two-state solution itu tidak mewakili keinginan rakyat Indonesia yaa. Jangan geer. 

Smp kpn pun isriwil bukan Negara, klean itu penjajah.",4,4,0,4707,https://x.com/abracabunna29/status/1971856627776233947,https://x.com/IndoPopBase/status/1971823769816912112,8
2025-09-27 07:02:40+00:00,_g00dm0aning,Berasa diketawain ama ETI ,0,2,0,43682,https://x.com/_g00dm0aning/status/1971832848287211871,https://x.com/IndoPopBase/status/1971823769816912112,2
2025-09-27 08:48:04+00:00,minecraaaafty,Ini sih saling tarik tarikan di neraka,0,2,0,2692,https://x.com/minecraaaafty/status/1971859372440801329,https://x.com/IndoPopBase/status/1971823769816912112,2
2025-09-27 08:35:58+00:00,nuemontserrat,"Ok. Polanya semakin terbaca. Rupiah dibikin tumbang. Pidato presidennya diplintir dan diposisikan sebagai pembela Zionis supaya rakyat makin benci. Klo rakyat makin benci, demo rusuh makin mudah untuk disulut. Disulut dg maraknya keracuan MBG, dan isu emosional lainnya.",25,3,0,3865,https://x.com/nuemontserrat/status/1971856328726663382,https://x.com/IndoPopBase/status/1971823769816912112,28
2025-09-27 09:32:42+00:00,4ssahongsam,titik terendah WNI adalah vote 02 dan dipuji zionis,0,1,0,722,https://x.com/4ssahongsam/status/1971870605487362481,https://x.com/IndoPopBase/status/1971823769816912112,1
2025-09-27 06:32:14+00:00,bluesunkiss_,Prabski anjim.,0,0,0,1158,https://x.com/bluesunkiss_/status/1971825188196217055,https://x.com/IndoPopBase/status/1971823769816912112,0
2025-09-27 06:50:44+00:00,S9ouw,Makin seneng beliau dimention di panggung internasional.,2,3,0,5245,https://x.com/S9ouw/status/1971829845798908132,https://x.com/IndoPopBase/status/1971823769816912112,5
2025-09-27 07:27:21+00:00,JanissaryD_Last,"Krna kaya raya perna bintang tiga mantan menantu penguasa bikin parte kepala garuda jadi presiden negara

Soal kapasitas bapak² sarungan kaos kutang mandiin perkutut tiap pagi masi lebi pantes..",0,1,0,15471,https://x.com/JanissaryD_Last/status/1971839059929825698,https://x.com/IndoPopBase/status/1971823769816912112,1
2025-09-27 10:44:22+00:00,abah_mumtaz,"Inna Lillahi wa Inna Ilaihi Rajiun...
Ya Rabb...Semoga Engkau Jauhkan Kami  dr segala keburukan akibat pemimpin yg bersekutu dgn Setan yg  mendzalimi saudara² kami di Palestine...Amin 

From The River to The Sea  Palestine will be Free, soon...Insya Allah

#FreePalestine ",1,3,0,352,https://x.com/abah_mumtaz/status/1971888641380332009,https://x.com/IndoPopBase/status/1971823769816912112,4
2025-09-27 09:15:16+00:00,natasha_saja,"Rakyatnya keras ke Zionis..
Wowo lembek sama zionis",0,3,0,822,https://x.com/natasha_saja/status/1971866218010497288,https://x.com/IndoPopBase/status/1971823769816912112,3
2025-09-27 06:33:20+00:00,sugar_6378,"tapi kan ada insiden yang Netanyahu, Perdana Menteri Israel di cuekin kan?

tldr
beberapa delegasi dari Indonesia, Pakistan, Kuwait, Malaysia, Iran, dan Kuba disebut termasuk di antara yang melakukan aksi protes tersebut. Aksi ini dikoordinasikan sebagai bentuk penolakan terhadap",1,0,0,21116,https://x.com/sugar_6378/status/1971825465414562301,https://x.com/IndoPopBase/status/1971823769816912112,1
2025-09-28 00:19:16+00:00,spiderk1tt1,yang setuju indo tahun depan bubar like,0,0,0,144,https://x.com/spiderk1tt1/status/1972093716535128194,https://x.com/IndoPopBase/status/1971823769816912112,0
2025-09-27 09:07:28+00:00,shyoonbi,"Prabowo gitu di PBB bukan mewakili rakyat Indonesia, tp mewakili egonya sendiri",0,2,0,426,https://x.com/shyoonbi/status/1971864255696982120,https://x.com/IndoPopBase/status/1971823769816912112,2
2025-09-27 06:52:07+00:00,is_pelssy,Go to hell setanyahu,0,0,0,1972,https://x.com/is_pelssy/status/1971830194613960862,https://x.com/IndoPopBase/status/1971823769816912112,0
2025-09-27 07:09:25+00:00,eomshys,,0,1,0,259,https://x.com/eomshys/status/1971834547697603007,https://x.com/IndoPopBase/status/1971823769816912112,1
2025-09-27 08:56:46+00:00,alotsofweird,sesama pembunuh dan penculik harus saling support hehehehe,0,1,0,3389,https://x.com/alotsofweird/status/1971861562999869732,https://x.com/IndoPopBase/status/1971823769816912112,1
2025-09-27 22:48:25+00:00,B4n6_H4n5,Maksudnya apa nih setannyahu...?,0,0,0,2403,https://x.com/B4n6_H4n5/status/1972070852612313096,https://x.com/IndoPopBase/status/1971823769816912112,0
2025-09-28 05:33:11+00:00,IWLYCPNNRTF,Baru kali ini bukan merinding kagum tapi merinding jijayyy di notice Netanyahu negara tercinta,0,1,0,134,https://x.com/IWLYCPNNRTF/status/1972172716636807495,https://x.com/IndoPopBase/status/1971823769816912112,1
2025-09-27 14:00:26+00:00,rifki_AM_,,0,0,0,286,https://x.com/rifki_AM_/status/1971937981411086390,https://x.com/IndoPopBase/status/1971823769816912112,0
2025-09-27 08:34:32+00:00,IlhamAtsaris,"Wkwk malu anjingg, di puji sama zionis",0,1,0,22816,https://x.com/IlhamAtsaris/status/1971855966812647871,https://x.com/IndoPopBase/status/1971823769816912112,1
2025-09-27 11:39:31+00:00,Sorayaame,"Makin hari makin zionist, anthekk asheng antekk asheng katanya",1,0,0,218,https://x.com/Sorayaame/status/1971902521003463022,https://x.com/IndoPopBase/status/1971823769816912112,1
2025-09-27 08:21:15+00:00,meow_leader2,sesama pelanggar HAM saling memuji,0,0,0,1652,https://x.com/meow_leader2/status/1971852622840905738,https://x.com/IndoPopBase/status/1971823769816912112,0
2025-09-27 16:02:14+00:00,GendiOfficial28,"Najis, “a sign of what could come” hina banget jadi pioneer supporter zionist. Ini presiden siapa ajg?",0,1,0,196,https://x.com/GendiOfficial28/status/1971968634433286647,https://x.com/IndoPopBase/status/1971823769816912112,1
2025-09-27 07:38:42+00:00,daehypeelS_,Oalahhhhhhhh satu grup WhatsApp ternyata ffuuucookkkkkkk,0,1,0,2427,https://x.com/daehypeelS_/status/1971841916124934440,https://x.com/IndoPopBase/status/1971823769816912112,1
2025-09-27 10:55:16+00:00,DIVINEG0RE,PRESIDEN KONTOL,0,1,0,103,https://x.com/DIVINEG0RE/status/1971891385256333687,https://x.com/IndoPopBase/status/1971823769816912112,1
2025-09-27 06:50:19+00:00,jackalevm,Si iblis make pin QR code dikira ada yang ngescan,1,0,0,9407,https://x.com/jackalevm/status/1971829738282143903,https://x.com/IndoPopBase/status/1971823769816912112,1
2025-09-28 14:13:07+00:00,ReinkarnasiDae1,,0,0,0,10,https://x.com/ReinkarnasiDae1/status/1972303560248615351,https://x.com/IndoPopBase/status/1971823769816912112,0
2025-09-27 06:36:23+00:00,UQzuu,pengebom dan peracun,0,0,0,4174,https://x.com/UQzuu/status/1971826234251452602,https://x.com/IndoPopBase/status/1971823769816912112,0
2025-09-27 12:07:03+00:00,beautiaf,najis amit-amit dipuji sama zionist,0,0,0,11081,https://x.com/beautiaf/status/1971909448575996364,https://x.com/IndoPopBase/status/1971823769816912112,0
2025-09-27 13:34:21+00:00,NggakPunya,Hina.,0,0,0,27,https://x.com/NggakPunya/status/1971931420135436774,https://x.com/IndoPopBase/status/1971823769816912112,0
2025-09-27 07:25:49+00:00,gedebugenjooy,Titik terendah jadi WNI,0,0,0,466,https://x.com/gedebugenjooy/status/1971838671826428160,https://x.com/IndoPopBase/status/1971823769816912112,0
2025-09-27 08:42:54+00:00,Mooneyra11,"Dipuji setanyahu, prab setara dgn krik.",0,0,0,120,https://x.com/Mooneyra11/status/1971858071065711093,https://x.com/IndoPopBase/status/1971823769816912112,0
2025-09-27 07:54:05+00:00,idiotsandbeach,lansia skizo x lansia skizo,0,0,0,129,https://x.com/idiotsandbeach/status/1971845785517236522,https://x.com/IndoPopBase/status/1971823769816912112,0
2025-09-27 07:10:03+00:00,devssential,Blokkkkk,0,0,0,41,https://x.com/devssential/status/1971834706183574008,https://x.com/IndoPopBase/status/1971823769816912112,0
2025-09-27 10:52:05+00:00,IrfanHP,Mau jadi Superman kah,0,0,0,9911,https://x.com/IrfanHP/status/1971890582386847942,https://x.com/IndoPopBase/status/1971823769816912112,0
2025-09-27 07:12:23+00:00,kaedehvara,anjinggggg malu goblog dipuji jionis,0,0,0,1671,https://x.com/kaedehvara/status/1971835292207534233,https://x.com/IndoPopBase/status/1971823769816912112,0
2025-09-27 09:30:52+00:00,valfidz,Malu bgt ya Allah punya presiden kek gini,0,0,0,108,https://x.com/valfidz/status/1971870142658417002,https://x.com/IndoPopBase/status/1971823769816912112,0
2025-09-27 08:15:36+00:00,mdpsetyo,Najis banget dipuji Firaun.,0,0,0,329,https://x.com/mdpsetyo/status/1971851201424883739,https://x.com/IndoPopBase/status/1971823769816912112,0
2025-09-27 04:08:50+00:00,officialinews_,"5 Daerah dengan Kasus Keracunan MBG Terbesar, Salah Satunya Bandung Barat",0,1,0,2342,https://x.com/officialinews_/status/1971789101788811351,https://x.com/IndoPopBase/status/1971784853810237597,1
2025-09-27 03:52:19+00:00,SaddamWeb3,,2,0,0,2055,https://x.com/SaddamWeb3/status/1971784945644491247,https://x.com/IndoPopBase/status/1971784853810237597,2
2025-09-27 04:11:14+00:00,dodisegrovee,"BGN bilang kasus keracunan MBG di Bandung :

Ayam dibeli Sabtu, baru dimasak Rabu. Dan disimpan 4 hari di freezer, 350 ekor pula. Imbasnya : ribuan anak keracunan.

Tragedi muncul bukan dari takdir, tapi dari kelalaian yang dibiarkan jadi kebiasaan.",2,6,0,3302,https://x.com/dodisegrovee/status/1971789704141181343,https://x.com/IndoPopBase/status/1971784853810237597,8
2025-09-27 04:02:01+00:00,Rumahdepok_,MBG sama aja dengan covid 19 sama sama membunuh cuma bedanya covid tidak berwujud ,1,1,0,1499,https://x.com/Rumahdepok_/status/1971787387346043023,https://x.com/IndoPopBase/status/1971784853810237597,2
2025-09-27 04:36:11+00:00,estelersatu,mind you not a single person in BGNs fam is a nutritionist expert or qualified in the given field. just a bunch of older people with military background.,0,0,0,1036,https://x.com/estelersatu/status/1971795984465432620,https://x.com/IndoPopBase/status/1971784853810237597,0
2025-09-27 03:54:49+00:00,sugar_6378,"Ini bertambah yah?

Ada yg bapak siapa bilang, ini kan yg keracunan sebagian kecil aja dari total mbg yg di bagikan.

Tp menurutku, kita kan manusia yah 2 orang keracunan aja dah banyak, 

ini 1000 org yg kracunan dia bilang, ""halah sedikit itu"". 

Ya ampun, kita kaya ayam ternak",1,1,0,3121,https://x.com/sugar_6378/status/1971785575264047569,https://x.com/IndoPopBase/status/1971784853810237597,2
2025-09-28 07:54:52+00:00,BaruNetas4,,0,0,0,32,https://x.com/BaruNetas4/status/1972208372830425542,https://x.com/IndoPopBase/status/1971784853810237597,0
2025-09-27 08:20:10+00:00,aripinkturtle,"Yg keracunan sebanyak itu tp gak ada yg d tuntut untuk bertanggung jawab.. subhanallah sekali yaa orang2 indon ini.. Buzzer 02 malah sebar hoax d Ig dengan bilang makan beracun gratis ini d sabotase..emang sekali setan, yaa gak bakal jadi manusia atw malaikat",1,0,0,443,https://x.com/aripinkturtle/status/1971852350240493777,https://x.com/IndoPopBase/status/1971784853810237597,1
2025-09-27 14:58:20+00:00,zahwacchan,Ini sudah separah ini apa gak mau demo lagi?,0,0,0,63,https://x.com/zahwacchan/status/1971952551584321578,https://x.com/IndoPopBase/status/1971784853810237597,0
2025-09-27 05:42:30+00:00,·,,0,0,0,502,https://x.com/amusingamused/status/1971812674892898575,https://x.com/IndoPopBase/status/1971784853810237597,0
2025-09-27 05:36:18+00:00,koukoseitantei,makan gratis sebagai kedok pemusnahan warga ini mah,0,0,0,191,https://x.com/koukoseitantei/status/1971811114406367276,https://x.com/IndoPopBase/status/1971784853810237597,0
2025-09-27 05:10:49+00:00,AnggaEhara,"Unreal innit'? 
@familiantlers",1,0,0,155,https://x.com/AnggaEhara/status/1971804701168751074,https://x.com/IndoPopBase/status/1971784853810237597,1
2025-09-27 04:56:43+00:00,pjssyg,udah sampe seribuan lebih orang gilak?? harus di berhentiin sih ini,0,0,0,65,https://x.com/pjssyg/status/1971801149805408543,https://x.com/IndoPopBase/status/1971784853810237597,0
2025-09-28 03:26:34+00:00,41n9maung,"@grok
 apa ini benar?",1,0,0,52,https://x.com/41n9maung/status/1972140852714913921,https://x.com/IndoPopBase/status/1971784853810237597,1
2025-09-28 02:20:14+00:00,fimalian,damn,0,0,0,21,https://x.com/fimalian/status/1972124160282579355,https://x.com/IndoPopBase/status/1971784853810237597,0
2025-09-27 03:56:32+00:00,Yeni_Puu,"Bgn bilang itu masih sedikit jumlah nya soalnya 4rb : 1miliar ya sangat sangat kecil. 

Mo nunggu korban ratusan ribu gitu kah pak?",0,0,0,263,https://x.com/Yeni_Puu/status/1971786005834567934,https://x.com/IndoPopBase/status/1971784853810237597,0
2025-09-27 04:56:34+00:00,ihopeyoufinetoo,Shame,0,0,0,95,https://x.com/ihopeyoufinetoo/status/1971801115537899560,https://x.com/IndoPopBase/status/1971784853810237597,0
2025-09-27 06:20:55+00:00,JavaJimmyMaukar,sudah kuduga,0,0,0,104,https://x.com/JavaJimmyMaukar/status/1971822340490383450,https://x.com/IndoPopBase/status/1971784853810237597,0
2025-09-27 04:13:02+00:00,jackthegon,"woy 
@prabowo
 gara gara ga pake sendok?",0,0,0,88,https://x.com/jackthegon/status/1971790156366827912,https://x.com/IndoPopBase/status/1971784853810237597,0
2025-09-27 03:59:35+00:00,AmberSaira95910,OMG,0,0,0,118,https://x.com/AmberSaira95910/status/1971786772339401026,https://x.com/IndoPopBase/status/1971784853810237597,0
2025-09-27 23:56:56+00:00,Th3Tr4vel3r,Makanan Beracun Gratis,0,0,0,172,https://x.com/Th3Tr4vel3r/status/1972088098550173851,https://x.com/IndoPopBase/status/1971784853810237597,0
2025-09-28 19:40:31+00:00,keyzeua,...,0,0,0,3,https://x.com/keyzeua/status/1972385953697382569,https://x.com/IndoPopBase/status/1971784853810237597,0
2025-09-27 04:16:29+00:00,sawadeeecat,at this point tetanggaku jg mungkin interview katseye nanti sore,0,4,0,2466,https://x.com/sawadeeecat/status/1971791027339202706,https://x.com/IndoPopBase/status/1971778755069989215,4
2025-09-27 04:03:44+00:00,soewarnozefanya,Hands off nunung,0,0,0,1766,https://x.com/soewarnozefanya/status/1971787816582762555,https://x.com/IndoPopBase/status/1971778755069989215,0
2025-09-27 03:28:25+00:00,AnnafiBG,"WOWKWKWKWK si Aul dimana2 jir, next interview siapa ye dia",0,0,0,2026,https://x.com/AnnafiBG/status/1971778928508612928,https://x.com/IndoPopBase/status/1971778755069989215,0
2025-09-27 04:44:59+00:00,KAMONEGlX,me watching this,0,0,0,926,https://x.com/KAMONEGlX/status/1971798200056271127,https://x.com/IndoPopBase/status/1971778755069989215,0
2025-09-27 09:15:18+00:00,INEYEKONS,,0,0,0,303,https://x.com/INEYEKONS/status/1971866225497223178,https://x.com/IndoPopBase/status/1971778755069989215,0
2025-09-27 05:37:44+00:00,asnianoy,Dikerjain sama Aul wkwkwk,0,0,0,1428,https://x.com/asnianoy/status/1971811472029401273,https://x.com/IndoPopBase/status/1971778755069989215,0
2025-09-27 03:49:47+00:00,pyuufl,WKWKW gakuat nontonnya njir malu,0,0,0,939,https://x.com/pyuufl/status/1971784308211044541,https://x.com/IndoPopBase/status/1971778755069989215,0
2025-09-27 03:53:58+00:00,eylviyu,GW GA BERENTI KETAWA NONTON INI,0,0,0,1820,https://x.com/eylviyu/status/1971785359991419246,https://x.com/IndoPopBase/status/1971778755069989215,0
2025-09-27 09:29:29+00:00,nyndasloth,Yaampuuun,0,0,0,212,https://x.com/nyndasloth/status/1971869796213104939,https://x.com/IndoPopBase/status/1971778755069989215,0
2025-09-28 06:11:43+00:00,geprekdinoo,AKWJSKWJWKE ANJING KTWA BGT,0,0,0,72,https://x.com/geprekdinoo/status/1972182412030628042,https://x.com/IndoPopBase/status/1971778755069989215,0
2025-09-27 11:13:36+00:00,mashihoursm,CAPE BGT ,0,0,0,206,https://x.com/mashihoursm/status/1971895998286012614,https://x.com/IndoPopBase/status/1971778755069989215,0
2025-09-28 07:08:13+00:00,Rynshhdj,Ngakak ,0,0,0,29,https://x.com/Rynshhdj/status/1972196630704390572,https://x.com/IndoPopBase/status/1971778755069989215,0
2025-09-27 03:30:23+00:00,enjoyouridebro,Respect aulia wkwk,0,0,0,778,https://x.com/enjoyouridebro/status/1971779424619212976,https://x.com/IndoPopBase/status/1971778755069989215,0
2025-09-27 08:28:58+00:00,·,Dalam rangka apa sih ini,0,0,0,364,https://x.com/T4KUT/status/1971854567785783667,https://x.com/IndoPopBase/status/1971778755069989215,0
2025-09-27 20:00:18+00:00,solamaxxing,srius nanya katseye base blem adakah,0,0,0,253,https://x.com/solamaxxing/status/1972028546718855293,https://x.com/IndoPopBase/status/1971778755069989215,0
2025-09-27 04:48:21+00:00,ralenionlaxus,ini beneran interview ya? kirain konten aul doank ,0,0,0,1017,https://x.com/ralenionlaxus/status/1971799044856205455,https://x.com/IndoPopBase/status/1971778755069989215,0
2025-09-27 11:08:29+00:00,BbyArii4,Ngakak Iah Sopiah,0,0,0,246,https://x.com/BbyArii4/status/1971894710492078401,https://x.com/IndoPopBase/status/1971778755069989215,0
2025-09-27 03:59:55+00:00,sonnakotojanai,hands off nunung ,0,0,0,829,https://x.com/sonnakotojanai/status/1971786858188382526,https://x.com/IndoPopBase/status/1971778755069989215,0
2025-09-27 04:42:11+00:00,The_cenobite99,,0,0,0,703,https://x.com/The_cenobite99/status/1971797493311852879,https://x.com/IndoPopBase/status/1971778755069989215,0
2025-09-27 03:51:11+00:00,·,yang sama emil juga ada,0,0,0,978,https://x.com/helfut/status/1971784660985463110,https://x.com/IndoPopBase/status/1971778755069989215,0
2025-09-27 03:55:00+00:00,kaffeamericano,Late as hell to repost but we cheer,0,0,0,1515,https://x.com/kaffeamericano/status/1971785621611196694,https://x.com/IndoPopBase/status/1971778755069989215,0
2025-09-27 04:07:44+00:00,Geezoy,,0,0,0,649,https://x.com/Geezoy/status/1971788825480561119,https://x.com/IndoPopBase/status/1971778755069989215,0
2025-10-01 15:24:54+00:00,·,WKWKWK ANYING AULIA,0,0,0,23,https://x.com/nonawaave/status/1973408792365953197,https://x.com/IndoPopBase/status/1971778755069989215,0
2025-09-27 23:58:47+00:00,Th3Tr4vel3r,ini beneran interview ? bukan gimmick ?,0,0,0,50,https://x.com/Th3Tr4vel3r/status/1972088560787640640,https://x.com/IndoPopBase/status/1971778755069989215,0
2025-09-27 03:39:40+00:00,AmberSaira95910,"So happy for you both!  Wishing you a lifetime full of love, joy, and unforgettable moments. ",0,0,0,555,https://x.com/AmberSaira95910/status/1971781760364302569,https://x.com/IndoPopBase/status/1971778755069989215,0
2025-09-27 04:12:48+00:00,VVYND,"Okay now we want her to interview the real Indonesian diaspora in NYC, not the ones that got to stay at Aman",1,85,0,42295,https://x.com/VVYND/status/1971790097868837092,https://x.com/IndoPopBase/status/1971776303956468165,86
2025-09-27 03:58:17+00:00,3usri,cinta kuya could never,3,15,0,20638,https://x.com/3usri/status/1971786445217313064,https://x.com/IndoPopBase/status/1971776303956468165,18
2025-09-27 04:38:48+00:00,gakgitudongpal,Serving face while supporting palestine is greedy  love u queen,0,10,0,36496,https://x.com/gakgitudongpal/status/1971796642132300242,https://x.com/IndoPopBase/status/1971776303956468165,10
2025-09-27 04:38:53+00:00,ndroe_,"rome, italy  ",2,65,0,15626,https://x.com/ndroe_/status/1971796662873215166,https://x.com/IndoPopBase/status/1971776303956468165,67
2025-09-27 04:19:05+00:00,Sobatpotomu,SERVING FACE AND JUSTICE,0,4,0,24704,https://x.com/Sobatpotomu/status/1971791679209509008,https://x.com/IndoPopBase/status/1971776303956468165,4
2025-09-27 04:01:05+00:00,sugar_6378,"Udalah cantik, pinter, empatinya tinggi.

Aduh idola aku banget kak najwa.",3,4,0,26518,https://x.com/sugar_6378/status/1971787152469209329,https://x.com/IndoPopBase/status/1971776303956468165,7
2025-09-27 05:33:32+00:00,mitzumore,"indogizen at tiktok : ""urusin negara sendiri mendingan""  suruh Presiden mu itulah yg urusin negara",1,6,0,12427,https://x.com/mitzumore/status/1971810418504225117,https://x.com/IndoPopBase/status/1971776303956468165,7
2025-09-27 03:45:44+00:00,SaddamWeb3,,0,0,0,16976,https://x.com/SaddamWeb3/status/1971783288416358834,https://x.com/IndoPopBase/status/1971776303956468165,0
2025-09-27 11:33:28+00:00,pamswakarsa_,"@NajwaShihab
 ",0,0,0,113,https://x.com/pamswakarsa_/status/1971900995606401132,https://x.com/IndoPopBase/status/1971776303956468165,0
2025-09-27 03:39:03+00:00,ONEW0LA,this gag,0,0,0,1117,https://x.com/ONEW0LA/status/1971781607347613773,https://x.com/IndoPopBase/status/1971776303956468165,0
2025-09-28 00:26:45+00:00,keringatan,"Najwa chants for Palestine, Prabroro charms Satanyahu.",0,0,0,310,https://x.com/keringatan/status/1972095599081402576,https://x.com/IndoPopBase/status/1971776303956468165,0
2025-09-27 16:02:55+00:00,Penduduk_RI,Jalanin ajaran agama dulu yg bener baru demo...,8,0,0,1349,https://x.com/Penduduk_RI/status/1971968807691509897,https://x.com/IndoPopBase/status/1971776303956468165,8
2025-09-28 15:15:34+00:00,surycyrus_,and still serving face..,0,0,0,48,https://x.com/surycyrus_/status/1972319277387780241,https://x.com/IndoPopBase/status/1971776303956468165,0
2025-09-28 09:51:22+00:00,ovyz_groovesick,"x.com/AzatAlsalim/st
…",0,0,0,64,https://x.com/ovyz_groovesick/status/1972237691627704403,https://x.com/IndoPopBase/status/1971776303956468165,0
2025-09-29 03:18:58+00:00,kuro_2013,Org Indonesia dgn mudahnya lupa sm dosa ini orang yg bahkan belom lewat tiga bulan.,0,0,0,24,https://x.com/kuro_2013/status/1972501325696172104,https://x.com/IndoPopBase/status/1971776303956468165,0
2025-09-27 06:34:52+00:00,ireneswarizona,eh tiba tiba banget dah di sana,0,0,0,20,https://x.com/ireneswarizona/status/1971825853018624182,https://x.com/IndoPopBase/status/1971776303956468165,0
2025-09-28 07:53:49+00:00,jsq_xxx,Beliau di monas dikedubs Amrik join jg ya? ruar biaza,0,0,0,55,https://x.com/jsq_xxx/status/1972208110153658781,https://x.com/IndoPopBase/status/1971776303956468165,0
2025-09-28 14:17:40+00:00,Tedi52033338,.,0,0,0,4,https://x.com/Tedi52033338/status/1972304708846137474,https://x.com/IndoPopBase/status/1971776303956468165,0
2025-09-27 04:19:37+00:00,PempekEater,Kelazz queen,0,0,0,971,https://x.com/PempekEater/status/1971791815398559992,https://x.com/IndoPopBase/status/1971776303956468165,0
2025-09-28 12:05:19+00:00,TaryudinR50890,Sehaat terus buat nana,0,0,0,21,https://x.com/TaryudinR50890/status/1972271401639055474,https://x.com/IndoPopBase/status/1971776303956468165,0
2025-09-28 13:26:28+00:00,takeamug,"udah ga underground lagi, ngikutin dulu waktu masih indie ",0,0,0,5,https://x.com/takeamug/status/1972291820240748784,https://x.com/IndoPopBase/status/1971776303956468165,0
2025-09-27 14:21:37+00:00,yan_lanes,langaung ke palestina aja,0,0,0,5251,https://x.com/yan_lanes/status/1971943312983838837,https://x.com/IndoPopBase/status/1971776303956468165,0
2025-09-27 07:03:41+00:00,akunmuid,kereennn banget mba nana,0,0,0,9523,https://x.com/akunmuid/status/1971833102936035672,https://x.com/IndoPopBase/status/1971776303956468165,0
2025-09-27 03:19:52+00:00,0xgasm,Ganyang Zionist!,0,0,0,8585,https://x.com/0xgasm/status/1971776779980611879,https://x.com/IndoPopBase/status/1971776303956468165,0
2025-09-27 08:00:54+00:00,worldhealed,Long life queen!,0,0,0,447,https://x.com/worldhealed/status/1971847501599928350,https://x.com/IndoPopBase/status/1971776303956468165,0
2025-09-27 03:22:43+00:00,Law_of_manifest,MBA NANA FTWW,0,0,0,18207,https://x.com/Law_of_manifest/status/1971777497370186199,https://x.com/IndoPopBase/status/1971776303956468165,0
2025-09-27 05:22:50+00:00,Rellavntz,she so mogged omg,0,0,0,378,https://x.com/Rellavntz/status/1971807723517018263,https://x.com/IndoPopBase/status/1971776303956468165,0
2025-09-27 20:59:42+00:00,DanielvdLeeuwen,Najwa who? ,0,0,0,20,https://x.com/DanielvdLeeuwen/status/1972043492911419706,https://x.com/IndoPopBase/status/1971776303956468165,0
2025-09-27 21:04:02+00:00,RFKMD,Selvi Ananda,0,0,0,68,https://x.com/RFKMD/status/1972044586265858330,https://x.com/IndoPopBase/status/1971776303956468165,0
2025-09-27 05:09:44+00:00,blessedurcurse,QUEEN,0,0,0,299,https://x.com/blessedurcurse/status/1971804427700130205,https://x.com/IndoPopBase/status/1971776303956468165,0
2025-09-29 01:07:06+00:00,darqmode,stun nya mna,0,0,0,14,https://x.com/darqmode/status/1972468141239533656,https://x.com/IndoPopBase/status/1971776303956468165,0
2025-09-27 12:51:36+00:00,Yaonlylovone,Who is this diva,0,0,0,125,https://x.com/Yaonlylovone/status/1971920657866015168,https://x.com/IndoPopBase/status/1971776303956468165,0
2025-09-27 15:05:26+00:00,vivdblu,DIVAAAAAAA,0,0,0,188,https://x.com/vivdblu/status/1971954338127138830,https://x.com/IndoPopBase/status/1971776303956468165,0
2025-09-27 10:25:37+00:00,risolalaska,Demo pun cool dan nonchalant gituu bikin bergetarr ,0,0,0,231,https://x.com/risolalaska/status/1971883920594817502,https://x.com/IndoPopBase/status/1971776303956468165,0
2025-09-27 10:51:02+00:00,Chrysantika19,"Udah lama gak liat mbak Nana, ternyata kurusan ya ",0,0,0,216,https://x.com/Chrysantika19/status/1971890320238694741,https://x.com/IndoPopBase/status/1971776303956468165,0
2025-09-27 08:44:30+00:00,gilang_febrians,Mukanya warlok banget,0,0,0,242,https://x.com/gilang_febrians/status/1971858476248043614,https://x.com/IndoPopBase/status/1971776303956468165,0
2025-09-28 12:37:16+00:00,tomatogirls00,my istri gua tuh,0,0,0,41,https://x.com/tomatogirls00/status/1972279440895045652,https://x.com/IndoPopBase/status/1971776303956468165,0
2025-09-27 13:14:04+00:00,mochramdhani24,"@prabowo
 ?",0,0,0,73,https://x.com/mochramdhani24/status/1971926314501501296,https://x.com/IndoPopBase/status/1971776303956468165,0
2025-09-28 22:50:57+00:00,messywidjaja,She’s fearless as always!!,0,0,0,22,https://x.com/messywidjaja/status/1972433877290619005,https://x.com/IndoPopBase/status/1971776303956468165,0
2025-09-27 04:54:18+00:00,noirettemoire,queen,0,0,0,969,https://x.com/noirettemoire/status/1971800543833256288,https://x.com/IndoPopBase/status/1971776303956468165,0
2025-09-28 10:32:11+00:00,skyundocean,March for Palestine but not for Indonesia? Really?,0,0,0,204,https://x.com/skyundocean/status/1972247964019200394,https://x.com/IndoPopBase/status/1971776303956468165,0
2025-09-28 04:29:58+00:00,tieamor,makin cantik ih,0,0,0,17,https://x.com/tieamor/status/1972156807432098274,https://x.com/IndoPopBase/status/1971776303956468165,0
2025-09-27 07:50:39+00:00,mysgzl,yasss that serving face,0,0,0,263,https://x.com/mysgzl/status/1971844922321064361,https://x.com/IndoPopBase/status/1971776303956468165,0
2025-09-27 23:06:09+00:00,HandarReyWang,Strategi bwt naikin namanya lg wkwk,0,0,0,204,https://x.com/HandarReyWang/status/1972075315108483191,https://x.com/IndoPopBase/status/1971776303956468165,0
2025-09-27 08:30:27+00:00,TaniaAn15579553,,0,0,0,144,https://x.com/TaniaAn15579553/status/1971854941167014069,https://x.com/IndoPopBase/status/1971776303956468165,0
2025-09-28 12:53:12+00:00,pppuleee,rodok ra terlalu gumun karo mbak nana wesan bro,0,0,0,88,https://x.com/pppuleee/status/1972283451392057367,https://x.com/IndoPopBase/status/1971776303956468165,0
2025-09-29 06:02:18+00:00,ndlg0x,Meh,0,0,0,9,https://x.com/ndlg0x/status/1972542432287113329,https://x.com/IndoPopBase/status/1971776303956468165,0
2025-09-27 06:32:44+00:00,mocoy69,Mba Nana kek bule,0,0,0,504,https://x.com/mocoy69/status/1971825314281164887,https://x.com/IndoPopBase/status/1971776303956468165,0
2025-09-27 15:18:53+00:00,b6dmenn,Tek ra nyawang nek negorone dewe yo koyo ngene,0,0,0,174,https://x.com/b6dmenn/status/1971957724658467275,https://x.com/IndoPopBase/status/1971776303956468165,0
2025-09-27 08:57:56+00:00,polo_classic88,deportation on the way,0,0,0,226,https://x.com/polo_classic88/status/1971861854650839491,https://x.com/IndoPopBase/status/1971776303956468165,0
2025-09-26 13:24:58+00:00,bareda,Pantesan Brimob makin beringas,0,0,0,393,https://x.com/bareda/status/1971566669475852293,https://x.com/IndoPopBase/status/1971560239137992934,0
2025-09-26 13:06:14+00:00,manesnoire,Menarik,0,0,0,3,https://x.com/manesnoire/status/1971561956248314014,https://x.com/IndoPopBase/status/1971560239137992934,0
2025-09-26 13:01:15+00:00,Law_of_manifest,Look like a thriller  music was  little... Spoiler alert,0,0,0,628,https://x.com/Law_of_manifest/status/1971560702323384398,https://x.com/IndoPopBase/status/1971560239137992934,0
2025-09-26 13:01:15+00:00,PROSPERDEGREAT,Big names are all in one film,0,0,0,454,https://x.com/PROSPERDEGREAT/status/1971560701232849300,https://x.com/IndoPopBase/status/1971560239137992934,0
2025-09-26 13:00:42+00:00,PROSPERDEGREAT,Stacked cast. I'm curious to see if the story can match the lineup.,0,0,0,686,https://x.com/PROSPERDEGREAT/status/1971560562837664195,https://x.com/IndoPopBase/status/1971560239137992934,0
2025-09-26 17:36:41+00:00,ferizast,waw,0,0,0,289,https://x.com/ferizast/status/1971630016871145488,https://x.com/IndoPopBase/status/1971560239137992934,0
2025-09-26 13:10:09+00:00,queerempath,oohh... interesting. semoga bagus,0,0,0,595,https://x.com/queerempath/status/1971562939472924812,https://x.com/IndoPopBase/status/1971560239137992934,0
2025-09-26 13:16:29+00:00,BearryBlush,orang itu tulisannya jelas2 masih teaser,0,0,0,788,https://x.com/BearryBlush/status/1971564534247858454,https://x.com/IndoPopBase/status/1971560239137992934,0
2025-09-28 00:00:38+00:00,Th3Tr4vel3r,ini teaser apa trailer ya ?,0,0,0,47,https://x.com/Th3Tr4vel3r/status/1972089026485407967,https://x.com/IndoPopBase/status/1971560239137992934,0
2025-09-26 08:19:36+00:00,SistersInDanger,"The queen is right tho. 
They’re handed a so-called free lunch (that doesn’t improve nutrition & has even caused food poisoning), but unfortunately, we are the ones who will pay dearly in the future through declining education quality. ",0,16,0,5520,https://x.com/SistersInDanger/status/1971489820309586375,https://x.com/IndoPopBase/status/1971475105239994721,16
2025-09-26 08:27:35+00:00,zingwind,"Gw prediksi, akan muncul pendapat2 kayak ""disyukuri aja, bagi orang kecil produk minimarket itu udah mewah"". atau ""produk minimarket tidak mudah basi"".

Halah.",2,19,0,6589,https://x.com/zingwind/status/1971491828663976222,https://x.com/IndoPopBase/status/1971475105239994721,21
2025-09-26 08:54:46+00:00,ndroe_,solusi yg tepat untuk menekan biaya,0,41,0,7311,https://x.com/ndroe_/status/1971498669288657191,https://x.com/IndoPopBase/status/1971475105239994721,41
2025-09-26 07:23:26+00:00,SaddamWeb3,"real gak nih 
@grok
 
2026 anggaran mbg naik",1,0,0,3702,https://x.com/SaddamWeb3/status/1971475685689655720,https://x.com/IndoPopBase/status/1971475105239994721,1
2025-09-26 07:23:30+00:00,jawaberat,"This is mot a diva, this is kanjeng ratu",0,4,0,3576,https://x.com/jawaberat/status/1971475703389618676,https://x.com/IndoPopBase/status/1971475105239994721,4
2025-09-26 07:45:20+00:00,serenamiades,a DIVA indeed,1,14,0,7544,https://x.com/serenamiades/status/1971481195830784282,https://x.com/IndoPopBase/status/1971475105239994721,15
2025-09-26 07:28:10+00:00,yddadog,,0,7,0,5025,https://x.com/yddadog/status/1971476876947505308,https://x.com/IndoPopBase/status/1971475105239994721,7
2025-09-26 15:18:42+00:00,Regiefelicia,Nih baru mbg,0,1,0,448,https://x.com/Regiefelicia/status/1971595289896321123,https://x.com/IndoPopBase/status/1971475105239994721,1
2025-09-26 07:24:34+00:00,PROSPERDEGREAT,That line is brutal but kinda true,0,0,0,454,https://x.com/PROSPERDEGREAT/status/1971475972580049362,https://x.com/IndoPopBase/status/1971475105239994721,0
2025-09-26 18:17:43+00:00,cityleng,"carut maruttttt. program p0pulis tapi plot twist pas udah realisasi

RIP education budget. let's be aware of common sense.",0,0,0,559,https://x.com/cityleng/status/1971640341125279798,https://x.com/IndoPopBase/status/1971475105239994721,0
2025-09-26 09:53:09+00:00,WardhaniIk72622,"Bukkkkk, semoga selalu diberikan keselamatan dan keamanan oleh Allah, ya

Btw self control ibuk ini keren banget. Kalau aku, udah aku balik mejanya ",0,0,0,1196,https://x.com/WardhaniIk72622/status/1971513364355666187,https://x.com/IndoPopBase/status/1971475105239994721,0
2025-09-26 07:53:59+00:00,guntarawahyu805,Memang dibikin bego,0,0,0,382,https://x.com/guntarawahyu805/status/1971483374817771917,https://x.com/IndoPopBase/status/1971475105239994721,0
2025-09-29 09:30:04+00:00,Billy_Naravit,"Preach 
Jangan mau dikasih makanan kemasan, mana bergizinya itu snack",0,0,0,369,https://x.com/Billy_Naravit/status/1972594719227318654,https://x.com/IndoPopBase/status/1971475105239994721,0
2025-10-01 15:12:18+00:00,riggcorta,"Kalau benar peduli anak bangsa, ya perbaiki programnya, bukan dimatikan. Anak-anak butuh gizi, bukan janji. #LanjutkanMBG",0,0,0,13,https://x.com/riggcorta/status/1973405621480534224,https://x.com/IndoPopBase/status/1971475105239994721,0
2025-09-26 18:59:52+00:00,titoku,1.2T perhari duit rakyat sia sia,0,0,0,358,https://x.com/titoku/status/1971650949707190643,https://x.com/IndoPopBase/status/1971475105239994721,0
2025-09-26 08:21:46+00:00,estelersatu,as she should,0,0,0,328,https://x.com/estelersatu/status/1971490367045562415,https://x.com/IndoPopBase/status/1971475105239994721,0
2025-09-26 08:34:05+00:00,thisisnthat,protect this dica,0,0,0,377,https://x.com/thisisnthat/status/1971493467298857192,https://x.com/IndoPopBase/status/1971475105239994721,0
2025-09-27 01:47:19+00:00,TejaAru05798875,A queen she is,0,0,0,101,https://x.com/TejaAru05798875/status/1971753487232127250,https://x.com/IndoPopBase/status/1971475105239994721,0
2025-09-26 15:48:50+00:00,nyamukbtina,Queen,0,0,0,238,https://x.com/nyamukbtina/status/1971602875760644335,https://x.com/IndoPopBase/status/1971475105239994721,0
2025-09-26 11:29:43+00:00,dtstvrb,pasti anak abah,0,0,0,360,https://x.com/dtstvrb/status/1971537664492130333,https://x.com/IndoPopBase/status/1971475105239994721,0
2025-09-27 03:44:49+00:00,samsulgalaxys21,Oh she's in full throttle ,0,0,0,183,https://x.com/samsulgalaxys21/status/1971783057020694814,https://x.com/IndoPopBase/status/1971475105239994721,0
2025-09-26 09:10:39+00:00,farhm_,don't forget your crown queen,0,0,0,605,https://x.com/farhm_/status/1971502666972025336,https://x.com/IndoPopBase/status/1971475105239994721,0
2025-09-26 12:01:35+00:00,heheheiyuU,diva,0,0,0,124,https://x.com/heheheiyuU/status/1971545684219482222,https://x.com/IndoPopBase/status/1971475105239994721,0
2025-09-26 10:55:35+00:00,·,Say it louder ,0,0,0,416,https://x.com/lostacker/status/1971529075291533519,https://x.com/IndoPopBase/status/1971475105239994721,0
2025-09-26 07:52:58+00:00,quattttrobajina,SHE ATE,0,0,0,70,https://x.com/quattttrobajina/status/1971483117526700072,https://x.com/IndoPopBase/status/1971475105239994721,0
2025-09-26 07:41:39+00:00,moodzfix,CLOCK IT,0,0,0,845,https://x.com/moodzfix/status/1971480272127525338,https://x.com/IndoPopBase/status/1971475105239994721,0
2025-09-26 07:43:45+00:00,doomdadda,Kweeen,0,0,0,731,https://x.com/doomdadda/status/1971480800957985191,https://x.com/IndoPopBase/status/1971475105239994721,0
2025-09-26 09:59:09+00:00,orangeybee,who's this DIVAAA ,0,0,0,286,https://x.com/orangeybee/status/1971514874489643152,https://x.com/IndoPopBase/status/1971475105239994721,0
2025-09-26 09:09:33+00:00,AlbannaMH,,0,0,0,189,https://x.com/AlbannaMH/status/1971502392110903308,https://x.com/IndoPopBase/status/1971475105239994721,0
2025-09-26 09:46:43+00:00,Flashdllah,protect the queen at any cost.⚘,0,0,0,1018,https://x.com/Flashdllah/status/1971511743752089849,https://x.com/IndoPopBase/status/1971475105239994721,0
2025-09-26 07:54:11+00:00,amewakasa,PERIOD,0,0,0,513,https://x.com/amewakasa/status/1971483423928877128,https://x.com/IndoPopBase/status/1971475105239994721,0
2025-09-26 08:08:45+00:00,hizkiyeahhh,cooke,0,0,0,1038,https://x.com/hizkiyeahhh/status/1971487088693665917,https://x.com/IndoPopBase/status/1971475105239994721,0
2025-09-26 12:38:08+00:00,tweetyyypieee,sehat selalu panjang umur dok. semoga dilindungi dmnpun berada,0,0,0,456,https://x.com/tweetyyypieee/status/1971554883812913580,https://x.com/IndoPopBase/status/1971475105239994721,0
2025-09-26 08:55:27+00:00,leondincht,Queen spit FACTS only!,0,0,0,125,https://x.com/leondincht/status/1971498843029262797,https://x.com/IndoPopBase/status/1971475105239994721,0
2025-09-26 12:05:53+00:00,_denjul,Our queen ,0,0,0,308,https://x.com/_denjul/status/1971546765800374609,https://x.com/IndoPopBase/status/1971475105239994721,0
2025-09-26 08:28:02+00:00,0xbadrus,banger,0,0,0,105,https://x.com/0xbadrus/status/1971491944124776819,https://x.com/IndoPopBase/status/1971475105239994721,0
2025-09-26 08:13:01+00:00,philipdj,Speakkk louderrr madaamm!,0,0,0,316,https://x.com/philipdj/status/1971488164092223652,https://x.com/IndoPopBase/status/1971475105239994721,0
2025-09-28 12:23:05+00:00,RianRintikHujan,Insane middle name btw,0,0,0,61,https://x.com/RianRintikHujan/status/1972275871148110307,https://x.com/IndoPopBase/status/1971475105239994721,0
2025-09-26 08:57:57+00:00,younevahevah,"Saya rasa mereka bersyukurnya karena risiko keracunan minim, Bu. Di satu sisi emang uang anggaran digelapkan.",0,0,0,1708,https://x.com/younevahevah/status/1971499471461867623,https://x.com/IndoPopBase/status/1971475105239994721,0
2025-09-26 07:30:57+00:00,mayzzystar,clock it,0,0,0,905,https://x.com/mayzzystar/status/1971477578079945140,https://x.com/IndoPopBase/status/1971475105239994721,0
2025-09-26 10:37:49+00:00,ursteulyNaveen,Dr. Tan’s words hit hard  Education cuts today only guarantee ignorance tomorrow. A nation can’t grow if its people are kept uneducated. ,0,0,0,137,https://x.com/ursteulyNaveen/status/1971524605677596985,https://x.com/IndoPopBase/status/1971475105239994721,0
2025-09-30 05:49:52+00:00,theopils,Makanan Berbahaya Gratis dilanjut terusss...,0,0,0,23,https://x.com/theopils/status/1972901691667423476,https://x.com/IndoPopBase/status/1971475105239994721,0
2025-09-26 09:38:04+00:00,deepublishstore,"I like her 
x.com/deepublishstor
…",0,0,0,112,https://x.com/deepublishstore/status/1971509569416503552,https://x.com/IndoPopBase/status/1971475105239994721,0
2025-09-26 07:25:37+00:00,Seung_ha_,"@grok
 What did Dr. Tan Shot Yen say about MBG’s education budget cut in the 2026 APBN?",1,0,0,1136,https://x.com/Seung_ha_/status/1971476233847513327,https://x.com/IndoPopBase/status/1971475105239994721,1
2025-10-01 10:25:19+00:00,Chabil4_02,Pendidikan tetap jalan normal meski MBG juga jalan dan terus nambah penerimanya. #LanjutkanMBG,0,0,0,10,https://x.com/Chabil4_02/status/1973333396496777429,https://x.com/IndoPopBase/status/1971475105239994721,0
2025-10-02 08:10:39+00:00,westterrace2200,"Perkiraan sy ujungnya adalah MBG yg adalah Makanan (sintetis) nya Bill Gates.
Mungkin nanti '' ahli2 gizinya (tentunya satu paket dg sertifikasi milik si yg empunya 'program')  yg mungkin jg ahli serangga.
Cerita bersambungnya : awas daging sapi berbahaya",0,0,0,16,https://x.com/westterrace2200/status/1973661894612492775,https://x.com/IndoPopBase/status/1971475105239994721,0
2025-09-26 07:33:07+00:00,JKJeonNSeagull,"Udah pada tau belum ya kalau MBG ini bisnis franchise? Saya juga baru tau lihat akun facebook yg ternyata cuma modal ruko aja dan uang 600jt siapa aja bisa. Ibarat jualan ini laku tiap hari karna udah ada pembeli pasti. 

Negara apa ini",1,3,0,330,https://x.com/JKJeonNSeagull/status/1971478123851272288,https://x.com/IndoPopBase/status/1971475105239994721,4
2025-09-29 00:04:27+00:00,WongF3hung,,0,0,0,12,https://x.com/WongF3hung/status/1972452374225866816,https://x.com/IndoPopBase/status/1971475105239994721,0
2025-09-26 08:51:48+00:00,deethemedia,wkwkk jogetin aja ,0,0,0,79,https://x.com/deethemedia/status/1971497926330601759,https://x.com/IndoPopBase/status/1971475105239994721,0
2025-09-26 07:52:42+00:00,NotDogss,And more and more smart people are greedy for the state budget,0,0,0,169,https://x.com/NotDogss/status/1971483053152460898,https://x.com/IndoPopBase/status/1971475105239994721,0
2025-09-26 06:42:29+00:00,SaddamWeb3,Dinas Perhubungan (Dishub) Provinsi DKI Jakarta memberikan klarifikasi terkait penindakan kendaraan yang dikendarai oleh Entis Sutisna (Sule) dalam kegiatan Operasi Lintas Jaya yang berlangsung baru-baru ini.,0,2,0,12014,https://x.com/SaddamWeb3/status/1971465382029557835,https://x.com/IndoPopBase/status/1971463479887528010,2
2025-09-26 06:37:57+00:00,PROSPERDEGREAT,Jujur malah keliatan lebih sopan drpd kebanyakan orang kalo ditilang .,0,1,0,10927,https://x.com/PROSPERDEGREAT/status/1971464241665466756,https://x.com/IndoPopBase/status/1971463479887528010,1
2025-09-26 09:01:41+00:00,okezonenews,Ini Sebabnya Sule Ditilang Petugas Dishub Jakarta,0,0,0,5806,https://x.com/okezonenews/status/1971500412894367814,https://x.com/IndoPopBase/status/1971463479887528010,0
2025-09-26 06:52:50+00:00,TonuStudio,aspek komedinya dimana? that is very serious thought light mannered,0,1,0,7592,https://x.com/TonuStudio/status/1971467987359236280,https://x.com/IndoPopBase/status/1971463479887528010,1
2025-09-26 07:22:47+00:00,helloseakun,"kapan ya ketilang itu berhenti memakan waktu, tenaga, pikiran, dan uang? ckp satu aja plis yg diambil jgn smua",2,1,0,10185,https://x.com/helloseakun/status/1971475520996143581,https://x.com/IndoPopBase/status/1971463479887528010,3
2025-09-26 06:35:39+00:00,JavaJimmyMaukar,"Woi dia ini lagi sakit dan butuh perawatan juga, malah diberhentikan di tengah jalan",1,0,0,11403,https://x.com/JavaJimmyMaukar/status/1971463662725730442,https://x.com/IndoPopBase/status/1971463479887528010,1
2025-09-26 07:04:27+00:00,AArul28,apaan dah kolom reply nya,0,0,0,4514,https://x.com/AArul28/status/1971470909388239311,https://x.com/IndoPopBase/status/1971463479887528010,0
2025-09-26 06:39:33+00:00,PROSPERDEGREAT,Sule turning even a traffic stop into comedy gold  dude can’t switch it off.,0,0,0,7488,https://x.com/PROSPERDEGREAT/status/1971464640606658933,https://x.com/IndoPopBase/status/1971463479887528010,0
2025-09-26 22:53:56+00:00,B4n6_H4n5,"Diluar Jawa, itu sih kendaraan operasional untuk kelapangan... 
Atau kendaraan untuk ke Ladang...",0,0,0,729,https://x.com/B4n6_H4n5/status/1971709853241692412,https://x.com/IndoPopBase/status/1971463479887528010,0
2025-09-26 09:46:39+00:00,MamatSuganTeh,"di STNK kecantumnya apa? atau pas lagi lewat lagi bawa barang banyak? kalau di STNK double cabinnya kecantum kendaraan pribadi ya ga perlu KIR, kalau kecantumnya mobil barang. ya apes aja.",2,0,0,6618,https://x.com/MamatSuganTeh/status/1971511728535208102,https://x.com/IndoPopBase/status/1971463479887528010,2
2025-09-26 06:38:39+00:00,PROSPERDEGREAT,"Jawaban Sule selalu bikin ketawa, bahkan pas ditilang tetep bisa jadi bahan komedi .",2,0,0,5037,https://x.com/PROSPERDEGREAT/status/1971464417842954458,https://x.com/IndoPopBase/status/1971463479887528010,2
2025-09-27 05:45:46+00:00,sotoboyol,"Aturan tolol emang, mangkanya double kabin gak laku di Indonesia. Di suruh kir padahal semua juga tau hasil kir gimana, truk aja ancur pada bebas jalan dan lulus kir. Harusnya double kabin ga perlu kir, emang aturan purba sih harusnya di update, susah kalau menguntungkan oknum",0,0,0,571,https://x.com/sotoboyol/status/1971813495546302698,https://x.com/IndoPopBase/status/1971463479887528010,0
2025-09-26 10:33:27+00:00,ursteulyNaveen,Sule always knows how to turn even a traffic stop into comedy gold  Respect for keeping it real while making everyone laugh!,0,0,0,1668,https://x.com/ursteulyNaveen/status/1971523505691955645,https://x.com/IndoPopBase/status/1971463479887528010,0
2025-09-26 06:53:24+00:00,akhirpekansans,Awas ada suleeeee,0,0,0,240,https://x.com/akhirpekansans/status/1971468128082399274,https://x.com/IndoPopBase/status/1971463479887528010,0
2025-09-26 06:58:53+00:00,sampemagrib,Awas ada suleeee,0,0,0,94,https://x.com/sampemagrib/status/1971469507404476790,https://x.com/IndoPopBase/status/1971463479887528010,0
2025-09-26 07:06:28+00:00,_tojay,"jadi kalo anda punya mobil pribadi yang berbentuk truk, anda bayar 2 pajak dalam 1 tahun",1,0,0,4363,https://x.com/_tojay/status/1971471417628922142,https://x.com/IndoPopBase/status/1971463479887528010,1
2025-09-26 06:40:10+00:00,Law_of_manifest,"Hey, he's sick and needs treatment too, but he was stopped in the middle of the road.",0,0,0,2944,https://x.com/Law_of_manifest/status/1971464798224413158,https://x.com/IndoPopBase/status/1971463479887528010,0
2025-09-26 15:22:29+00:00,_rairawan,"Sebentar, dishub boleh nilang?",1,0,0,2854,https://x.com/_rairawan/status/1971596243341349093,https://x.com/IndoPopBase/status/1971463479887528010,1
2025-09-26 07:14:08+00:00,torifanraf,Ini Sule bawa truk angkut barang apa gmana kok harus bawa kir?,1,0,0,12994,https://x.com/torifanraf/status/1971473345603567927,https://x.com/IndoPopBase/status/1971463479887528010,1
2025-09-26 06:39:36+00:00,Seung_ha_,"Who stopped comedian Sule for a missing KIR? 
@grok",1,0,0,3775,https://x.com/Seung_ha_/status/1971464655920119834,https://x.com/IndoPopBase/status/1971463479887528010,1
2025-09-26 06:35:11+00:00,JavaJimmyMaukar,,0,0,0,5561,https://x.com/JavaJimmyMaukar/status/1971463545314550026,https://x.com/IndoPopBase/status/1971463479887528010,0
2025-09-26 08:51:23+00:00,deethemedia,Mantap kang Sule ahaa ,0,0,0,887,https://x.com/deethemedia/status/1971497820894196072,https://x.com/IndoPopBase/status/1971463479887528010,0
2025-09-26 05:07:23+00:00,SaddamWeb3,king prab geram karena masih banyak ditemui pertambangan ilegal di dalam negeri hingga penyelundupan emas.,1,0,0,373,https://x.com/SaddamWeb3/status/1971441448588562925,https://x.com/IndoPopBase/status/1971439988681343240,1
2025-09-26 06:20:44+00:00,B4n6_H4n5,"Eksploitasi terus, 
Sampai 447 Pulau itu habis/hilang... 
Gosah mikirin Kerusakan lingkungan, hilangnya keindahan alam, Kuno itu... 
Yang Penting Cuan masuk Terus dan rekening gendut terus... 
BANG**T....!!!",0,5,0,691,https://x.com/B4n6_H4n5/status/1971459907040968755,https://x.com/IndoPopBase/status/1971439988681343240,5
2025-09-26 05:04:18+00:00,Washyourkiss,Let me guess this gremlin behind all of that.,1,0,0,416,https://x.com/Washyourkiss/status/1971440672768168150,https://x.com/IndoPopBase/status/1971439988681343240,1
2025-09-26 05:33:55+00:00,BANANAKAKUMEl,semoga besok sabtu negara ini bubar aamiin,1,0,0,300,https://x.com/BANANAKAKUMEl/status/1971448124196651470,https://x.com/IndoPopBase/status/1971439988681343240,1
2025-09-26 05:09:04+00:00,_Matahari_senja,"Padahal pasal 35 UU No 27 Tahun 2007 Tentang pengelolaan wilayah pesisir dan Pulau-pulau kecil, 'pulau kecil harus bebas dari segala izin pertambangan'

Sayang bgt view sebagus ini klo diizinin ada tambang² yg ga bertanggung jawab bisa² ya rusak",0,1,0,134,https://x.com/_Matahari_senja/status/1971441872938979514,https://x.com/IndoPopBase/status/1971439988681343240,1
2025-09-26 05:22:33+00:00,unanevesoffice,Gimana kl minggu depan kita kiamat aja,0,0,0,340,https://x.com/unanevesoffice/status/1971445265061351931,https://x.com/IndoPopBase/status/1971439988681343240,0
2025-09-26 05:02:47+00:00,ursteulyNaveen,226 mining permits for 477 small islands… that sounds like a recipe for environmental disaster.,0,0,0,753,https://x.com/ursteulyNaveen/status/1971440289471664476,https://x.com/IndoPopBase/status/1971439988681343240,0
2025-09-26 06:19:28+00:00,PROSPERDEGREAT,That’s basically one mining site for every two islands. There is no way that doesn’t wreck ecosystems long term.,0,0,0,613,https://x.com/PROSPERDEGREAT/status/1971459588148105288,https://x.com/IndoPopBase/status/1971439988681343240,0
2025-09-27 04:30:09+00:00,matamantra,bahlil kontol,0,0,0,66,https://x.com/matamantra/status/1971794466681094333,https://x.com/IndoPopBase/status/1971439988681343240,0
2025-09-27 02:31:43+00:00,richauntyy09,Hadehh kerjaan bahlil nih,0,0,0,37,https://x.com/richauntyy09/status/1971764661864616180,https://x.com/IndoPopBase/status/1971439988681343240,0
2025-09-26 06:35:14+00:00,GrowWithSeno,"226 mining permits across 477 small islands. At this point, it’s not exploration—it’s exhaustion. Nature deserves better than being treated like a checklist.",0,0,0,256,https://x.com/GrowWithSeno/status/1971463554529415308,https://x.com/IndoPopBase/status/1971439988681343240,0
2025-09-26 05:58:32+00:00,roweeasley,"Keruk aja terus anjir sampe bumi marah sendiri, bukannya dijaga malah dijarah dan dieksploitasi terus. Ya tuhan, jahat banget.",0,0,0,274,https://x.com/roweeasley/status/1971454322346205264,https://x.com/IndoPopBase/status/1971439988681343240,0
2025-09-28 09:08:40+00:00,nisaL00,,0,0,0,6,https://x.com/nisaL00/status/1972226942901608609,https://x.com/IndoPopBase/status/1971439988681343240,0
2025-09-26 05:01:55+00:00,JavaJimmyMaukar,"@susipudjiastuti
 bu liat bu",0,0,0,297,https://x.com/JavaJimmyMaukar/status/1971440070315171868,https://x.com/IndoPopBase/status/1971439988681343240,0
2025-09-26 08:52:13+00:00,deethemedia,"Indonesia indah, sayang kebanyakan pejabatnya kek kon...",1,0,0,81,https://x.com/deethemedia/status/1971498027497201830,https://x.com/IndoPopBase/status/1971439988681343240,1
2025-09-26 05:02:02+00:00,airdrop_goe,Indah bangt,0,0,0,188,https://x.com/airdrop_goe/status/1971440100568596932,https://x.com/IndoPopBase/status/1971439988681343240,0
2025-09-26 07:53:04+00:00,WESTSlDEST0RY,STREAM SHABRINA LEANOR - SEMBUH KEMBALI YALL,0,9,0,1266,https://x.com/WESTSlDEST0RY/status/1971483144114344309,https://x.com/IndoPopBase/status/1971427689253962192,9
2025-09-26 04:25:24+00:00,berrybeomony,"Just adding Yovie Widianto, Andi Rianto, Rony Parulian — Salahi Aku (Ku Jatuh Cinta Lagi) in your list",0,0,0,1439,https://x.com/berrybeomony/status/1971430883426181277,https://x.com/IndoPopBase/status/1971427689253962192,0
2025-09-26 07:57:19+00:00,aaspotifynation,GALAU FINAL BOSS,0,2,0,241,https://x.com/aaspotifynation/status/1971484213611557349,https://x.com/IndoPopBase/status/1971427689253962192,2
2025-09-26 04:57:59+00:00,blckwdwd,"yovie widianto x andi rianto x rony parulian - Salahi Aku, masuknya minggu kemarin apa minggu ini ? mereka rilis hari minggu kemarin",0,0,0,944,https://x.com/blckwdwd/status/1971439084188074161,https://x.com/IndoPopBase/status/1971427689253962192,0
2025-09-26 18:36:36+00:00,jay_rockstar000,On to something,0,0,0,19,https://x.com/jay_rockstar000/status/1971645092948857122,https://x.com/IndoPopBase/status/1971427689253962192,0
2025-09-26 09:14:34+00:00,KDessty,Shabrina Leanor - Sembuh Kembali,0,0,0,165,https://x.com/KDessty/status/1971503651845013634,https://x.com/IndoPopBase/status/1971427689253962192,0
2025-09-26 04:43:42+00:00,EVM0x_nads,otw dengerin ,0,0,0,886,https://x.com/EVM0x_nads/status/1971435486364479562,https://x.com/IndoPopBase/status/1971427689253962192,0
2025-09-26 06:16:27+00:00,PROSPERDEGREAT,Temper Trap dropping new music out of nowhere is the real surprise on that list,0,0,0,874,https://x.com/PROSPERDEGREAT/status/1971458830954614881,https://x.com/IndoPopBase/status/1971427689253962192,0
2025-09-26 04:14:08+00:00,Law_of_manifest,mariah queen of r&b ,0,0,0,320,https://x.com/Law_of_manifest/status/1971428048059900252,https://x.com/IndoPopBase/status/1971427689253962192,0
2025-09-26 06:48:36+00:00,saintmaranello,WHITE CHORUS ALL THE WAYYYYYUUHHH,0,0,0,203,https://x.com/saintmaranello/status/1971466920349270455,https://x.com/IndoPopBase/status/1971427689253962192,0
2025-09-26 06:12:53+00:00,outlieerrr,white chorus enak enak nih isinya,0,0,0,243,https://x.com/outlieerrr/status/1971457932652052768,https://x.com/IndoPopBase/status/1971427689253962192,0
2025-09-26 09:42:42+00:00,iytich,Music released last week. This music will takes us to 2000’s vibes,0,0,0,117,https://x.com/iytich/status/1971510731775598600,https://x.com/IndoPopBase/status/1971427689253962192,0
2025-09-26 05:30:55+00:00,nino_fredi,"@vvhitechorus
 istimewa sih",0,0,0,186,https://x.com/nino_fredi/status/1971447368613802375,https://x.com/IndoPopBase/status/1971427689253962192,0
2025-09-26 05:39:49+00:00,tariqmaaang,Yg suisei asik juga,0,0,0,212,https://x.com/tariqmaaang/status/1971449610641211823,https://x.com/IndoPopBase/status/1971427689253962192,0
2025-09-26 04:40:42+00:00,mailvelous,wah banyak yg gw suka sepertinya,0,0,0,196,https://x.com/mailvelous/status/1971434731716870548,https://x.com/IndoPopBase/status/1971427689253962192,0
2025-09-26 05:10:09+00:00,SINGKITMYLUV,STREAM DEVAKI,0,0,0,130,https://x.com/SINGKITMYLUV/status/1971442145816084875,https://x.com/IndoPopBase/status/1971427689253962192,0
2025-09-26 04:38:03+00:00,protprotttt,Vanessa zee — Berkaca-kaca,0,0,0,334,https://x.com/protprotttt/status/1971434067146178689,https://x.com/IndoPopBase/status/1971427689253962192,0
2025-09-26 05:24:54+00:00,moodjianto,and JKT48?,1,0,0,321,https://x.com/moodjianto/status/1971445855157879122,https://x.com/IndoPopBase/status/1971427689253962192,1
2025-09-26 04:13:02+00:00,JavaJimmyMaukar,forvermoreeeeee,0,0,0,445,https://x.com/JavaJimmyMaukar/status/1971427768719290435,https://x.com/IndoPopBase/status/1971427689253962192,0
2025-09-26 04:35:13+00:00,3usri,,0,0,0,58,https://x.com/3usri/status/1971433354592649521,https://x.com/IndoPopBase/status/1971427689253962192,0
2025-09-26 06:05:34+00:00,butterscooths,Vanessa Zee - Berkaca-kaca,0,0,0,474,https://x.com/butterscooths/status/1971456090790560132,https://x.com/IndoPopBase/status/1971427689253962192,0
2025-09-26 04:16:01+00:00,airdrop_goe,Mantap,0,1,0,223,https://x.com/airdrop_goe/status/1971428523157094900,https://x.com/IndoPopBase/status/1971427689253962192,1
2025-09-26 04:15:46+00:00,airdrop_goe,Lgu opo ni,0,0,0,214,https://x.com/airdrop_goe/status/1971428459089101093,https://x.com/IndoPopBase/status/1971427689253962192,0
2025-09-25 04:51:11+00:00,piadesu_,"That ""isi burger kastanisasi"" and the way she pronounces ""chicken katsoeeee""  is 100% on point. Sharp and stabbing 🫟",2,241,0,39283,https://x.com/piadesu_/status/1971074981711970580,https://x.com/IndoPopBase/status/1971073094778511523,243
2025-09-25 06:35:50+00:00,ndrandrii,"Kalau pejabat2 masih ngeyel menu MBG itu layak dan sehat, aturannya konsumsi rapat2 dinas pejabat menunya disamakan menu MBG aja.",3,192,0,27773,https://x.com/ndrandrii/status/1971101320783515767,https://x.com/IndoPopBase/status/1971073094778511523,195
2025-09-25 05:36:52+00:00,pjk_kmr,,8,161,0,42339,https://x.com/pjk_kmr/status/1971086479414981112,https://x.com/IndoPopBase/status/1971073094778511523,169
2025-09-25 05:19:44+00:00,hwang_hyunj1n,"Pada tau ga sih, di Papua kalau mau di explore, itu ikan2 nya dan tanaman2 sayuran nya bagus2 semua, krn mereka punya laut dan punya pegunungan.
Tinggal mau apa enggak aja untuk distribusi nya.
Gila ya itu alpukat nya aja pulen2
Udang selingkuh nya enak banget",14,117,0,35088,https://x.com/hwang_hyunj1n/status/1971082169012584580,https://x.com/IndoPopBase/status/1971073094778511523,131
2025-09-25 06:56:38+00:00,ndroe_,suka bgt sama cara bicaranya,5,120,0,18865,https://x.com/ndroe_/status/1971106555602129083,https://x.com/IndoPopBase/status/1971073094778511523,125
2025-09-25 09:19:21+00:00,Ramarmdhn__,"Nih liat si tolol ini prodinya apaan, ilmuwan serangga. Tiba² jadi ketua BGN, apa kaga sinting itu. ",16,123,0,24946,https://x.com/Ramarmdhn__/status/1971142469506170929,https://x.com/IndoPopBase/status/1971073094778511523,139
2025-09-25 05:32:18+00:00,hastarika,"jangan diperbaiki, dihentikan saja. dibatalkan. kit aperlu anggarannya utk pendidikan & sektor lain.",1,33,0,10486,https://x.com/hastarika/status/1971085332268585239,https://x.com/IndoPopBase/status/1971073094778511523,34
2025-09-25 04:55:44+00:00,shakesapear,"“susun nak, ada sayurnya… ” oh boy the way i directly imagined those poor kids have to assemble that sad ass burger",1,42,0,18156,https://x.com/shakesapear/status/1971076129818804651,https://x.com/IndoPopBase/status/1971073094778511523,43
2025-09-25 05:50:25+00:00,sleepybijes,Cape ya bu ngomong sm org2 bodoh,0,0,0,4730,https://x.com/sleepybijes/status/1971089889035944314,https://x.com/IndoPopBase/status/1971073094778511523,0
2025-09-25 06:18:16+00:00,measme99,Berasa bgt gemesnya dr Tan sm program MBG ini..iyaa sih dia edukask bertahun2 tp pemerintah bikin program asal2an..ya mbok klo bikin program tuh ngundnag ahlo2 gitu loh..banyak org2 pintar di Indonesia kagak mau dilake sm pemerintah krn yg dicari untung bukan lakukan yg benar,0,0,0,1597,https://x.com/measme99/status/1971096897533399316,https://x.com/IndoPopBase/status/1971073094778511523,0
2025-09-25 05:44:26+00:00,SanuBari_,"Para siswa anak baik baik, belum terbiasa makan duit haram, jadi banyak yang keracunan, para pejabat mah enak sudah terbiasa makan duit haram.",1,0,0,2018,https://x.com/SanuBari_/status/1971088383104647548,https://x.com/IndoPopBase/status/1971073094778511523,1
2025-09-25 04:59:17+00:00,kiokio878,"Anggaran 71 T
Yg keseram 13 T sisa nya kemana cuk?",2,0,0,7262,https://x.com/kiokio878/status/1971077023587238392,https://x.com/IndoPopBase/status/1971073094778511523,2
2025-09-25 07:24:53+00:00,barthdiaz198,"Kalau baca tiktok masih berkisar tentang ""jangan salahin prabowo "", sama paling bilang mbg disabotase.

Agak seneng baca komen di x, penuh orang kritis dan paham soal gizi

Tapi sayangnya, masyarakat kita ya gambaranya warga2 tiktok itu",0,0,0,656,https://x.com/barthdiaz198/status/1971113663634592169,https://x.com/IndoPopBase/status/1971073094778511523,0
2025-09-25 08:40:50+00:00,bias_bias,"20% APBN dianggarkan utk pendidikan, 6% nya untuk MBG ini
Andai saja itu digunakan utk gratiskan jenjang pendidikan tinggi
Eh tapi kan ada yg gak seneng ya kalai warganya jadi pinter",1,1,0,3708,https://x.com/bias_bias/status/1971132777539248129,https://x.com/IndoPopBase/status/1971073094778511523,2
2025-09-25 04:44:31+00:00,thirdeyeraven,semoga terdengar jelas sampai mana mana,1,0,0,1295,https://x.com/thirdeyeraven/status/1971073307077497145,https://x.com/IndoPopBase/status/1971073094778511523,1
2025-09-25 05:52:06+00:00,zousa_fernandez,"Minimal MBG makanan nya standar Rumah sakit , itu bagus gizi nya yng diberikan RS , lah ini malah burger ahli gizi MBG pie toh ??",1,0,0,1612,https://x.com/zousa_fernandez/status/1971090312295821629,https://x.com/IndoPopBase/status/1971073094778511523,1
2025-09-25 04:50:14+00:00,dimoonlock,"Yes istg bread is overrated, doesnt taste good at all, you bitchesss need to stop worshiping bread, pastry, cake etc.",1,0,0,1369,https://x.com/dimoonlock/status/1971074745258201514,https://x.com/IndoPopBase/status/1971073094778511523,1
2025-09-25 04:53:57+00:00,Zaen2233,Gak tau lagi bakal gmn kalo sampe yg d dalam pun gak d dengar.,1,0,0,1614,https://x.com/Zaen2233/status/1971075680105566460,https://x.com/IndoPopBase/status/1971073094778511523,1
2025-09-25 05:36:21+00:00,_real__dil_,"Sering liat konten org papua nukar ikan, jantung pisang, umbi dan bahan makanan alami lainnya dengan indomie. Menyedihkan kata gue teh",6,0,0,9742,https://x.com/_real__dil_/status/1971086350159052925,https://x.com/IndoPopBase/status/1971073094778511523,6
2025-09-25 09:17:01+00:00,TreesCherr87373,Lagian ngapain sih BGN diisi sama brigjen2 purnawirawan? Ngisi lowker kasir minimarket aja harus orang yg punya background relevan. Lah ini?,0,0,0,1306,https://x.com/TreesCherr87373/status/1971141883612233895,https://x.com/IndoPopBase/status/1971073094778511523,0
2025-09-25 09:15:00+00:00,TreesCherr87373,"Boleh MBG tetap jalan. Tapi harus: ganti jajaran pengurus BGN dengan golongan teknokrat di bidangnya, transparansi anggaran, manajemen rantai pasok yg bagus, distribusi yg merata, dan mampu menggerakkan ekonomi rakyat.",1,1,0,2124,https://x.com/TreesCherr87373/status/1971141376520998912,https://x.com/IndoPopBase/status/1971073094778511523,2
2025-09-25 04:44:13+00:00,ursteulyNaveen,Strong words from Dr. Tan  Clearly shows how serious the concerns are about MBG’s quality.,1,0,0,3213,https://x.com/ursteulyNaveen/status/1971073228526465256,https://x.com/IndoPopBase/status/1971073094778511523,1
2025-09-25 09:03:55+00:00,AnakBuluku_5,"Sedih ya, motong anggaran pendidikan banyak2 cuma buat ngeracunin anak orang
Terus kalo kita ngekritik ini program, pasti dikata gak bersyukur. Pdhl klo programnya gak bener/kurang tepat kan wajar di kritik",0,0,0,515,https://x.com/AnakBuluku_5/status/1971138584410505392,https://x.com/IndoPopBase/status/1971073094778511523,0
2025-09-25 10:43:00+00:00,WidyoLita,Ikut ngrasain getaran marahnya bu dokter ini ,1,0,0,643,https://x.com/WidyoLita/status/1971163521380757972,https://x.com/IndoPopBase/status/1971073094778511523,1
2025-09-25 11:23:25+00:00,modestybanget,"My old office used to invite her, just to educate us bout healthy food, one ocassion she casually asked us ""so how old I am?"" I am 50, no I'm not awet muda, u just early aging"" with those bombastic side eyes",0,0,0,464,https://x.com/modestybanget/status/1971173692186165478,https://x.com/IndoPopBase/status/1971073094778511523,0
2025-09-25 06:01:18+00:00,gb_sleepy,This mom got more balls than whole BGN combined,0,0,0,1537,https://x.com/gb_sleepy/status/1971092627190940124,https://x.com/IndoPopBase/status/1971073094778511523,0
2025-09-25 11:58:37+00:00,·,"Walau memang tips beliau banyak ga 'disukai' orang karena mengutamakan real food & pangan lokal (paham bgt menu burger dan mie itu praktis hampir pasti disukai siswa)

Tapi jujur aku setuju usul ini + MBG sebaiknya dari kantin sekolah jadi rantai diatribusi ga terlalu panjang",2,0,0,1958,https://x.com/dinii_ps/status/1971182548773671073,https://x.com/IndoPopBase/status/1971073094778511523,2
2025-09-25 06:45:34+00:00,pusingpalaaa,"I feel u, dok 
Pasti udah suebeeeellll bgt rasanya dan muak saking muaknya sampe cara ngomongnya diperhalus satir kek gitu
Kapan ya orang2 itu sadar dan bisa berperilaku sebagaimana mestinya? ",0,0,0,552,https://x.com/pusingpalaaa/status/1971103768663163244,https://x.com/IndoPopBase/status/1971073094778511523,0
2025-09-26 01:04:17+00:00,adhipenegoro,Omke gas omke gas,0,1,0,191,https://x.com/adhipenegoro/status/1971380268524310679,https://x.com/IndoPopBase/status/1971073094778511523,1
2025-09-25 10:31:19+00:00,amrtd_id,Ibu ini berani dan superkeren. Gila aja klo masih ada yg menghubungkan dg latar belakang etnisnya ,1,0,0,336,https://x.com/amrtd_id/status/1971160581144182802,https://x.com/IndoPopBase/status/1971073094778511523,1
2025-09-25 10:07:33+00:00,cityleng,We need more people like her. again. MORE PEOPLE LIKE HER.,0,0,0,144,https://x.com/cityleng/status/1971154601719341436,https://x.com/IndoPopBase/status/1971073094778511523,0
2025-09-25 06:21:03+00:00,pagicerahceria,"MBG selalu dibawa pulang nak gadis. 
Nugget? Nugget curah ",0,1,0,1100,https://x.com/pagicerahceria/status/1971097598208659611,https://x.com/IndoPopBase/status/1971073094778511523,1
2025-09-25 07:53:01+00:00,RedCliff256,The mother is mothering,0,0,0,11163,https://x.com/RedCliff256/status/1971120743086948801,https://x.com/IndoPopBase/status/1971073094778511523,0
2025-09-25 09:25:03+00:00,deepublishstore,"Please do stop/do more research, korbannya udah banyak banget ;'((",0,0,0,579,https://x.com/deepublishstore/status/1971143902787985650,https://x.com/IndoPopBase/status/1971073094778511523,0
2025-09-25 14:04:16+00:00,officialfgmedia,"Udah di desak hentikan sementara & evaluasi total, Anggota Komisi IX DPR gak sepakat katanya MBG Program Mulia ",0,0,0,3612,https://x.com/officialfgmedia/status/1971214171934241110,https://x.com/IndoPopBase/status/1971073094778511523,0
2025-09-25 12:49:26+00:00,tttiiiccceee,"Emosi si ibu dapet bgt. Kerasa bgt di gw. Emosi beliau mewakili kita sbg rakyat Indonesia yg CERDAS yg tentunya sudah SANGAT MUAK DENGAN PROGRAM MBG INI.

PROGRAM YANG SANGAT UNFAEDAH KARENA MALAH MEMBUNUH SISWA/SISWI YANG MENGKONSUMSINYA.",0,0,0,219,https://x.com/tttiiiccceee/status/1971195339379179621,https://x.com/IndoPopBase/status/1971073094778511523,0
2025-09-25 15:08:30+00:00,dustchamber,semoga si ibu ini dan keluarganya sekarang ga ada yg neror,0,0,0,51,https://x.com/dustchamber/status/1971230335557144941,https://x.com/IndoPopBase/status/1971073094778511523,0
2025-09-26 23:26:13+00:00,fitri99187,WHO ga pengen inspeksi ke sini? Ini korban nya aset penerus bangsa lho....,0,0,0,15,https://x.com/fitri99187/status/1971717977700749701,https://x.com/IndoPopBase/status/1971073094778511523,0
2025-09-25 17:10:42+00:00,DrKamalStrange,"Di Papua pun, makanan pokoknya dipaksa nasi, mie instan pun seakan makanan mewah dengan harga tinggi karena harus ""impor"". Memang ini perlu diperbaiki dari akarnya, mulai pembiasaan pangan lokal dan penyesuaian makanan pokok dll",0,0,0,232,https://x.com/DrKamalStrange/status/1971261090140148027,https://x.com/IndoPopBase/status/1971073094778511523,0
2025-09-25 08:19:17+00:00,MinJi_04,"Beliau adlh panutan dr dulu  smp anak mpasi pun konsul sm blio, yg dgn senang hati sll balas dm2 ibu2 baru ",0,0,0,134,https://x.com/MinJi_04/status/1971127354484457961,https://x.com/IndoPopBase/status/1971073094778511523,0
2025-09-25 06:23:18+00:00,taringular,"mending duit MBG langsung dibagi2 ke Parpol aja, ga usah proyek2an dan nambah ngeracunin bocah2",0,0,0,1912,https://x.com/taringular/status/1971098166008434875,https://x.com/IndoPopBase/status/1971073094778511523,0
2025-09-26 03:07:37+00:00,KomiteInovasi,Gaya selebritas,0,0,0,22,https://x.com/KomiteInovasi/status/1971411307804193147,https://x.com/IndoPopBase/status/1971073094778511523,0
2025-09-26 01:30:59+00:00,bitterosweetx,"tionghoa yes, pribumi could never",0,0,0,48,https://x.com/bitterosweetx/status/1971386987430150476,https://x.com/IndoPopBase/status/1971073094778511523,0
2025-09-25 22:27:57+00:00,sauvi9n0nblanc,"Ini udah pasti duit di korup, gamungkin engga, pelakunya jgn di penjara plis, suruh balikin aj smua uang yg dia ambil, trs org nya di gantung di tiang listrik tgh kota selama 1 bulan. Turunin klo mau makan aja (kasih mbg), biar klo turun langsung jadi odgj mental ancur. Setan",1,0,0,409,https://x.com/sauvi9n0nblanc/status/1971340927743688953,https://x.com/IndoPopBase/status/1971073094778511523,1
2025-09-25 08:42:17+00:00,UjiLapangan,"ya gimana mau bener, yg ngurusin purnawirawan TNI!!!

temen2 lu kan 
@prabowo
 ?

ada byk ahli gizi, yg dipake purnawirawan TNI.

Satnya program ini dievaluasi.

Daripada makin byk anak yg keracunan.

Mgkn, anak, adik, ponakan kita aman.

Tapi besok2 ndak ada yg tau.",0,0,0,494,https://x.com/UjiLapangan/status/1971133143446139267,https://x.com/IndoPopBase/status/1971073094778511523,0
2025-09-25 04:51:15+00:00,jihadalif_,Suka banget nada ngenyeknya,0,0,0,1114,https://x.com/jihadalif_/status/1971075001848942742,https://x.com/IndoPopBase/status/1971073094778511523,0
2025-09-25 05:42:37+00:00,plyxeol,this queen,0,0,0,342,https://x.com/plyxeol/status/1971087927414489245,https://x.com/IndoPopBase/status/1971073094778511523,0
2025-09-25 14:49:10+00:00,AgoodMood16,"Bergizi versi pemerintah indo: murid kenyang,anteng 

Isinya: nasi banyak,perkedel kentang,sayur sesendok,telor kadang,kadang tempe,kadang ayam setengah potong paha 
Maaf

Gemes abisnya",0,0,0,275,https://x.com/AgoodMood16/status/1971225470516842869,https://x.com/IndoPopBase/status/1971073094778511523,0
2025-09-26 07:25:01+00:00,outskirtcapital,"Watch full on YouTube 
youtube.com/live/GD_6aOv-i
… ",0,0,0,105,https://x.com/outskirtcapital/status/1971476084035289389,https://x.com/IndoPopBase/status/1971073094778511523,0
2025-09-26 00:15:40+00:00,asyiqshackshock,Critical hit damage +26954 ,0,0,0,46,https://x.com/asyiqshackshock/status/1971368033785610379,https://x.com/IndoPopBase/status/1971073094778511523,0
2025-09-25 03:57:00+00:00,CakRedi,"'Pesan ayam goreng dua, sayur asem'
screams senior citizen awkwardly trying to keep up with youngsters with his  joke bapack2.",1,1,0,3413,https://x.com/CakRedi/status/1971061348550447110,https://x.com/IndoPopBase/status/1971058202776305782,2
2025-09-25 04:11:04+00:00,BANANAKAKUMEl,"me getting 6/6
me 1 : nicholas saputra 0",0,0,0,2789,https://x.com/BANANAKAKUMEl/status/1971064889587507368,https://x.com/IndoPopBase/status/1971058202776305782,0
2025-09-25 04:16:59+00:00,humanitey,"Its amazing how once you see someone is actually not a good person that you thought they were, they suddenly not look hot anymore",4,0,0,1360,https://x.com/humanitey/status/1971066376568832022,https://x.com/IndoPopBase/status/1971058202776305782,4
2025-09-25 04:18:14+00:00,kasanaruphrase,um i thought we cancelled him?,5,2,0,3781,https://x.com/kasanaruphrase/status/1971066691900801308,https://x.com/IndoPopBase/status/1971058202776305782,7
2025-09-25 05:24:13+00:00,aden87,"Jawaban gw yg benar sama lagi, cuma bedanya muka gw kaye musang pandan aja ",0,0,0,1564,https://x.com/aden87/status/1971083297230028889,https://x.com/IndoPopBase/status/1971058202776305782,0
2025-09-25 13:29:32+00:00,syifaalfian,,0,1,0,999,https://x.com/syifaalfian/status/1971205428827807790,https://x.com/IndoPopBase/status/1971058202776305782,1
2025-09-25 13:43:06+00:00,zakktheone,"funfact that nobody knows, Nicholas Saputra  use hearing aid because his ear issue -mas mas melawai said.",0,0,0,828,https://x.com/zakktheone/status/1971208843565916318,https://x.com/IndoPopBase/status/1971058202776305782,0
2025-09-25 09:00:07+00:00,miloovaltines,Nico salah jawab pertanyaan bukan nico nya yg salah tapi yg nanya nya,0,0,0,979,https://x.com/miloovaltines/status/1971137631397503174,https://x.com/IndoPopBase/status/1971058202776305782,0
2025-09-26 00:43:20+00:00,white_lyly,"Gak sbar bawain sambel biar tambah sedep kita makannya, sayang ",0,0,0,368,https://x.com/white_lyly/status/1971374998930792780,https://x.com/IndoPopBase/status/1971058202776305782,0
2025-09-25 16:46:08+00:00,Ihyanursamsie,ayam goreng dua sama sayur asem itu maksudnya kode mas nichol mau makan,0,0,0,550,https://x.com/Ihyanursamsie/status/1971254904829378976,https://x.com/IndoPopBase/status/1971058202776305782,0
2025-09-26 06:28:43+00:00,sawerkendi,Sabrina Carpenter as “artis 2020-an”? Gurl debuted since 2010s,0,0,0,111,https://x.com/sawerkendi/status/1971461916427182442,https://x.com/IndoPopBase/status/1971058202776305782,0
2025-09-25 17:23:59+00:00,oktvrsd,siap carry di gunung manapun,0,0,0,275,https://x.com/oktvrsd/status/1971264433591812361,https://x.com/IndoPopBase/status/1971058202776305782,0
2025-09-25 08:40:13+00:00,dwdk11,Aw gemes,0,0,0,543,https://x.com/dwdk11/status/1971132620194074879,https://x.com/IndoPopBase/status/1971058202776305782,0
2025-09-25 09:44:34+00:00,larasasyf,ganteng bgt emg ni org,0,0,0,536,https://x.com/larasasyf/status/1971148816276754467,https://x.com/IndoPopBase/status/1971058202776305782,0
2025-09-26 03:55:08+00:00,annisahtbrt,"tttt-tapi aku 2 diawal juga gatau, cuma pernah denger lagunya doangg, penyanyi dan albumnya gatau 
apakah aku setua itu? huaaaaa ",0,0,0,190,https://x.com/annisahtbrt/status/1971423266066792655,https://x.com/IndoPopBase/status/1971058202776305782,0
2025-09-25 11:00:35+00:00,nalacila,pesen ayam goreng dua? itu satunya buat aku kan?,0,0,0,991,https://x.com/nalacila/status/1971167946283307205,https://x.com/IndoPopBase/status/1971058202776305782,0
2025-09-25 23:55:47+00:00,pinkishdust,Buseeeeetttt,0,0,0,182,https://x.com/pinkishdust/status/1971363032153702481,https://x.com/IndoPopBase/status/1971058202776305782,0
2025-09-25 07:22:00+00:00,redermoree,he can top me,0,0,0,435,https://x.com/redermoree/status/1971112936199565615,https://x.com/IndoPopBase/status/1971058202776305782,0
2025-09-25 14:16:59+00:00,lucasstephen,Cocok sih. Secara…..,0,0,0,300,https://x.com/lucasstephen/status/1971217369998716931,https://x.com/IndoPopBase/status/1971058202776305782,0
2025-09-26 00:17:05+00:00,temanamaste,wdc about this 40 year old twink,0,0,0,156,https://x.com/temanamaste/status/1971368391291396561,https://x.com/IndoPopBase/status/1971058202776305782,0
2025-09-25 09:58:30+00:00,·,Nonton sambil senyum,0,0,0,476,https://x.com/nasiuduktongkol/status/1971152320680559029,https://x.com/IndoPopBase/status/1971058202776305782,0
2025-09-26 01:41:41+00:00,cadburryyss,gemesh ih,0,0,0,92,https://x.com/cadburryyss/status/1971389682660651166,https://x.com/IndoPopBase/status/1971058202776305782,0
2025-09-25 09:37:58+00:00,NoeNoeNeon,pesen ayam goreng 2 ,0,0,0,722,https://x.com/NoeNoeNeon/status/1971147155558818191,https://x.com/IndoPopBase/status/1971058202776305782,0
2025-09-25 14:02:47+00:00,eightwothirteen,mas gamteennggg,0,0,0,180,https://x.com/eightwothirteen/status/1971213796586008837,https://x.com/IndoPopBase/status/1971058202776305782,0
2025-09-25 16:39:07+00:00,barblinkz,he can top me,0,0,0,107,https://x.com/barblinkz/status/1971253139685900346,https://x.com/IndoPopBase/status/1971058202776305782,0
2025-09-27 14:19:02+00:00,nathaloraa,Enak x dengar abang ini ngomong,0,0,0,29,https://x.com/nathaloraa/status/1971942662111666663,https://x.com/IndoPopBase/status/1971058202776305782,0
2025-09-26 16:40:40+00:00,MIKESrePLAY,Our gay king!,0,0,0,22,https://x.com/MIKESrePLAY/status/1971615919479931142,https://x.com/IndoPopBase/status/1971058202776305782,0
2025-09-25 08:58:48+00:00,Leonaderune,my unchronically online king,0,0,0,601,https://x.com/Leonaderune/status/1971137298797588618,https://x.com/IndoPopBase/status/1971058202776305782,0
2025-09-25 08:58:16+00:00,Leonaderune,is he live in cave-,0,0,0,492,https://x.com/Leonaderune/status/1971137164017881572,https://x.com/IndoPopBase/status/1971058202776305782,0
2025-09-25 04:25:43+00:00,scarednostalgic,I can teach him,0,0,0,788,https://x.com/scarednostalgic/status/1971068573134237913,https://x.com/IndoPopBase/status/1971058202776305782,0
2025-09-25 04:12:19+00:00,DduBbu3,IJBOL,0,0,0,1138,https://x.com/DduBbu3/status/1971065201731703113,https://x.com/IndoPopBase/status/1971058202776305782,0
2025-09-25 10:16:56+00:00,gernbul,Nicsap main roblox,0,0,0,365,https://x.com/gernbul/status/1971156963154329730,https://x.com/IndoPopBase/status/1971058202776305782,0
2025-09-26 02:11:46+00:00,zaharassi,Yg dia lakukan sepele tp beneran jd gak excited ngeliat dia skrg,0,0,0,178,https://x.com/zaharassi/status/1971397254151119104,https://x.com/IndoPopBase/status/1971058202776305782,0
2025-09-25 06:53:05+00:00,ans__dinda,Aku siap carry,0,0,0,514,https://x.com/ans__dinda/status/1971105660881469667,https://x.com/IndoPopBase/status/1971058202776305782,0
2025-09-25 04:04:22+00:00,kerupug888,,0,0,0,1048,https://x.com/kerupug888/status/1971063201510171109,https://x.com/IndoPopBase/status/1971058202776305782,0
2025-09-26 02:31:02+00:00,InsNantikaa,,0,0,0,63,https://x.com/InsNantikaa/status/1971402101067825593,https://x.com/IndoPopBase/status/1971058202776305782,0
2025-09-25 05:28:04+00:00,hzliest,udah paham mas? udah cocok nih nikah sm genz kaya aku,0,0,0,1325,https://x.com/hzliest/status/1971084263853543578,https://x.com/IndoPopBase/status/1971058202776305782,0
2025-09-25 04:14:56+00:00,mmjussX,"And they said Sabrina is 2020’s artist demn, how about the debut dll ",2,0,0,2381,https://x.com/mmjussX/status/1971065860371644777,https://x.com/IndoPopBase/status/1971058202776305782,2
2025-09-25 15:47:50+00:00,crestcen,"his sense of humor wkwk, pesen ayam goreng dua, sayur asem",0,0,0,357,https://x.com/crestcen/status/1971240235158864323,https://x.com/IndoPopBase/status/1971058202776305782,0
2025-09-25 04:35:36+00:00,crushrockwell,the way i can hear his voice over this,34,141,0,54574,https://x.com/crushrockwell/status/1971071061128249540,https://x.com/IndoPopBase/status/1971051395974648212,175
2025-09-25 03:22:23+00:00,cs_Lilo,"gk seruu influencer complain tinggal bikin konten, gk perlu chat ini, email sana, dilempar kesini",4,27,0,28262,https://x.com/cs_Lilo/status/1971052637450846456,https://x.com/IndoPopBase/status/1971051395974648212,31
2025-09-25 08:36:26+00:00,nameless_str4y,"""Balikin refund gue"" pasti semua orang membayangkan suaranya dengan intonasi yang sama. Gabisa ngasih contoh, tapi pasti bayangan kita sama.",1,25,0,29369,https://x.com/nameless_str4y/status/1971131669559357635,https://x.com/IndoPopBase/status/1971051395974648212,26
2025-09-25 04:11:16+00:00,RiansyahDE," Travel agent here, refund bakal otomatis ditrf kalau udh di issue maskapai, berarti problemnya di maskapai.",11,16,0,46963,https://x.com/RiansyahDE/status/1971064935989076088,https://x.com/IndoPopBase/status/1971051395974648212,27
2025-09-25 03:33:45+00:00,hadilocoboy,cakep nih org (buat yg ga tau),0,0,0,5900,https://x.com/hadilocoboy/status/1971055494988271919,https://x.com/IndoPopBase/status/1971051395974648212,0
2025-09-25 03:28:36+00:00,agehmraa,Bernada yaa typing nyaa,0,0,0,4979,https://x.com/agehmraa/status/1971054199183114292,https://x.com/IndoPopBase/status/1971051395974648212,0
2025-09-25 05:21:43+00:00,fourze_raihan2,Refund tuh juga harus nunggu dari maskapai. Enak deh jadi publik figur tinggal komplain aja :(.,0,0,0,6512,https://x.com/fourze_raihan2/status/1971082666217963815,https://x.com/IndoPopBase/status/1971051395974648212,0
2025-09-25 12:03:42+00:00,pinginsugih,"Pernah Kaya gini. Parahnya lagi beli pakai pay later terus reschedule. Pay later udah lunas, uang refund ga dibalikin, malah dikasih voucher.

Pelajarannya : jangan beli pakai paylater, sulit proses refund nya",0,1,0,2005,https://x.com/pinginsugih/status/1971183830209032496,https://x.com/IndoPopBase/status/1971051395974648212,1
2025-09-25 03:46:36+00:00,anaklarangan_,Its her right,0,0,0,1826,https://x.com/anaklarangan_/status/1971058729811677507,https://x.com/IndoPopBase/status/1971051395974648212,0
2025-09-25 03:29:24+00:00,ursteulyNaveen,That’s a strong call-out  Hope Traveloka clears this up quickly.,0,0,0,5887,https://x.com/ursteulyNaveen/status/1971054402623635870,https://x.com/IndoPopBase/status/1971051395974648212,0
2025-09-25 06:16:36+00:00,cupang_fish,"Traveloka jan main - main lu, belom pernah di tonjok abang - abangan kan? ",0,0,0,20751,https://x.com/cupang_fish/status/1971096478111461565,https://x.com/IndoPopBase/status/1971051395974648212,0
2025-09-25 06:53:17+00:00,roseisabtch,"Ya Allah mbak, kalo duit udh turun dari maskapai juga travel agent ga bakal nahan kok. Komplain noh ke maskapai. Travel agent mah nurut aja",0,0,0,21231,https://x.com/roseisabtch/status/1971105712190419251,https://x.com/IndoPopBase/status/1971051395974648212,0
2025-09-25 04:34:23+00:00,discreet_banget,Pake capslock gasie “BALIKIN REFUND GUE”,4,0,0,18687,https://x.com/discreet_banget/status/1971070755661283711,https://x.com/IndoPopBase/status/1971051395974648212,4
2025-09-25 03:25:59+00:00,ItsSkywalkers,She is legend,3,0,0,15042,https://x.com/ItsSkywalkers/status/1971053542220890382,https://x.com/IndoPopBase/status/1971051395974648212,3
2025-09-25 04:43:59+00:00,r_adam_p,"HER ???
not him anymore ?",6,0,0,3989,https://x.com/r_adam_p/status/1971073170208924133,https://x.com/IndoPopBase/status/1971051395974648212,6
2025-09-25 11:48:37+00:00,bry4n_cyrus,"anjir, gue baca tanda kutip nya dalam hati langsung ada suara mbak ll langsung",0,0,0,7185,https://x.com/bry4n_cyrus/status/1971180032556233183,https://x.com/IndoPopBase/status/1971051395974648212,0
2025-09-25 04:47:57+00:00,xxxaryadi,Mungkin gegara demo kmaren,0,0,0,13485,https://x.com/xxxaryadi/status/1971074169174622320,https://x.com/IndoPopBase/status/1971051395974648212,0
2025-09-25 16:22:38+00:00,finoalfaris,Gw juga ini beli tiket singapore cable car gaktaunya wahananya maintenance lama bgt tapi tiketnya masih dijual traveloka??? Padahal pihak terkait bilang udah ngabarin pihak spt traveloka sejak 2 bulan sebelum,0,0,0,3163,https://x.com/finoalfaris/status/1971248990395183238,https://x.com/IndoPopBase/status/1971051395974648212,0
2025-09-25 05:00:45+00:00,wayorami,that’s not how refunds work,0,0,0,569,https://x.com/wayorami/status/1971077391696171013,https://x.com/IndoPopBase/status/1971051395974648212,0
2025-09-25 14:07:19+00:00,Lostranauts_300,"""Balikin refund gue!""",0,0,0,607,https://x.com/Lostranauts_300/status/1971214939982573843,https://x.com/IndoPopBase/status/1971051395974648212,0
2025-09-25 06:23:11+00:00,karimakayyim,"Sayang, udah diwakilin Lucinta Luna 
@keharyapatihan",1,0,0,1630,https://x.com/karimakayyim/status/1971098133993226674,https://x.com/IndoPopBase/status/1971051395974648212,1
2025-09-25 05:04:43+00:00,remasbulu,"Balikin refund ini masuk list ga? 
@uglycatclub",1,0,0,393,https://x.com/remasbulu/status/1971078388682297462,https://x.com/IndoPopBase/status/1971051395974648212,1
2025-09-25 09:33:00+00:00,hyinfloyen,"Kek kedengeran banget ll ngomong ""balikin refund gw"" Tanpa voice ",0,0,0,1472,https://x.com/hyinfloyen/status/1971145904146219213,https://x.com/IndoPopBase/status/1971051395974648212,0
2025-09-25 03:49:07+00:00,beautiaf,jangan sampe muhammad fatah dia keluar,0,0,0,7358,https://x.com/beautiaf/status/1971059362560200938,https://x.com/IndoPopBase/status/1971051395974648212,0
2025-09-25 13:13:58+00:00,nocturnpoets,udah di bailout min. wkwkwkwkwk,0,0,0,4568,https://x.com/nocturnpoets/status/1971201511368847502,https://x.com/IndoPopBase/status/1971051395974648212,0
2025-09-25 23:57:02+00:00,tiarawwrr,"what thee  
@crackmycookieee",1,0,0,24,https://x.com/tiarawwrr/status/1971363344629236107,https://x.com/IndoPopBase/status/1971051395974648212,1
2025-09-25 04:28:48+00:00,0xgasm,she is he,0,0,0,4697,https://x.com/0xgasm/status/1971069350083018990,https://x.com/IndoPopBase/status/1971051395974648212,0
2025-09-25 20:56:54+00:00,forbes31st,His flight,0,0,0,242,https://x.com/forbes31st/status/1971318013157920785,https://x.com/IndoPopBase/status/1971051395974648212,0
2025-09-25 13:49:22+00:00,·,balikin refund gue ,0,0,0,125,https://x.com/pengremas/status/1971210421467218358,https://x.com/IndoPopBase/status/1971051395974648212,0
2025-09-25 17:59:39+00:00,DetektifBelanja,,0,0,0,11,https://x.com/DetektifBelanja/status/1971273406902566957,https://x.com/IndoPopBase/status/1971051395974648212,0
2025-09-25 06:15:44+00:00,SfgsggsS60251,Suaranya kedengeran sampe telinga semut,0,0,0,2935,https://x.com/SfgsggsS60251/status/1971096260515115195,https://x.com/IndoPopBase/status/1971051395974648212,0
2025-09-25 19:13:15+00:00,akbarpange,"Beli tiket pesawat skg mending book direct di website maskapainya, lebih aman. Lewat traveloka kalo jadwal keganti dr maskapai suka ribet apalagi refund ",0,0,0,935,https://x.com/akbarpange/status/1971291927489470837,https://x.com/IndoPopBase/status/1971051395974648212,0
2025-09-26 03:52:57+00:00,M4ngU5il,...anaknya...,0,0,0,123,https://x.com/M4ngU5il/status/1971422714952024404,https://x.com/IndoPopBase/status/1971051395974648212,0
2025-09-25 08:22:59+00:00,baejuniel,@honeydumbcrazy,1,0,0,90,https://x.com/baejuniel/status/1971128285817180396,https://x.com/IndoPopBase/status/1971051395974648212,1
2025-09-25 12:37:42+00:00,zalfa_slsbl,"Saya pernah ngajuin refund ke traveloka, dan masuk sih uangnya cuman takes time aja, beberapa bulan baru masuk",0,0,0,742,https://x.com/zalfa_slsbl/status/1971192385062445095,https://x.com/IndoPopBase/status/1971051395974648212,0
2025-09-25 05:19:04+00:00,polo_classic88,you mean now? after you just click refund?,0,0,0,1054,https://x.com/polo_classic88/status/1971082000867234020,https://x.com/IndoPopBase/status/1971051395974648212,0
2025-09-25 23:01:31+00:00,·,Udh refund dbalikin? Jd terima pengembalian nya ap kaga nih? ,0,0,0,203,https://x.com/iseethesunwell/status/1971349373092233556,https://x.com/IndoPopBase/status/1971051395974648212,0
2025-09-25 10:06:44+00:00,Oxerion1234,Bencong lanang minta refund,0,0,0,117,https://x.com/Oxerion1234/status/1971154392826167486,https://x.com/IndoPopBase/status/1971051395974648212,0
2025-09-25 19:04:20+00:00,RakyatNgenez,Dia berbatang atau udah dicut gusy?,0,0,0,132,https://x.com/RakyatNgenez/status/1971289684656652521,https://x.com/IndoPopBase/status/1971051395974648212,0
2025-09-25 10:52:54+00:00,contoh_username,"""his""",0,0,0,232,https://x.com/contoh_username/status/1971166011819950176,https://x.com/IndoPopBase/status/1971051395974648212,0
2025-09-25 06:50:56+00:00,IqbalQuosophy,HIM,0,0,0,221,https://x.com/IqbalQuosophy/status/1971105118818119935,https://x.com/IndoPopBase/status/1971051395974648212,0
2025-09-25 05:05:11+00:00,itadoriyudi_,Balikin my refund gue,0,0,0,1026,https://x.com/itadoriyudi_/status/1971078507662016569,https://x.com/IndoPopBase/status/1971051395974648212,0
2025-09-25 15:21:03+00:00,gpp_hehe,Aku bacanya dalem hati tapi kaya ada suara lucintanya gtu bjir,0,0,0,388,https://x.com/gpp_hehe/status/1971233493813522774,https://x.com/IndoPopBase/status/1971051395974648212,0
2025-09-25 11:36:58+00:00,ykpil_,,0,0,0,227,https://x.com/ykpil_/status/1971177104097280337,https://x.com/IndoPopBase/status/1971051395974648212,0
2025-09-25 11:52:22+00:00,monsoonero,Lets start calling it Notransveloka,0,0,0,710,https://x.com/monsoonero/status/1971180976782090566,https://x.com/IndoPopBase/status/1971051395974648212,0
2025-09-25 05:56:54+00:00,tweet_juna,Balikin-refund,0,0,0,347,https://x.com/tweet_juna/status/1971091522016907347,https://x.com/IndoPopBase/status/1971051395974648212,0
2025-09-25 07:20:36+00:00,lanceuppercutx,It takes 30days at least,1,0,0,594,https://x.com/lanceuppercutx/status/1971112583907377534,https://x.com/IndoPopBase/status/1971051395974648212,1
2025-09-25 11:25:49+00:00,modestybanget,Kok lu banyak duit sih  Fataahhh...dengki gua,0,0,0,299,https://x.com/modestybanget/status/1971174295905894612,https://x.com/IndoPopBase/status/1971051395974648212,0
2025-09-26 02:35:28+00:00,BIitzwing,"""balikin refund"" ",0,0,0,44,https://x.com/BIitzwing/status/1971403219084759176,https://x.com/IndoPopBase/status/1971051395974648212,0
2025-09-25 03:43:44+00:00,RomaMonitor,With male’s tone?,0,0,0,1930,https://x.com/RomaMonitor/status/1971058009146261965,https://x.com/IndoPopBase/status/1971051395974648212,0
2025-09-25 04:01:27+00:00,rosesaidred,hey pop base I'm actually curious abt how you remember this kind of things,4,2,0,48751,https://x.com/rosesaidred/status/1971062466965876971,https://x.com/IndoPopBase/status/1971044597569913130,6
2025-09-25 03:03:05+00:00,manobiaaa,"they should've done ""Hello, this is xxx entertainment"" sorta shits loll",1,2,0,2430,https://x.com/manobiaaa/status/1971047778500620447,https://x.com/IndoPopBase/status/1971044597569913130,3
2025-09-25 02:59:40+00:00,jablaycore,the only visual on that group i fear,0,0,0,2104,https://x.com/jablaycore/status/1971046921033990206,https://x.com/IndoPopBase/status/1971044597569913130,0
2025-09-25 04:24:24+00:00,loenpiambaklien,He and Anisa Chibi’s departure are the biggest loss for Indonesia music.,0,1,0,1895,https://x.com/loenpiambaklien/status/1971068241738072153,https://x.com/IndoPopBase/status/1971044597569913130,1
2025-09-25 03:09:34+00:00,Xyz545X,ambil spd ya dia? pantesan ngajar di sma.,1,1,0,3221,https://x.com/Xyz545X/status/1971049411242492283,https://x.com/IndoPopBase/status/1971044597569913130,2
2025-09-25 06:08:25+00:00,tertusuq,Helppppp zhajshshshds,0,0,0,1143,https://x.com/tertusuq/status/1971094418661966059,https://x.com/IndoPopBase/status/1971044597569913130,0
2025-09-25 03:35:14+00:00,yesiamherewithu,setelah out dari SM*SH malah menekuni pendidikan keguruan sampai akhirnya kita mengenal beliau sebagai Pak Edwin,0,0,0,1759,https://x.com/yesiamherewithu/status/1971055870009323948,https://x.com/IndoPopBase/status/1971044597569913130,0
2025-09-25 05:35:51+00:00,exaltedpempek,Kok disensor gitu? Ketik lengkap aja kali nama grupnya,1,0,0,1817,https://x.com/exaltedpempek/status/1971086222752895088,https://x.com/IndoPopBase/status/1971044597569913130,1
2025-09-25 07:22:10+00:00,RayvalAbdi,"Infonya dia ngambil sertifikat PPG, ya? Makanya dia akhirnya ngajar di sekolah.",2,0,0,2138,https://x.com/RayvalAbdi/status/1971112980768251910,https://x.com/IndoPopBase/status/1971044597569913130,2
2025-09-25 08:30:29+00:00,persephoze,My first heartbreak actually,0,0,0,544,https://x.com/persephoze/status/1971130173094560199,https://x.com/IndoPopBase/status/1971044597569913130,0
2025-09-25 05:09:36+00:00,moodjianto,and Cleopatra Djapri?,1,0,0,633,https://x.com/moodjianto/status/1971079617437143407,https://x.com/IndoPopBase/status/1971044597569913130,1
2025-09-25 04:27:29+00:00,roweeasley,The ladder stand still more than Morgan,0,0,0,1959,https://x.com/roweeasley/status/1971069020825924054,https://x.com/IndoPopBase/status/1971044597569913130,0
2025-09-25 10:59:53+00:00,Epixurus8,#arielbebasboybandtewas,0,0,0,284,https://x.com/Epixurus8/status/1971167768860086668,https://x.com/IndoPopBase/status/1971044597569913130,0
2025-09-25 10:25:49+00:00,jennieace_cream,his best decision.,0,0,0,257,https://x.com/jennieace_cream/status/1971159195237126230,https://x.com/IndoPopBase/status/1971044597569913130,0
2025-09-25 05:44:40+00:00,belum_dilantik,Siapa yang dulu pas morgan keluar dr sm*sh nangis? Ayo sini ,0,0,0,1661,https://x.com/belum_dilantik/status/1971088444610035846,https://x.com/IndoPopBase/status/1971044597569913130,0
2025-09-25 15:13:38+00:00,sarahmeilindaa,Jd inget pernah beli majalah cuma buat poster Morgan,0,0,0,445,https://x.com/sarahmeilindaa/status/1971231627977335294,https://x.com/IndoPopBase/status/1971044597569913130,0
2025-09-25 02:56:38+00:00,helloseakun,my first bias,0,0,0,1435,https://x.com/helloseakun/status/1971046154327744665,https://x.com/IndoPopBase/status/1971044597569913130,0
2025-09-25 04:26:01+00:00,mubadminton,This is cultural mement,0,0,0,724,https://x.com/mubadminton/status/1971068649210593732,https://x.com/IndoPopBase/status/1971044597569913130,0
2025-09-25 05:36:45+00:00,·,the only member yang visually pleasing,0,0,0,496,https://x.com/ohhhwhoisyou/status/1971086449559908726,https://x.com/IndoPopBase/status/1971044597569913130,0
2025-09-25 13:56:54+00:00,Leonaderune,my first boycrush,0,0,0,220,https://x.com/Leonaderune/status/1971212316009279494,https://x.com/IndoPopBase/status/1971044597569913130,0
2025-09-25 04:34:28+00:00,icamkns,and remain iconic ever since,0,0,0,910,https://x.com/icamkns/status/1971070777618465028,https://x.com/IndoPopBase/status/1971044597569913130,0
2025-09-25 13:43:56+00:00,merindinggg,setelah itu jadi telur,0,0,0,272,https://x.com/merindinggg/status/1971209055768281200,https://x.com/IndoPopBase/status/1971044597569913130,0
2025-09-26 00:27:21+00:00,OAPutra,I Heart You is still a reliable song to boost the mood.,0,0,0,193,https://x.com/OAPutra/status/1971370975209132056,https://x.com/IndoPopBase/status/1971044597569913130,0
2025-09-25 12:18:14+00:00,hd_of_suburbia,Mamang Rafael yang mana?,0,0,0,299,https://x.com/hd_of_suburbia/status/1971187485918347653,https://x.com/IndoPopBase/status/1971044597569913130,0
2025-09-25 03:37:48+00:00,dontolicious_,,0,0,0,676,https://x.com/dontolicious_/status/1971056513906282640,https://x.com/IndoPopBase/status/1971044597569913130,0
2025-09-25 07:06:16+00:00,drocernekorb,"Don’t let this distract you, from the fact that this KING has finished them ALL.",0,0,0,111,https://x.com/drocernekorb/status/1971108980148797663,https://x.com/IndoPopBase/status/1971044597569913130,0
2025-09-25 02:38:10+00:00,fed_febri,when will the auditions for Asia's Got Talent 2026 open?,0,0,0,2605,https://x.com/fed_febri/status/1971041506694996130,https://x.com/IndoPopBase/status/1971040394839486675,0
2025-09-25 05:24:47+00:00,0xHarryry,Semoga tempat dan semuanya bisa kasih quality yang bagus,0,0,0,830,https://x.com/0xHarryry/status/1971083439286911203,https://x.com/IndoPopBase/status/1971040394839486675,0
2025-09-25 02:51:29+00:00,·,"sahorny, naflop urbitch & eko fadrio will be the judges",0,4,0,3326,https://x.com/helfut/status/1971044858409439695,https://x.com/IndoPopBase/status/1971040394839486675,4
2025-09-25 04:13:42+00:00,patellacaudal,"Soimah, addie ms, and deddy corbuzier as the judges wbk",7,3,0,2605,https://x.com/patellacaudal/status/1971065550563692723,https://x.com/IndoPopBase/status/1971040394839486675,10
2025-09-25 03:19:43+00:00,Alexx1992xx,I hope they can be the judges!,1,0,0,644,https://x.com/Alexx1992xx/status/1971051965015871633,https://x.com/IndoPopBase/status/1971040394839486675,1
2025-09-25 12:22:16+00:00,hollaa_uv,"Bisa nih kalian ikutan 
@v1rstofficial
 @UN1TY_Official",1,0,0,291,https://x.com/hollaa_uv/status/1971188503200571810,https://x.com/IndoPopBase/status/1971040394839486675,1
2025-09-26 09:15:04+00:00,AdindaRahmatul1,"Gas ikutan 
@UN1TY_Official",0,0,0,99,https://x.com/AdindaRahmatul1/status/1971503779511152760,https://x.com/IndoPopBase/status/1971040394839486675,0
2025-09-25 11:15:01+00:00,pabuescobar,Takut diajak joget uya kuya,0,0,0,641,https://x.com/pabuescobar/status/1971171576621175139,https://x.com/IndoPopBase/status/1971040394839486675,0
2025-09-25 03:50:26+00:00,·,Gue bingung acara ini kok kerjaannya audisi terus doang ya?,3,0,0,2543,https://x.com/asibhoney/status/1971059695914975429,https://x.com/IndoPopBase/status/1971040394839486675,3
2025-09-27 06:35:35+00:00,14097_,"Kalau Indosiar benci bgt gw, kualitas langsung drop siap2 untuk dihujat",0,0,0,31,https://x.com/14097_/status/1971826030227890480,https://x.com/IndoPopBase/status/1971040394839486675,0
2025-09-25 02:36:23+00:00,craftzhka,Lah masih ada,0,0,0,1654,https://x.com/craftzhka/status/1971041057946337662,https://x.com/IndoPopBase/status/1971040394839486675,0
2025-09-25 14:31:50+00:00,riz_rnf13,"ayok ikutan ges berempat 
@UN1TY_Official",0,0,0,121,https://x.com/riz_rnf13/status/1971221108088324503,https://x.com/IndoPopBase/status/1971040394839486675,0
2025-09-25 04:54:06+00:00,saidmanaf,"P join 
@RFritzy_JKT48
 @AR_LanaJKT48",0,0,0,725,https://x.com/saidmanaf/status/1971075719284584456,https://x.com/IndoPopBase/status/1971040394839486675,0
2025-09-25 11:51:04+00:00,yoursugarboooo,"saatnya menunjukan betismu sambil juggling bola api 
@sanwsktaaaa",1,0,0,380,https://x.com/yoursugarboooo/status/1971180649282461794,https://x.com/IndoPopBase/status/1971040394839486675,1
2025-09-25 05:18:28+00:00,ininuno,Hmm,0,0,0,36,https://x.com/ininuno/status/1971081851046592879,https://x.com/IndoPopBase/status/1971040394839486675,0
2025-09-26 06:44:36+00:00,SultanTraveler,"OMG! 
@Anggun_Cipta
 bakal kembali jadi juri?",0,0,0,66,https://x.com/SultanTraveler/status/1971465914651639834,https://x.com/IndoPopBase/status/1971040394839486675,0
2025-09-25 02:50:54+00:00,ikan_ikangoreng,aku mau ikut audisi,0,0,0,491,https://x.com/ikan_ikangoreng/status/1971044713412297139,https://x.com/IndoPopBase/status/1971040394839486675,0
2025-09-25 02:50:20+00:00,tabolt,But why,0,0,0,956,https://x.com/tabolt/status/1971044571225465188,https://x.com/IndoPopBase/status/1971040394839486675,0
2025-09-25 15:44:56+00:00,sanirosyad,"Its time to rise again 
@RFritzy_JKT48
 ",0,0,0,152,https://x.com/sanirosyad/status/1971239505333191028,https://x.com/IndoPopBase/status/1971040394839486675,0
2025-09-25 12:50:00+00:00,vixhd,"@grok
 yang jadi jurinya siapa?...",1,0,0,186,https://x.com/vixhd/status/1971195480177770871,https://x.com/IndoPopBase/status/1971040394839486675,1
2025-09-25 02:45:13+00:00,SuperFaqihhh,ikut apa ya,0,0,0,460,https://x.com/SuperFaqihhh/status/1971043282810708120,https://x.com/IndoPopBase/status/1971040394839486675,0
2025-09-25 04:46:59+00:00,dimoonlock,and eurovision? Flopped cause of israelis,0,0,0,187,https://x.com/dimoonlock/status/1971073927654023610,https://x.com/IndoPopBase/status/1971040394839486675,0
2025-09-25 15:27:01+00:00,strangerzssz,new meme in coming................,0,0,0,116,https://x.com/strangerzssz/status/1971234997655962005,https://x.com/IndoPopBase/status/1971040394839486675,0
2025-09-25 15:34:27+00:00,greyemeraldxx,"Gonna recommend 
@5ecretNumber
 as one of the contestants since they flop so hard.",0,0,0,85,https://x.com/greyemeraldxx/status/1971236868147818880,https://x.com/IndoPopBase/status/1971040394839486675,0
2025-09-25 14:17:14+00:00,goldinfernal,jakarta teros :),0,0,0,76,https://x.com/goldinfernal/status/1971217433831821548,https://x.com/IndoPopBase/status/1971040394839486675,0
2025-09-25 11:05:19+00:00,bimadimm,uuuuuuu,0,0,0,134,https://x.com/bimadimm/status/1971169136161194067,https://x.com/IndoPopBase/status/1971040394839486675,0
2025-09-25 23:41:30+00:00,felixputrinoble,They're right for so many reasons.,0,0,0,58,https://x.com/felixputrinoble/status/1971359437647650848,https://x.com/IndoPopBase/status/1971040394839486675,0
2025-09-25 02:55:14+00:00,madindanidien,Wewww,0,0,0,763,https://x.com/madindanidien/status/1971045803725881353,https://x.com/IndoPopBase/status/1971040394839486675,0
2025-09-25 02:50:02+00:00,BANANAKAKUMEl,Melody Nurramdhani will be the judge,0,0,0,588,https://x.com/BANANAKAKUMEl/status/1971044495786651986,https://x.com/IndoPopBase/status/1971040394839486675,0
2025-09-25 03:01:44+00:00,JavaJimmyMaukar,here we go again,0,0,0,704,https://x.com/JavaJimmyMaukar/status/1971047438602600719,https://x.com/IndoPopBase/status/1971040394839486675,0
2025-09-25 03:18:18+00:00,dopamindd,Omg,0,0,0,647,https://x.com/dopamindd/status/1971051609116508444,https://x.com/IndoPopBase/status/1971040394839486675,0
2025-09-25 02:40:14+00:00,bluemoonikii,Prostitusi 48 is over,1,0,0,370,https://x.com/bluemoonikii/status/1971042028764135453,https://x.com/IndoPopBase/status/1971040394839486675,1
2025-09-25 02:37:13+00:00,deethemedia,wahh ga sabar lihat peserta yang aneh-aneh wkk,0,0,0,414,https://x.com/deethemedia/status/1971041270320762935,https://x.com/IndoPopBase/status/1971040394839486675,0
2025-09-25 02:34:41+00:00,airdrop_goe,Mantap,0,1,0,394,https://x.com/airdrop_goe/status/1971040631465312552,https://x.com/IndoPopBase/status/1971040394839486675,1
2025-09-25 02:43:11+00:00,AmberSaira95910,"""Stay curious, the riddle rewards careful observation!""",0,0,0,294,https://x.com/AmberSaira95910/status/1971042770145116396,https://x.com/IndoPopBase/status/1971040394839486675,0
2025-09-25 02:45:18+00:00,Th3Tr4vel3r,From Jakarta to the world  Asia’s Got Talent 2026 will make history here!,0,0,0,1483,https://x.com/Th3Tr4vel3r/status/1971043304981790878,https://x.com/IndoPopBase/status/1971040394839486675,0
2025-09-25 02:58:22+00:00,kimkobzar,"Never really kept up with the show, just watched the viral clips",0,0,0,235,https://x.com/kimkobzar/status/1971046590518526392,https://x.com/IndoPopBase/status/1971040394839486675,0
2025-09-25 03:03:32+00:00,BrokenButGoldnn,Ohh wow,0,0,0,237,https://x.com/BrokenButGoldnn/status/1971047891990085775,https://x.com/IndoPopBase/status/1971040394839486675,0
2025-09-25 10:32:33+00:00,iknowmyfeel,Apa ini yg bakal ditayangkan indosiar?,0,0,0,61,https://x.com/iknowmyfeel/status/1971160890931294534,https://x.com/IndoPopBase/status/1971040394839486675,0
2025-09-25 04:06:12+00:00,jakarta48fansid,She should be the mc,0,0,0,59,https://x.com/jakarta48fansid/status/1971063663445561446,https://x.com/IndoPopBase/status/1971040394839486675,0
2025-09-25 04:05:14+00:00,SaddamPradika,"Salah satu hal yang patut disyukuri Ikal dan teman-temannya adalah sekolah mereka tidak mendapatkan EmBeGe, sehingga mereka bisa belajar dan meraih mimpi-mimpinya",2,35,0,11898,https://x.com/SaddamPradika/status/1971063419517403434,https://x.com/IndoPopBase/status/1971030844346335392,37
2025-09-25 04:10:20+00:00,mubadminton,Entah berapa kali nangis gua di bagian lintang tau bapaknya meninggal. Udah cuma gitu aja. Gak ada drama2. Gak ada flashback2 di laut atau apa2. TIba2 semua di bioskop kaget aja pas suratnya dibacain. Fuckkkk heratbreaking.,0,21,0,7819,https://x.com/mubadminton/status/1971064704765489517,https://x.com/IndoPopBase/status/1971030844346335392,21
2025-09-26 02:00:58+00:00,_littlerui,"""... Ayahku telah meninggal. Besok aku akan datang ke sekolah untuk mengucapkan salam perpisahan""

That line broke my heart so many times. And yet 17 years later we cannot stop another Lintang leaving school due to the poor economy.",4,36,0,3189,https://x.com/_littlerui/status/1971394536145551391,https://x.com/IndoPopBase/status/1971030844346335392,40
2025-09-25 02:44:03+00:00,ferizast,"Mahar was my crush. He's so charming and easy-going. That song, Bunga Seroja one, was very suit him. RIP Verrys Yamarno, you were a star!",1,32,0,7188,https://x.com/ferizast/status/1971042987531771931,https://x.com/IndoPopBase/status/1971030844346335392,33
2025-09-25 02:41:26+00:00,ur_fave_homeboy,"Pemeran filmnya kayak kena curse gitu ya, ada yg meninggal muda, ada yg terjebak kriminal, ada yg hidupnya jadi melarat ",3,10,0,6826,https://x.com/ur_fave_homeboy/status/1971042331714630037,https://x.com/IndoPopBase/status/1971030844346335392,13
2025-09-25 02:03:35+00:00,kiokio878,Time fly really fast because just crazy how one of their main character became human trafficker,12,12,0,10581,https://x.com/kiokio878/status/1971032805561024567,https://x.com/IndoPopBase/status/1971030844346335392,24
2025-09-25 13:55:53+00:00,dodondwiprastyo,Dan saya ada versi Korea-nya,1,7,0,5828,https://x.com/dodondwiprastyo/status/1971212060718694856,https://x.com/IndoPopBase/status/1971030844346335392,8
2025-09-25 02:32:21+00:00,yhoxcendolz,"Adegan Lintang harus berpisah sama teman2nya itu bikin banjir air mata, padahal cuma berpisah.",0,0,0,4242,https://x.com/yhoxcendolz/status/1971040044678000894,https://x.com/IndoPopBase/status/1971030844346335392,0
2025-09-25 03:39:40+00:00,umbiiiiiii,"The movie, and even more so the book, was so eye jarring I can’t muster the courage to rewatch and reread it.

In contrary, read Sang Pemimpi and Edensor 2-3 times already.",0,12,0,5854,https://x.com/umbiiiiiii/status/1971056984842698884,https://x.com/IndoPopBase/status/1971030844346335392,12
2025-09-25 15:46:07+00:00,hszajast,Funfact: ni sekolah sama pantai yg banyak batu2 gede tempat anak2 main sama lari larian itu jauhhhhhhhhh kali,3,2,0,3173,https://x.com/hszajast/status/1971239802101190695,https://x.com/IndoPopBase/status/1971030844346335392,5
2025-09-25 04:23:27+00:00,TheaRizkyyy,Banyak orang yg pertama nonton bioskop tuh di film ini,6,8,0,3795,https://x.com/TheaRizkyyy/status/1971068002994094409,https://x.com/IndoPopBase/status/1971030844346335392,14
2025-09-25 15:50:55+00:00,skedush_,"Film pertama yang gua tonton di Bioskop ini ternyata udah 17 tahun lalu.

Inget banget waktu ayahnya Lintang dimakan buaya, lomba cerdas cermat. Walaupun gua saat itu masih bocah, tapi itu ngena banget dan jadi core memory gua soal film bioskop.",7,1,0,2771,https://x.com/skedush_/status/1971241010740199768,https://x.com/IndoPopBase/status/1971030844346335392,8
2025-09-25 11:15:48+00:00,shotgunputer,Mungkin ini satu2nya film Indo yg booming tapi pemerannya banyak yang ga tenar.,1,0,0,2212,https://x.com/shotgunputer/status/1971171776811106598,https://x.com/IndoPopBase/status/1971030844346335392,1
2025-09-25 14:31:21+00:00,riderhusqvarna,"pertama kali nangis di bioskop njir, pas adegan lintang berenti sekolah krn harus kerja gantiin bokapnya yg meninggal di laut. gw kelas 6SD nonton di hari pertama rilis ternyata rame banget dan dapet kursi paling depan",0,0,0,1602,https://x.com/riderhusqvarna/status/1971220988227719323,https://x.com/IndoPopBase/status/1971030844346335392,0
2025-09-25 13:22:20+00:00,jakfest1,"Ada Apa dengan Cinta, Petualangan Sherina, Laskar Pelangi. Sepertinya film Miles tuh “berhenti” di trifecta ini.",1,0,0,1407,https://x.com/jakfest1/status/1971203617446388041,https://x.com/IndoPopBase/status/1971030844346335392,1
2025-09-25 15:00:40+00:00,eufouriya,"ingettt banget pertama kali ke bioskop nonton film ini sama bapak. bapak masih hidup namun sudah tidak sefit yang dulu. dad, i miss watching movies with you",2,0,0,1251,https://x.com/eufouriya/status/1971228364615950614,https://x.com/IndoPopBase/status/1971030844346335392,2
2025-09-25 18:19:57+00:00,jamurkinoko,penyanyinya jadi kacung,0,1,0,170,https://x.com/jamurkinoko/status/1971278517586591819,https://x.com/IndoPopBase/status/1971030844346335392,1
2025-09-25 03:48:11+00:00,dutchppl,,0,0,0,685,https://x.com/dutchppl/status/1971059129193247200,https://x.com/IndoPopBase/status/1971030844346335392,0
2025-09-25 16:33:48+00:00,rifqi_salafi,"Novelnya tuh ""kiri"" banget aslinya ",2,0,0,613,https://x.com/rifqi_salafi/status/1971251802764083277,https://x.com/IndoPopBase/status/1971030844346335392,2
2025-09-25 09:45:42+00:00,·,Perasaan baru kemarin nonton film ini,0,1,0,275,https://x.com/bajulebarannn/status/1971149100625297804,https://x.com/IndoPopBase/status/1971030844346335392,1
2025-09-26 04:52:44+00:00,aliceveryday,"I cried a lot watching this in the cinema back then, never knew that this is still happening in 2025, the Oslo fam and prabs really ruined our country.",0,0,0,174,https://x.com/aliceveryday/status/1971437760574853176,https://x.com/IndoPopBase/status/1971030844346335392,0
2025-09-25 07:50:16+00:00,daehypeelS_,"Schools needed to made a mandatory watch for this movie, im being serious",0,0,0,900,https://x.com/daehypeelS_/status/1971120050842251658,https://x.com/IndoPopBase/status/1971030844346335392,0
2025-09-25 23:28:53+00:00,amirwawan_,17 tahun masih banyak sekolah gak layak,0,1,0,249,https://x.com/amirwawan_/status/1971356261469094259,https://x.com/IndoPopBase/status/1971030844346335392,1
2025-09-25 23:09:34+00:00,sereineid,"Ya Allahh.. what a momenttt, gamau rewatch nanti nangis lagiiii",0,0,0,306,https://x.com/sereineid/status/1971351400669118482,https://x.com/IndoPopBase/status/1971030844346335392,0
2025-09-25 02:20:52+00:00,ErnaPrihantini,Totochan nya Indonesia ,0,0,0,792,https://x.com/ErnaPrihantini/status/1971037156723593713,https://x.com/IndoPopBase/status/1971030844346335392,0
2025-09-25 16:42:09+00:00,iciiiiil,"I love everything about this, especially the book, my very first book yang bikin bolak balik ke perpus sekolah buat baca ",0,0,0,498,https://x.com/iciiiiil/status/1971253903296713181,https://x.com/IndoPopBase/status/1971030844346335392,0
2025-09-25 09:23:51+00:00,deetoh,satu2nya flop dr film ini cuman Lukman sardi.. lol,0,0,0,426,https://x.com/deetoh/status/1971143600835789310,https://x.com/IndoPopBase/status/1971030844346335392,0
2025-09-25 04:47:34+00:00,dimoonlock,Better than jumbo,1,0,0,238,https://x.com/dimoonlock/status/1971074073217355820,https://x.com/IndoPopBase/status/1971030844346335392,1
2025-09-25 14:36:52+00:00,BeginiCeritany1,Still waiting for maryamah karpov,0,0,0,289,https://x.com/BeginiCeritany1/status/1971222377255284955,https://x.com/IndoPopBase/status/1971030844346335392,0
2025-09-25 03:20:36+00:00,bolakbalikdiary,Ini nonton legalnya dmn sih gaesss ponakan aku yg gen alpha pengen nonton:(,3,0,0,3894,https://x.com/bolakbalikdiary/status/1971052186709995920,https://x.com/IndoPopBase/status/1971030844346335392,3
2025-09-25 12:12:12+00:00,EDPrihartati,"Dapat rekomendasi film ini dari 
@vividargarini
 pas kuliah lalu esoknya nobar dengan anak murid sekelas di bioskop Mal Sunter. What a sweet moment.",0,0,0,418,https://x.com/EDPrihartati/status/1971185969073356840,https://x.com/IndoPopBase/status/1971030844346335392,0
2025-09-25 16:27:43+00:00,nishenmele,And i still haven't reached my dream yet,0,0,0,198,https://x.com/nishenmele/status/1971250271448953200,https://x.com/IndoPopBase/status/1971030844346335392,0
2025-09-25 09:50:37+00:00,·,,0,0,0,75,https://x.com/versylus/status/1971150337768816939,https://x.com/IndoPopBase/status/1971030844346335392,0
2025-09-26 19:56:28+00:00,LJamlus,I just read the book!,0,0,0,20,https://x.com/LJamlus/status/1971665194041725163,https://x.com/IndoPopBase/status/1971030844346335392,0
2025-09-25 02:16:30+00:00,simpcityid,"Watching alone, and cry. ",0,0,0,560,https://x.com/simpcityid/status/1971036055609672172,https://x.com/IndoPopBase/status/1971030844346335392,0
2025-09-25 04:53:27+00:00,callmeanythng,Wow tua bgt gue,0,0,0,271,https://x.com/callmeanythng/status/1971075554595176719,https://x.com/IndoPopBase/status/1971030844346335392,0
2025-09-25 11:59:54+00:00,Imanavila1,"Film yang pertama kali aku tonton di bioskop. Endingnya kan sedih banget tuh, malu banget pas keluar bioskop mata masih sembab ",0,0,0,888,https://x.com/Imanavila1/status/1971182873958023303,https://x.com/IndoPopBase/status/1971030844346335392,0
2025-09-25 02:47:22+00:00,aukseen,Legend,0,0,0,3510,https://x.com/aukseen/status/1971043825125839271,https://x.com/IndoPopBase/status/1971030844346335392,0
2025-09-25 04:36:36+00:00,EndaJapar,thebest!,0,0,0,71,https://x.com/EndaJapar/status/1971071312476110974,https://x.com/IndoPopBase/status/1971030844346335392,0
2025-09-25 18:15:21+00:00,amoreplumette,hh time really flies so fastt. film pertama yg aku tonton di bioskopp ,0,0,0,24,https://x.com/amoreplumette/status/1971277359052636261,https://x.com/IndoPopBase/status/1971030844346335392,0
2025-09-25 16:23:51+00:00,naszrul,Feel old yet?,0,0,0,93,https://x.com/naszrul/status/1971249299175706975,https://x.com/IndoPopBase/status/1971030844346335392,0
2025-09-25 01:57:28+00:00,EVM0x_nads,makasih film yg menemani masa kecilku,0,0,0,3321,https://x.com/EVM0x_nads/status/1971031265878131081,https://x.com/IndoPopBase/status/1971030844346335392,0
2025-09-25 01:56:23+00:00,AnnafiBG,Menarilah dan terus tertawa…..,0,0,0,3148,https://x.com/AnnafiBG/status/1971030993265168852,https://x.com/IndoPopBase/status/1971030844346335392,0
2025-09-25 15:44:38+00:00,antigvla,Lintang! Bujang kecil berkulit hitam mengayuh kebut sepedanya~,1,0,0,1205,https://x.com/antigvla/status/1971239429206675938,https://x.com/IndoPopBase/status/1971030844346335392,1
2025-09-25 14:47:04+00:00,Xyomarana,Pertama kali ke bioskop karena film ini,0,0,0,186,https://x.com/Xyomarana/status/1971224940323193036,https://x.com/IndoPopBase/status/1971030844346335392,0
2025-09-25 15:10:47+00:00,kmplx24,,0,0,0,895,https://x.com/kmplx24/status/1971230910382264500,https://x.com/IndoPopBase/status/1971030844346335392,0
2025-09-25 07:31:26+00:00,ininuno,Booming bgt dulu sama lagunya juga!,0,0,0,44,https://x.com/ininuno/status/1971115312117690597,https://x.com/IndoPopBase/status/1971030844346335392,0
2025-09-25 14:28:13+00:00,leenovel,"one of my comfort movie  bunga seroojaa aaaa~ cepet bgt deh waktu, perasaan baru diajak nobar film ini pas msih sd",0,0,0,244,https://x.com/leenovel/status/1971220196716327112,https://x.com/IndoPopBase/status/1971030844346335392,0
2025-09-25 13:00:55+00:00,CtrlAltDelayy,"lah perasaan ini film jaman SD
waittt
AKU DAH 28",0,0,0,924,https://x.com/CtrlAltDelayy/status/1971198228650656112,https://x.com/IndoPopBase/status/1971030844346335392,0
2025-09-25 11:58:26+00:00,mooneliaz,"I remember going to the cinema with my mum and my brother to watch this movie, and I can’t believe it’s been 17 years ",0,0,0,541,https://x.com/mooneliaz/status/1971182505194844432,https://x.com/IndoPopBase/status/1971030844346335392,0
2025-09-24 12:47:16+00:00,SaddamWeb3,"hanya keteledoran kata king Dadan

nunggu berapa korban lagi baru di stop pak prabu?",0,1,0,3135,https://x.com/SaddamWeb3/status/1970832406715531746,https://x.com/IndoPopBase/status/1970815187885457679,1
2025-09-24 11:42:49+00:00,hadilocoboy,siapa sih awalnya yg ngide MBG ini ?,5,0,0,3588,https://x.com/hadilocoboy/status/1970816184758206675,https://x.com/IndoPopBase/status/1970815187885457679,5
2025-09-24 17:09:04+00:00,skingameofc,can we just stop :(,0,0,0,309,https://x.com/skingameofc/status/1970898290704265679,https://x.com/IndoPopBase/status/1970815187885457679,0
2025-09-24 11:45:05+00:00,kiokio878,And that bastard biji peler satu refuse to stop this program just for his ego and of course money his people get from this bullshit program,1,13,0,2357,https://x.com/kiokio878/status/1970816758157336626,https://x.com/IndoPopBase/status/1970815187885457679,14
2025-09-24 11:56:42+00:00,SanjaiBaladoo,Ada anak pejabat yg keracunan ga? Kalau ga ada mah yah ga akan peduli mereka. Bodo amat Ama nyawa rakyat jelata. Bukan anak mereka.,2,8,0,4004,https://x.com/SanjaiBaladoo/status/1970819682312839241,https://x.com/IndoPopBase/status/1970815187885457679,10
2025-09-24 11:47:34+00:00,noireublanc,"at this rate, I think this is how the government prevents poverty spreading in Indonesia....",2,3,0,2657,https://x.com/noireublanc/status/1970817380352942338,https://x.com/IndoPopBase/status/1970815187885457679,5
2025-09-24 11:57:15+00:00,ayernmin,"this is concerning, atp health authorities should step in quickly to investigate and ensure proper care for the students",0,0,0,2628,https://x.com/ayernmin/status/1970819819621789711,https://x.com/IndoPopBase/status/1970815187885457679,0
2025-09-24 19:40:49+00:00,ryotxt46,"Vendor salah, iya. Tapi kalau keracunan terjadi di banyak daerah berarti sistemnya jelek. Kalau sistemnya bagus palingan dua bulan sekali lah kejadian karena kelalaian vendor. Kalau hampir tiap hari gini ya sistemnya jelek, udah",0,0,0,450,https://x.com/ryotxt46/status/1970936478999130329,https://x.com/IndoPopBase/status/1970815187885457679,0
2025-09-24 12:55:27+00:00,admiralkizaruuu,"Selama bukan keluarga mereka yg mengalami, program ini akan lanjut terus sampe kiamat",0,0,0,3493,https://x.com/admiralkizaruuu/status/1970834464281625004,https://x.com/IndoPopBase/status/1970815187885457679,0
2025-09-24 12:25:02+00:00,ndroe_,really don't know how to say,0,0,0,2116,https://x.com/ndroe_/status/1970826808670183772,https://x.com/IndoPopBase/status/1970815187885457679,0
2025-09-24 16:18:12+00:00,avvogat_o,"Setiap kebijakan rejim yg menimbulkan korban, gua selalu teringat Kamis - Hindia.",0,0,0,1068,https://x.com/avvogat_o/status/1970885488270790881,https://x.com/IndoPopBase/status/1970815187885457679,0
2025-09-24 16:57:09+00:00,RedCliff256,"Nyawa orang itu, pak",0,0,0,230,https://x.com/RedCliff256/status/1970895290686374364,https://x.com/IndoPopBase/status/1970815187885457679,0
2025-09-25 04:15:47+00:00,wron9word,"oomf please look at this 
@prabowo",0,0,0,27,https://x.com/wron9word/status/1971066075501691405,https://x.com/IndoPopBase/status/1970815187885457679,0
2025-09-25 08:01:05+00:00,bareda,Worse than mass possession (kerasukan massal).,0,0,0,181,https://x.com/bareda/status/1971122772182208564,https://x.com/IndoPopBase/status/1970815187885457679,0
2025-09-24 11:43:04+00:00,PROSPERDEGREAT,Authorities need to explain fast what caused it and how it spread that wide.,0,0,0,1540,https://x.com/PROSPERDEGREAT/status/1970816251422490736,https://x.com/IndoPopBase/status/1970815187885457679,0
2025-09-24 11:42:31+00:00,PROSPERDEGREAT,500 is a scary number,0,0,0,666,https://x.com/PROSPERDEGREAT/status/1970816110737121599,https://x.com/IndoPopBase/status/1970815187885457679,0
2025-09-24 11:42:26+00:00,ursteulyNaveen,That’s really alarming  Hoping all the students recover quickly and authorities find the cause soon.,0,0,0,515,https://x.com/ursteulyNaveen/status/1970816089354535391,https://x.com/IndoPopBase/status/1970815187885457679,0
2025-09-24 11:44:25+00:00,sugar_6378,"Semoga cepat selesai dan segera diatasi.
Kasihan adek2 kita ",0,0,0,690,https://x.com/sugar_6378/status/1970816589462483007,https://x.com/IndoPopBase/status/1970815187885457679,0
2025-09-24 12:24:09+00:00,is_pelssy,OMG News about MBG always exists..,0,0,0,517,https://x.com/is_pelssy/status/1970826587026378869,https://x.com/IndoPopBase/status/1970815187885457679,0
2025-09-24 18:14:21+00:00,Justrayman11,"If someone's child dies because this stupid policy, we need to BRING DOWN THIS REGIME TO THE GRAVE!.",0,0,0,17,https://x.com/Justrayman11/status/1970914719218401490,https://x.com/IndoPopBase/status/1970815187885457679,0
2025-09-25 02:40:47+00:00,Inezslytn,gila sumpah,0,0,0,27,https://x.com/Inezslytn/status/1971042168082170191,https://x.com/IndoPopBase/status/1970815187885457679,0
2025-09-24 19:02:15+00:00,sperlunya,"duit pajak lo pada dari gaji yg ga bikin lo kaya raya itu kalo ga dipake buat biaya high-maintenance lifestyle ani2, bayarin bill dugem anak pejabat (+ circle pertemanannya ofc, untuk jadi certified spender), atau ya buat bahan baku senjata biologis aliasss MBG ini ",0,0,0,269,https://x.com/sperlunya/status/1970926774122061871,https://x.com/IndoPopBase/status/1970815187885457679,0
2025-09-25 08:12:36+00:00,yohandsup,makan beracun gratis,0,0,0,19,https://x.com/yohandsup/status/1971125670907617625,https://x.com/IndoPopBase/status/1970815187885457679,0
2025-09-24 14:16:51+00:00,creamycump,Mantapp Makan Beracun Gratis ,0,0,0,15,https://x.com/creamycump/status/1970854949656621470,https://x.com/IndoPopBase/status/1970815187885457679,0
2025-09-25 01:33:31+00:00,kitschize,unfortunately it just a number for him ( we're so doomed ),0,0,0,21,https://x.com/kitschize/status/1971025239527322013,https://x.com/IndoPopBase/status/1970815187885457679,0
2025-09-24 12:12:15+00:00,sayaobito,all of this is big old baby fault,0,0,0,58,https://x.com/sayaobito/status/1970823593157353903,https://x.com/IndoPopBase/status/1970815187885457679,0
2025-09-24 21:21:05+00:00,sidi_repo,"Kalau di US ada mass school shooting, di indo ada mass food poisoning.",0,0,0,51,https://x.com/sidi_repo/status/1970961711353172357,https://x.com/IndoPopBase/status/1970815187885457679,0
2025-09-24 12:18:35+00:00,vatefoutre,this is so concerning..,0,0,0,236,https://x.com/vatefoutre/status/1970825185604653066,https://x.com/IndoPopBase/status/1970815187885457679,0
2025-09-24 15:35:41+00:00,plavar87,Gila banget yg bilang siswa keracunan gimmick  segitunya ngebela goblogverrment,0,0,0,231,https://x.com/plavar87/status/1970874787737350166,https://x.com/IndoPopBase/status/1970815187885457679,0
2025-09-24 12:29:50+00:00,tjoetfitria,sumpah ini 500 itu orang kan? manusia kan? ini lapornya ke siapa si anjir ga tega banget ,0,0,0,532,https://x.com/tjoetfitria/status/1970828019448385852,https://x.com/IndoPopBase/status/1970815187885457679,0
2025-09-24 12:04:39+00:00,TejaAru05798875,That useless fugly MBG,0,0,0,93,https://x.com/TejaAru05798875/status/1970821682752540720,https://x.com/IndoPopBase/status/1970815187885457679,0
2025-09-24 14:24:52+00:00,Cheesechoco123,MBG program yang gagal ,0,0,0,55,https://x.com/Cheesechoco123/status/1970856967460868391,https://x.com/IndoPopBase/status/1970815187885457679,0
2025-09-24 15:12:58+00:00,billllliiee,"Lagi nungguin 
@corbuzier
 komen. Udah sampe ribuan jadi korban nih",0,0,0,83,https://x.com/billllliiee/status/1970869073694318900,https://x.com/IndoPopBase/status/1970815187885457679,0
2025-09-24 15:17:48+00:00,parkyshall,Kepala BGN harusnya mundur,0,0,0,109,https://x.com/parkyshall/status/1970870290491338903,https://x.com/IndoPopBase/status/1970815187885457679,0
2025-09-24 11:59:29+00:00,idiotsandbeach,this is what you get for electing a mass murderer as a president,0,0,0,128,https://x.com/idiotsandbeach/status/1970820379037057347,https://x.com/IndoPopBase/status/1970815187885457679,0
2025-09-24 11:43:40+00:00,orgility,kataku stop,0,0,0,256,https://x.com/orgility/status/1970816399477281240,https://x.com/IndoPopBase/status/1970815187885457679,0
2025-09-24 12:19:41+00:00,railgunvelocity,Makan Beracun Gratis for a reason,0,0,0,142,https://x.com/railgunvelocity/status/1970825464995622991,https://x.com/IndoPopBase/status/1970815187885457679,0
2025-09-25 04:09:44+00:00,afcdevan,"'West Bandung' Please replace it with Kabupaten Bandung Barat aka KBB, because this is a different government area that still includes Bandung Raya  such as Kota Bandung, Cimahi, Kabupaten Bandung.

Btw, the Bupati is Jeje Govinda, husband of Syahnaz, Raffi Ahmad's younger sister",0,0,0,128,https://x.com/afcdevan/status/1971064551807516901,https://x.com/IndoPopBase/status/1970815187885457679,0
2025-09-25 06:10:09+00:00,aysareed,There you go..,0,0,0,29,https://x.com/aysareed/status/1971094855960101309,https://x.com/IndoPopBase/status/1970815187885457679,0
2025-09-24 11:51:34+00:00,DirutPertamin4,sengaja dibikin beracun biar ngga malu-maluin kalau programnya diberhentikan ceunah,0,0,0,511,https://x.com/DirutPertamin4/status/1970818389427060835,https://x.com/IndoPopBase/status/1970815187885457679,0
2025-09-24 12:51:56+00:00,for_humanityIND,"KAYA GINI MASIH LANJUT???
GILAK SIHH!!!",0,0,0,64,https://x.com/for_humanityIND/status/1970833578960601601,https://x.com/IndoPopBase/status/1970815187885457679,0
2025-09-24 19:16:50+00:00,HermaOnce_,"- investasikan gelontoran dana ratusan - ribuan T itu ke kualitas pendidikan, beasiswa & kesejahteraan tenaga pengajar. Bangun SDM nya

Dahlah stop MBG ini banyak masalah",0,0,0,387,https://x.com/HermaOnce_/status/1970930443303457184,https://x.com/IndoPopBase/status/1970815187885457679,0
2025-09-24 18:12:23+00:00,utdstewie,The new pandemic,0,0,0,37,https://x.com/utdstewie/status/1970914225339146263,https://x.com/IndoPopBase/status/1970815187885457679,0
2025-09-24 12:34:15+00:00,penyihirrr,harus stop cok ini pelaksanaannya udh ngawur bgt,0,0,0,172,https://x.com/penyihirrr/status/1970829128665559511,https://x.com/IndoPopBase/status/1970815187885457679,0
2025-09-24 12:27:17+00:00,keustruckpdf,udahan njr??? @ prbw,0,0,0,25,https://x.com/keustruckpdf/status/1970827377392705948,https://x.com/IndoPopBase/status/1970815187885457679,0
2025-09-24 14:57:32+00:00,tayloveslorde,"Shut down this stupid program, omg.",0,0,0,24,https://x.com/tayloveslorde/status/1970865190351819121,https://x.com/IndoPopBase/status/1970815187885457679,0
2025-09-24 16:29:10+00:00,gukiezs,berhentiin aja kek program gajelas ini.,0,0,0,29,https://x.com/gukiezs/status/1970888248059969738,https://x.com/IndoPopBase/status/1970815187885457679,0
2025-09-24 12:09:28+00:00,carlosbumn,"Free meals turning into free poison, 500 kids down, and wowo out here bragging about success. Man, this is not policy, this is public health terrorism dressed up as welfare",0,1,0,66,https://x.com/carlosbumn/status/1970822895028011103,https://x.com/IndoPopBase/status/1970815187885457679,1
2025-09-27 14:00:49+00:00,SuzukoK70447,"That’s really concerning! I remember a similar incident in my school. It was so scary, and I felt helpless. Now I realize how important safety protocols are in schools.",0,0,0,0,https://x.com/SuzukoK70447/status/1971938080182751530,https://x.com/IndoPopBase/status/1970815187885457679,0
2025-09-24 16:18:08+00:00,MvGuJ0z0wp56662,That's a really concerning situation!  What do you think caused it?,0,0,0,4,https://x.com/MvGuJ0z0wp56662/status/1970885470247915687,https://x.com/IndoPopBase/status/1970815187885457679,0
2025-09-24 11:38:06+00:00,himbosapiens,"It's never too late to claim ballad again my girl 
@agnezmo",0,0,0,1164,https://x.com/himbosapiens/status/1970814998583922920,https://x.com/IndoPopBase/status/1970812843508498737,0
2025-09-24 11:35:44+00:00,abouqueofroses,"jujur, afgan ganteng banget jir

I mean, like fork found in the kitchen, I guess...",0,0,0,1403,https://x.com/abouqueofroses/status/1970814402900406765,https://x.com/IndoPopBase/status/1970812843508498737,0
2025-09-24 12:25:06+00:00,vosverseau,We want wallflower 2.0,1,0,0,928,https://x.com/vosverseau/status/1970826828723183676,https://x.com/IndoPopBase/status/1970812843508498737,1
2025-09-24 12:34:17+00:00,·,"Tbh, I’ve got high expectations for Afgan’s new album. He’s working with such amazing musicians and I can’t wait to hear the songs—especially the sad ones",0,0,0,715,https://x.com/whiterosestea/status/1970829137331011922,https://x.com/IndoPopBase/status/1970812843508498737,0
2025-09-24 11:53:32+00:00,tarokar01,The king of indonesian ballad is back,0,0,0,670,https://x.com/tarokar01/status/1970818882731692501,https://x.com/IndoPopBase/status/1970812843508498737,0
2025-09-24 11:39:29+00:00,bioplacenton13,No Bebi Romeo???,0,0,0,450,https://x.com/bioplacenton13/status/1970815347155710394,https://x.com/IndoPopBase/status/1970812843508498737,0
2025-09-25 07:57:57+00:00,cupang_fish,"Jujur lagu - lagu inggris afgan kurang ngena di gua sih, kayak gak ada nyawanya. 
Bagus deh kalo dia lebih milih genre indo ballad lagi.",0,0,0,109,https://x.com/cupang_fish/status/1971121983112008069,https://x.com/IndoPopBase/status/1970812843508498737,0
2025-09-24 11:39:27+00:00,dimoonlock,Oh af(a)gan we know what ur intention with those men,0,0,0,667,https://x.com/dimoonlock/status/1970815341086593316,https://x.com/IndoPopBase/status/1970812843508498737,0
2025-09-24 11:38:31+00:00,dosilasel,Itu petra apa chris cornell tuh??,0,0,0,905,https://x.com/dosilasel/status/1970815104418803745,https://x.com/IndoPopBase/status/1970812843508498737,0
2025-09-24 11:45:31+00:00,ursteulyNaveen,"Exciting news! Afgan's teaming up with Bilal Indrajaya, Petra Sihombing, and Kamga for his first Indonesian-language album in seven years, ‘RETROSPEKTIF,’ returning to his roots. Can’t wait to hear it!",0,0,0,722,https://x.com/ursteulyNaveen/status/1970816865963520039,https://x.com/IndoPopBase/status/1970812843508498737,0
2025-09-24 11:43:49+00:00,PROSPERDEGREAT,Feels like this album will hit closer to home for his fans,0,0,0,692,https://x.com/PROSPERDEGREAT/status/1970816436949127289,https://x.com/IndoPopBase/status/1970812843508498737,0
2025-09-24 11:43:41+00:00,PROSPERDEGREAT,Going back to Indonesian after 7 years is a big move,0,0,0,635,https://x.com/PROSPERDEGREAT/status/1970816404028039318,https://x.com/IndoPopBase/status/1970812843508498737,0
2025-09-25 06:52:39+00:00,Yoimdiya,"KAK kamga???? 
@1997flr",0,0,0,11,https://x.com/Yoimdiya/status/1971105550344839382,https://x.com/IndoPopBase/status/1970812843508498737,0
2025-09-24 13:15:30+00:00,SINGKITMYLUV,WE WANT BALLADS,0,0,0,293,https://x.com/SINGKITMYLUV/status/1970839512717853051,https://x.com/IndoPopBase/status/1970812843508498737,0
2025-09-26 02:11:31+00:00,Washyourkiss,"As if your english song getting recognition,  that's why you comeback to your root again.",0,0,0,28,https://x.com/Washyourkiss/status/1971397190825521573,https://x.com/IndoPopBase/status/1970812843508498737,0
2025-09-24 11:44:19+00:00,·,Menarik,0,0,0,434,https://x.com/nami_singkat/status/1970816562480500778,https://x.com/IndoPopBase/status/1970812843508498737,0
2025-09-24 11:39:01+00:00,·,can't wait hhe,0,0,0,616,https://x.com/masaendeberr/status/1970815231875330335,https://x.com/IndoPopBase/status/1970812843508498737,0
2025-09-24 14:22:32+00:00,·,expectation ,0,0,0,338,https://x.com/lpjvfeh4tncuawd/status/1970856380673450178,https://x.com/IndoPopBase/status/1970812843508498737,0
2025-09-25 02:17:09+00:00,ferizast,wow,0,0,0,71,https://x.com/ferizast/status/1971036219384684919,https://x.com/IndoPopBase/status/1970812843508498737,0
2025-09-24 12:22:02+00:00,·,BILALLL,0,0,0,319,https://x.com/_adelaidesky/status/1970826056526598344,https://x.com/IndoPopBase/status/1970812843508498737,0
2025-09-25 06:37:30+00:00,cooooffav,CANT WAITTTTTT,0,0,0,59,https://x.com/cooooffav/status/1971101739089805720,https://x.com/IndoPopBase/status/1970812843508498737,0
2025-09-25 02:24:58+00:00,YudhiNOW,they all can top me,0,0,0,72,https://x.com/YudhiNOW/status/1971038188073619789,https://x.com/IndoPopBase/status/1970812843508498737,0
2025-09-24 12:09:53+00:00,arwahgoyangkrwg,Agnezmo when,0,0,0,210,https://x.com/arwahgoyangkrwg/status/1970822997083828331,https://x.com/IndoPopBase/status/1970812843508498737,0
2025-09-24 12:51:03+00:00,piscesquest,i will be seated,0,0,0,452,https://x.com/piscesquest/status/1970833359082562031,https://x.com/IndoPopBase/status/1970812843508498737,0
2025-09-25 06:13:43+00:00,CheVuole1,Akhirnya afgan's ballad era is back,0,0,0,61,https://x.com/CheVuole1/status/1971095754111651941,https://x.com/IndoPopBase/status/1970812843508498737,0
2025-09-24 12:14:02+00:00,nadyaiskndrr,menarikkk,0,0,0,328,https://x.com/nadyaiskndrr/status/1970824041616609386,https://x.com/IndoPopBase/status/1970812843508498737,0
2025-09-25 12:10:07+00:00,dinisuciyanti,WAWWWWWWW,0,0,0,46,https://x.com/dinisuciyanti/status/1971185445393531124,https://x.com/IndoPopBase/status/1970812843508498737,0
2025-09-24 14:16:06+00:00,abhiemz,Musisi hebat semua nih. Bakalan keren lagu-lagunya.,0,0,0,201,https://x.com/abhiemz/status/1970854761194025140,https://x.com/IndoPopBase/status/1970812843508498737,0
2025-09-24 12:05:17+00:00,brodeldi,Menarik,0,0,0,187,https://x.com/brodeldi/status/1970821839867027878,https://x.com/IndoPopBase/status/1970812843508498737,0
2025-09-25 02:51:10+00:00,Th3Tr4vel3r,afgan is back,0,0,0,247,https://x.com/Th3Tr4vel3r/status/1971044779422253274,https://x.com/IndoPopBase/status/1970812843508498737,0
2025-09-24 12:03:15+00:00,rezkiamda62,,0,0,0,183,https://x.com/rezkiamda62/status/1970821329415983205,https://x.com/IndoPopBase/status/1970812843508498737,0
2025-09-24 11:16:49+00:00,PROSPERDEGREAT,I'm curious to see how his sound has evolved on this one,0,0,0,372,https://x.com/PROSPERDEGREAT/status/1970809644030545933,https://x.com/IndoPopBase/status/1970809406205075947,0
2025-09-24 11:16:35+00:00,PROSPERDEGREAT,Seven albums in and still going strong,0,0,0,359,https://x.com/PROSPERDEGREAT/status/1970809583347384726,https://x.com/IndoPopBase/status/1970809406205075947,0
2025-09-24 11:28:39+00:00,hayatgunawann,Federico barba,0,0,0,253,https://x.com/hayatgunawann/status/1970812621248143366,https://x.com/IndoPopBase/status/1970809406205075947,0
2025-09-24 11:23:19+00:00,Soraya_0615,Lets Gooo,0,0,0,293,https://x.com/Soraya_0615/status/1970811278877933628,https://x.com/IndoPopBase/status/1970809406205075947,0
2025-09-24 11:30:53+00:00,firzafp,"Mohon ""geo-blocking"" diskografi Afgan untuk pengguna Israel dalam semua layanan......",0,0,0,227,https://x.com/firzafp/status/1970813182890623435,https://x.com/IndoPopBase/status/1970809406205075947,0
2025-09-24 11:46:43+00:00,·,i've liked this post,0,0,0,205,https://x.com/masaendeberr/status/1970817168435785991,https://x.com/IndoPopBase/status/1970809406205075947,0
2025-09-24 11:17:07+00:00,CorenswetsSlut,RetroFLOPtif ,2,0,0,342,https://x.com/CorenswetsSlut/status/1970809719989416151,https://x.com/IndoPopBase/status/1970809406205075947,2
2025-09-25 02:51:37+00:00,Th3Tr4vel3r,makin kinclong nih mas afgan,0,0,0,67,https://x.com/Th3Tr4vel3r/status/1971044892244902253,https://x.com/IndoPopBase/status/1970809406205075947,0
2025-09-24 12:06:08+00:00,bluemoonikii,Flop,1,0,0,208,https://x.com/bluemoonikii/status/1970822054757982695,https://x.com/IndoPopBase/status/1970809406205075947,1
2025-10-09 09:27:44+00:00,QUEERAUSAHAAN,ammar zoni is the best anti-drug ad cause WTF HAPPENED like oh my god…..,123,890,0,572581,https://x.com/QUEERAUSAHAAN/status/1976218010957512842,https://x.com/IndoPopBase/status/1970809406205075947,1013
2025-10-09 05:36:59+00:00,mhwnk_,the outfit:                      the scent:,176,1775,0,376972,https://x.com/mhwnk_/status/1976159937651933484,https://x.com/IndoPopBase/status/1970809406205075947,1951
2025-10-09 17:10:30+00:00,so1air,,201,3902,0,1047579,https://x.com/so1air/status/1976334468966486062,https://x.com/IndoPopBase/status/1970809406205075947,4103
2025-10-09 14:34:33+00:00,findormeme,bunch of elementary school kids revealing their exam passing status while slipping through my fingers is playing on the background meryl streep tidak lulus anak sd nangis dramatic hasil ujian nangis,376,2194,0,1426768,https://x.com/findormeme/status/1976295222960427487,https://x.com/IndoPopBase/status/1970809406205075947,2570
2025-09-24 10:34:05+00:00,Alifahsekaar,"Ga kerja direndahin, kerja independent dimanfaatin, pusing gak jadi wanita",50,2599,0,320543,https://x.com/Alifahsekaar/status/1970798889499509048,https://x.com/IndoPopBase/status/1970786034289107197,2649
2025-09-24 09:54:33+00:00,tippanul,nuntut 100 perak datang di sidang pertama sambil nenteng birkin himalaya harga diri lu di injek bgt ahmad tpi masih bisa ketawa” depan tasya,107,1505,0,530203,https://x.com/tippanul/status/1970788938723025322,https://x.com/IndoPopBase/status/1970786034289107197,1612
2025-09-24 10:25:18+00:00,happyonke,queen tau cara menjatuhkan mantan ,18,888,0,264513,https://x.com/happyonke/status/1970796678065381751,https://x.com/IndoPopBase/status/1970786034289107197,906
2025-09-24 10:48:07+00:00,dno_tscdey,Nemu komen ini di tiktok.,42,757,0,222697,https://x.com/dno_tscdey/status/1970802421925552558,https://x.com/IndoPopBase/status/1970786034289107197,799
2025-09-24 09:45:38+00:00,ur_mindss,"case ini ngingetin aku ke kasus kai yg kmrn sempet gesekan sama kraton, trus kraton minta uang denda ke kai cuma sebesar 1.000 (it means nyuwun sewu = permisi).

kek, kraton tuh gabutuh uang lu  tp minimal lu tau diri anjay @ kai",57,458,0,207982,https://x.com/ur_mindss/status/1970786698360754606,https://x.com/IndoPopBase/status/1970786034289107197,515
2025-09-24 10:17:45+00:00,gabutforlife,"Jujur ini jahat banget, sampe keluarga besar si cowo terlibat korupsi + ngacak2 sertif rumah bu ala tuh emang kejahatan yg di planning!",31,219,0,119678,https://x.com/gabutforlife/status/1970794777454281182,https://x.com/IndoPopBase/status/1970786034289107197,250
2025-09-24 10:02:57+00:00,SaddamWeb3,"nafkah rp100 tuh more like simbolik aja sih, kaya nunjukin tasya basically never dapet nafkah yang proper",5,97,0,143177,https://x.com/SaddamWeb3/status/1970791052857823360,https://x.com/IndoPopBase/status/1970786034289107197,102
2025-09-24 10:49:09+00:00,lecdabin,Tamparan untuk cewe2 berkerja keras lah sampai kalian sukses biar kalo punya pasangan yang selingkuh/mokondo tinggal tinggalin aja gak usah ngemis2 kek gak punya harg diri aja,5,285,0,100006,https://x.com/lecdabin/status/1970802679279755626,https://x.com/IndoPopBase/status/1970786034289107197,290
2025-09-24 10:33:53+00:00,nonnaninaa,"cara terbaik ngancurin ego laki2 adalah dari kemampuan finansialnya  kayak rendah banget harga diri lo cuma ditagih 100 perak, klo gk dipenuhi yaa emng bgst lakinya",3,170,0,62324,https://x.com/nonnaninaa/status/1970798840094785603,https://x.com/IndoPopBase/status/1970786034289107197,173
2025-09-24 10:16:47+00:00,SaddamWeb3,"simbolis 100 perak tapi nusuk banget
menurut lu ada yang lebih hina dari disindir kayak gini ga? wkwkwkw",0,0,0,139174,https://x.com/SaddamWeb3/status/1970794533425451107,https://x.com/IndoPopBase/status/1970786034289107197,0
2025-09-24 10:59:14+00:00,cendikiaaawan,"Buset 100 perak, kadang emg gini ya guys yg keliatan nya muka nya bersih, adem, kaya raya belum tentu memanusiakan istri nya… 

aku selalu berdoa semoga temen2 disini terhindar dari laki2 nggak bertanggung jwb kek gini ",1,4,0,7035,https://x.com/cendikiaaawan/status/1970805216590340593,https://x.com/IndoPopBase/status/1970786034289107197,5
2025-09-24 13:19:06+00:00,SaddamWeb3,"tasya tuh nuntut suaminya rp100 perak doang pas cerai
ini bukan karena dia butuh duit receh, tapi biar keliatan banget kalau suaminya ga ada value.

kaya bilang: nih gw tuntut lo cuma seratus perak, segitu doang harga lo di mata gue

jadi bukan masalah duit, tapi lebih ke",1,1,0,35314,https://x.com/SaddamWeb3/status/1970840418612064310,https://x.com/IndoPopBase/status/1970786034289107197,2
2025-09-24 16:54:38+00:00,KampusUpdate,harga diri langsung jatuh seketika dituntut nafkah Rp100 ,0,0,0,24943,https://x.com/KampusUpdate/status/1970894656969101763,https://x.com/IndoPopBase/status/1970786034289107197,0
2025-09-24 09:54:35+00:00,SaddamWeb3,"suami model gini mah ga jadi sandaran
jadi beban iya. utang numpuk, nafkah nol, duit istri ilang kombo banget.

tasya cuma nuntut 100 perak?",0,1,0,9127,https://x.com/SaddamWeb3/status/1970788946797117678,https://x.com/IndoPopBase/status/1970786034289107197,1
2025-09-24 23:17:13+00:00,detikcom,Proses perceraian Tasya Farasya dan Ahmad Assegaf berlanjut. kuasa hukum Tasya sebut mengajukan gugatan nafkah sebesar Rp 100 perak.,0,0,0,10676,https://x.com/detikcom/status/1970990935866745149,https://x.com/IndoPopBase/status/1970786034289107197,0
2025-09-24 10:17:03+00:00,B4n6_H4n5,"Dengan kata lain, dia ingin mengatakan bahwa harga diri lu cuma 100 perak...",17,5,0,226464,https://x.com/B4n6_H4n5/status/1970794602052673988,https://x.com/IndoPopBase/status/1970786034289107197,22
2025-09-24 09:56:41+00:00,blockxs,"Rp100, supporter or not",0,0,0,18071,https://x.com/blockxs/status/1970789479184314420,https://x.com/IndoPopBase/status/1970786034289107197,0
2025-09-24 09:54:45+00:00,0xHarryry,she just need to sue him haha,0,0,0,8559,https://x.com/0xHarryry/status/1970788991797698717,https://x.com/IndoPopBase/status/1970786034289107197,0
2025-09-24 09:55:38+00:00,amiernais,Hakimnya makin yakin untuk ngabulin permohonannya Tasya kalo Ahmad gagal ngasih nafkah ,0,0,0,8009,https://x.com/amiernais/status/1970789213013745881,https://x.com/IndoPopBase/status/1970786034289107197,0
2025-09-24 10:04:45+00:00,anaknomor_3,"Tasya marah, kecewa, sedih wajahnya. Semoga Allah angkat derajatnya ",0,2,0,3221,https://x.com/anaknomor_3/status/1970791508745081326,https://x.com/IndoPopBase/status/1970786034289107197,2
2025-09-24 10:42:34+00:00,kwek118,"Org lain ada yg sampe nipu demi nafkahin anak istri, ini NIPU ISTRI ANJIR mau dibilang mokondo juga tu burung ga dipake buat nafkah batin. GATAU BGT JIR LAH MARAH BESAR",1,12,0,3775,https://x.com/kwek118/status/1970801023141982315,https://x.com/IndoPopBase/status/1970786034289107197,13
2025-09-24 09:47:30+00:00,sunflowlilie,"Sudah tidak bisa komentar apapun. Soalnya emang kita ga bisa nilai dari luar doang. Namanya manusia ada aja sifat tamaknya. Ini ibaratnya udah percaya banget sama orang yg dicinta, saking cintanya gak pernah cek2 mutasi/transaksi ",1,6,0,6241,https://x.com/sunflowlilie/status/1970787165404889558,https://x.com/IndoPopBase/status/1970786034289107197,7
2025-09-24 10:35:39+00:00,DINozaurous,"tasa: mom i already had everything, i am a richman i am a richman",0,7,0,32097,https://x.com/DINozaurous/status/1970799282103189751,https://x.com/IndoPopBase/status/1970786034289107197,7
2025-09-24 09:57:59+00:00,your_rosa,"damn, she serving ""Mom, Iam a rich man"" - Cher vibes ",0,3,0,8114,https://x.com/your_rosa/status/1970789802795827339,https://x.com/IndoPopBase/status/1970786034289107197,3
2025-09-24 10:55:13+00:00,LoverNotSaint,rame bener yang bilang muka suaminya kayak orang baik2. baik2 darimana bjjr. pantes dah prabowo bisa menang ,5,1,0,60806,https://x.com/LoverNotSaint/status/1970804206413197526,https://x.com/IndoPopBase/status/1970786034289107197,6
2025-09-24 10:13:21+00:00,gestunbygita,"mana digelapin dr 2021 tapi mintanya cuman 100 perak, bener2 dijatohin ama tasya",0,2,0,8288,https://x.com/gestunbygita/status/1970793669432422711,https://x.com/IndoPopBase/status/1970786034289107197,2
2025-09-24 10:17:50+00:00,SUNSETW1TCH,"Pengemis dikasih 100 perak aja suka dilemparin balik ke yg ngasih, lu laki ngga ada harga dirinya amat.",0,4,0,31091,https://x.com/SUNSETW1TCH/status/1970794801126871338,https://x.com/IndoPopBase/status/1970786034289107197,4
2025-09-24 09:47:24+00:00,dimoonlock,"A real rich man, not like that robotic highschool talent show khia group",0,6,0,7453,https://x.com/dimoonlock/status/1970787141421814013,https://x.com/IndoPopBase/status/1970786034289107197,6
2025-09-24 10:20:45+00:00,·,"Kalau gua diposisi dia, ego gua bakal kena banget sih. Kesannya kaya seengga mampu itu sampai minta 100p aja tiap bulan. ",0,0,0,4183,https://x.com/pesesif/status/1970795535411118296,https://x.com/IndoPopBase/status/1970786034289107197,0
2025-09-24 10:02:42+00:00,farmerschinken,"anjir 500 perak jaman gue SD cuma bisa dapet gorengan 1 biji ahmad, apalagi 100 perak paling dpt apa? dapet hikmah doang",0,1,0,28574,https://x.com/farmerschinken/status/1970790990052315314,https://x.com/IndoPopBase/status/1970786034289107197,1
2025-09-24 10:32:51+00:00,icamkns,oh queen farasya clock that mokondo for me,0,1,0,9764,https://x.com/icamkns/status/1970798578420568097,https://x.com/IndoPopBase/status/1970786034289107197,1
2025-09-24 09:59:38+00:00,ilsasfst,Anjing gue ketawa mampus bacanya,1,0,0,23920,https://x.com/ilsasfst/status/1970790218531021003,https://x.com/IndoPopBase/status/1970786034289107197,1
2025-09-24 11:57:04+00:00,tclrockk,"Teringat  kasus Taylor Swift, nuntut menang atas kasus pelecehan bayar kopensasi sebesar S$ 1 RT 
.",0,0,0,4475,https://x.com/tclrockk/status/1970819774025519326,https://x.com/IndoPopBase/status/1970786034289107197,0
2025-09-24 10:04:37+00:00,Dedi_hrj,Dituntut nafkah cuma 100 perak permen seitil aja gak dapet cok.,1,0,0,29335,https://x.com/Dedi_hrj/status/1970791471965212979,https://x.com/IndoPopBase/status/1970786034289107197,1
2025-09-24 11:01:19+00:00,selectien,Ditransfer juga ga bisa itu 100 perak ,2,0,0,17539,https://x.com/selectien/status/1970805742090490266,https://x.com/IndoPopBase/status/1970786034289107197,2
2025-09-24 10:08:00+00:00,zephyrove,ketua mokondo ini mah ga ada malunya ,0,0,0,2831,https://x.com/zephyrove/status/1970792324159709654,https://x.com/IndoPopBase/status/1970786034289107197,0
2025-09-24 10:49:17+00:00,fckngshibal,"Menyala memong , sidang pake hermes himalaya outif kuning sesuai warna baju pernikahan, menyala sekali",0,0,0,853,https://x.com/fckngshibal/status/1970802712607650022,https://x.com/IndoPopBase/status/1970786034289107197,0
2025-09-24 14:21:50+00:00,beautiaf,memong aja GAKTAU UANG SERIBU anjir gimana 100 perak,2,0,0,74991,https://x.com/beautiaf/status/1970856206077141216,https://x.com/IndoPopBase/status/1970786034289107197,2
2025-09-24 10:53:08+00:00,Ry_Odji,Is it safe to say that gorgeous young money ALWAYS cross paths with mokondo..??,0,0,0,954,https://x.com/Ry_Odji/status/1970803682313961560,https://x.com/IndoPopBase/status/1970786034289107197,0
2025-09-24 10:09:12+00:00,indiraaml,diva behaviour i fear,0,0,0,2372,https://x.com/indiraaml/status/1970792627722408417,https://x.com/IndoPopBase/status/1970786034289107197,0
2025-09-24 11:09:44+00:00,nanaspineapel,Jujur gak ada harga dirinya lagi si ahmad,0,0,0,6729,https://x.com/nanaspineapel/status/1970807859291234739,https://x.com/IndoPopBase/status/1970786034289107197,0
2025-09-24 10:09:16+00:00,cacingkremyyy,"Ahmad tu kl gasalah kerja ga si?? Kerja apaa dah dia masa kg bs nafkahin bjirr, ap dia merasa sayang duit krn tasya earn more alias pelit????",2,0,0,9031,https://x.com/cacingkremyyy/status/1970792644604473689,https://x.com/IndoPopBase/status/1970786034289107197,2
2025-09-24 13:56:13+00:00,vmilkoyaa,"cowo mau cari istri kek gimanaa sih, heran gue dah",0,0,0,599,https://x.com/vmilkoyaa/status/1970849759482225134,https://x.com/IndoPopBase/status/1970786034289107197,0
2025-09-24 10:24:00+00:00,akunaamengg,Beneran diinjek bjirr harga dirinya si Ahmad lebih malu daripada sapno,0,0,0,2227,https://x.com/akunaamengg/status/1970796353531027815,https://x.com/IndoPopBase/status/1970786034289107197,0
2025-09-24 12:19:41+00:00,capymawa,queenshit,0,0,0,1283,https://x.com/capymawa/status/1970825464714592314,https://x.com/IndoPopBase/status/1970786034289107197,0
2025-09-24 11:51:51+00:00,larasasyf,all hail qween! minimal berasa direndahin deh tu laki. kena kali harga dirinya cuma dihargain 100 perak masa engga? kalo engga sih urat malunya dah putus yaaaa,0,0,0,2159,https://x.com/larasasyf/status/1970818459488620722,https://x.com/IndoPopBase/status/1970786034289107197,0
2025-09-24 14:56:19+00:00,inisayaudin,ahmad tidak tasya farasya approved,0,1,0,522,https://x.com/inisayaudin/status/1970864881848250821,https://x.com/IndoPopBase/status/1970786034289107197,1
2025-09-24 12:38:16+00:00,valeriemanov,"ternyata harga diri ahmad cuma 100 perak, gak malu",1,0,0,632,https://x.com/valeriemanov/status/1970830138821709905,https://x.com/IndoPopBase/status/1970786034289107197,1
2025-09-24 16:33:52+00:00,joni_member,"Hati2 nih berita buat nutupin kasus keracunan mbg ratusan siswa, udah kalian ga usah pedulikan artis2 dan influencer gblk yg suka flexing",0,0,0,325,https://x.com/joni_member/status/1970889431294128435,https://x.com/IndoPopBase/status/1970786034289107197,0
2025-09-24 10:21:59+00:00,laninamujer,"Kemarin di beranda yutub gua lewat video kak Tasya yg pesta nikahan hari terakhir nya, dan tulisan di video nya SELESAI.",0,0,0,770,https://x.com/laninamujer/status/1970795842337755458,https://x.com/IndoPopBase/status/1970786034289107197,0
2025-09-24 09:32:44+00:00,0xHarryry,"a good show that bring laugh for me, thankyouu standup",0,0,0,1318,https://x.com/0xHarryry/status/1970783448916021679,https://x.com/IndoPopBase/status/1970780246560628804,0
2025-09-24 09:23:24+00:00,ilatireng,"Hostnya gede di stand up comedy, pesertanya justru gede sebagai sutradara ",4,1,0,2572,https://x.com/ilatireng/status/1970781099082252348,https://x.com/IndoPopBase/status/1970780246560628804,5
2025-09-24 09:23:03+00:00,Supri50_,"Suci 3 sama 4 fav gua

Kapan lagi liat coki pardede terharu pas eliminasi wkwkwkwkwkwk",5,1,0,2494,https://x.com/Supri50_/status/1970781014760001553,https://x.com/IndoPopBase/status/1970780246560628804,6
2025-09-24 13:23:39+00:00,ekopxl,"Kompas TV saat dipegang Indra Yudhistira  
Selain SUCI kompas TV beliau juga yg bikin SUCA (Stand Up Comedy Academy) di Indosiar",0,3,0,1352,https://x.com/ekopxl/status/1970841563564855328,https://x.com/IndoPopBase/status/1970780246560628804,3
2025-09-24 17:29:01+00:00,yanjiro38,Industri hiburan Indonesia dikuasai komika semua dan komunitasnya masih solid sampe sekarang,0,0,0,433,https://x.com/yanjiro38/status/1970903311047160216,https://x.com/IndoPopBase/status/1970780246560628804,0
2025-09-24 09:26:20+00:00,ursteulyNaveen,A show that changed the comedy scene in Indonesia  14 years and still iconic!,0,0,0,2126,https://x.com/ursteulyNaveen/status/1970781837476692166,https://x.com/IndoPopBase/status/1970780246560628804,0
2025-09-24 13:03:51+00:00,FelixSGL1,Salah satu acara pertama saat Kompas berdiri heheheh,0,0,0,585,https://x.com/FelixSGL1/status/1970836579854987358,https://x.com/IndoPopBase/status/1970780246560628804,0
2025-09-24 10:25:27+00:00,PROSPERDEGREAT,Wild how that show basically launched a whole wave of comics in Indo. 14 years flew fast.,0,0,0,1613,https://x.com/PROSPERDEGREAT/status/1970796715893473468,https://x.com/IndoPopBase/status/1970780246560628804,0
2025-09-24 13:13:42+00:00,reDWine7078,Era nya dodit mulyanto yang jokes kpu.. Miss the moment,0,0,0,890,https://x.com/reDWine7078/status/1970839056084062705,https://x.com/IndoPopBase/status/1970780246560628804,0
2025-09-24 09:35:16+00:00,simbot_,"Tentu saja dong favorit sepanjang masa, kue-kue kering from Tomy Babap.",0,1,0,142,https://x.com/simbot_/status/1970784085481226574,https://x.com/IndoPopBase/status/1970780246560628804,1
2025-09-24 09:20:50+00:00,Law_of_manifest,The comedians are evergreen pairs they made those days awsome,0,0,0,1188,https://x.com/Law_of_manifest/status/1970780455244108211,https://x.com/IndoPopBase/status/1970780246560628804,0
2025-09-24 10:38:50+00:00,yogya_serviceAC,Lucuan Audisi Pelawak TPI.. ,2,1,0,636,https://x.com/yogya_serviceAC/status/1970800084150546791,https://x.com/IndoPopBase/status/1970780246560628804,3
2025-09-24 12:32:43+00:00,AryonoIgnatius,Dan dulu saya nonton di tv mulai dari SUCI 1. Sempat ikut audisi SUCI 4 atau 5 (agak lupa) dan tidak lolos. Lanjut jadi penikmat lagi sampai SUCI yang kemarin terakhir,0,0,0,987,https://x.com/AryonoIgnatius/status/1970828745708818750,https://x.com/IndoPopBase/status/1970780246560628804,0
2025-09-24 10:21:45+00:00,chaechwe,yg masih ngeksis selain ernest siapa di s1?,6,0,0,3852,https://x.com/chaechwe/status/1970795783495815664,https://x.com/IndoPopBase/status/1970780246560628804,6
2025-09-24 13:16:02+00:00,JavaJimmyMaukar,@Standupindo,0,0,0,222,https://x.com/JavaJimmyMaukar/status/1970839644775588237,https://x.com/IndoPopBase/status/1970780246560628804,0
2025-09-24 12:53:25+00:00,Randomieshere,When did Stand Up Comedy Indonesia premiere again???,0,0,0,645,https://x.com/Randomieshere/status/1970833951825772994,https://x.com/IndoPopBase/status/1970780246560628804,0
2025-09-24 12:36:13+00:00,valangdika,Yang paling organiknya bukannya di Metro TV ya?,0,0,0,249,https://x.com/valangdika/status/1970829626059731235,https://x.com/IndoPopBase/status/1970780246560628804,0
2025-09-24 13:56:09+00:00,edwinbazz,Kompor gas.,0,0,0,224,https://x.com/edwinbazz/status/1970849742071734502,https://x.com/IndoPopBase/status/1970780246560628804,0
2025-09-24 11:02:04+00:00,rigeldzikrullah,"Pertama nonton ini waktu SMP kelas 1, jatuh cinta sm kompetisi ini waktu mulai jaman SUCI 2 sampe sekarang ",0,0,0,732,https://x.com/rigeldzikrullah/status/1970805932969099357,https://x.com/IndoPopBase/status/1970780246560628804,0
2025-09-25 01:52:50+00:00,gamilaarief,Sakdiyaaah ,0,0,0,97,https://x.com/gamilaarief/status/1971030101350547681,https://x.com/IndoPopBase/status/1970780246560628804,0
2025-09-24 15:01:14+00:00,gubernurgotham,Suci 3 >>>,0,0,0,258,https://x.com/gubernurgotham/status/1970866118484246794,https://x.com/IndoPopBase/status/1970780246560628804,0
2025-09-25 04:31:12+00:00,Aricomeback,Suci 3 the best for me,0,0,0,88,https://x.com/Aricomeback/status/1971069955715322211,https://x.com/IndoPopBase/status/1970780246560628804,0
2025-09-25 01:53:29+00:00,kucingpiknik,Suci 4 sama 7 ,0,0,0,107,https://x.com/kucingpiknik/status/1971030263837892704,https://x.com/IndoPopBase/status/1970780246560628804,0
2025-09-24 16:34:10+00:00,islundia,"inget ga pin kita punya cita cita nonton suci 
@IpinKaramel",1,0,0,739,https://x.com/islundia/status/1970889506858606904,https://x.com/IndoPopBase/status/1970780246560628804,1
2025-09-25 01:29:10+00:00,hii_dayy,Yg mayoritas sukses di season 4,0,0,0,161,https://x.com/hii_dayy/status/1971024142599323971,https://x.com/IndoPopBase/status/1970780246560628804,0
2025-09-25 05:17:23+00:00,dimanrahman_19,Agung motivamor adalah kunci ,0,0,0,69,https://x.com/dimanrahman_19/status/1971081578089677048,https://x.com/IndoPopBase/status/1970780246560628804,0
2025-09-24 19:32:10+00:00,gogis0,miss the old era,0,0,0,138,https://x.com/gogis0/status/1970934301887001071,https://x.com/IndoPopBase/status/1970780246560628804,0
2025-09-24 14:44:27+00:00,H_mints,"SUCI 1-5 ngikutin terus, mulai season2 berikutnya udah beda vibe, jadinya hmpir ga pernah nonton lagi.",0,0,0,431,https://x.com/H_mints/status/1970861894060868052,https://x.com/IndoPopBase/status/1970780246560628804,0
2025-09-26 07:09:40+00:00,SupeRenaldy,"Dari sini komunitas Stand Up Indo lahir dan dari sini industri Standup di Indo terbentuk
Berlanjut menjamurnya komika jadi berimbas ke Industri lain baik film, musik, lawak tv, podcast dll",0,0,0,16,https://x.com/SupeRenaldy/status/1971472223245566093,https://x.com/IndoPopBase/status/1970780246560628804,0
2025-09-24 11:41:28+00:00,tendamieayam,Yg sulap bocor bagus,0,0,0,525,https://x.com/tendamieayam/status/1970815844663095653,https://x.com/IndoPopBase/status/1970780246560628804,0
2025-09-24 22:09:58+00:00,kangsulapp,I luv this show!,0,0,0,4,https://x.com/kangsulapp/status/1970974014626836888,https://x.com/IndoPopBase/status/1970780246560628804,0
2025-09-24 09:42:42+00:00,AmberSaira95910,We stand palatine,0,0,0,704,https://x.com/AmberSaira95910/status/1970785957847957741,https://x.com/IndoPopBase/status/1970780246560628804,0
2025-09-24 09:42:29+00:00,AmberSaira95910,Wow,0,0,0,896,https://x.com/AmberSaira95910/status/1970785901564625043,https://x.com/IndoPopBase/status/1970780246560628804,0
2025-09-24 09:35:40+00:00,brodeldi,jelas sih yang tengah paling keren,0,0,0,523,https://x.com/brodeldi/status/1970784190112428090,https://x.com/IndoPopBase/status/1970780246560628804,0
2025-09-25 02:52:49+00:00,Th3Tr4vel3r,semoga lahir para komika lucu tp kritis,0,0,0,367,https://x.com/Th3Tr4vel3r/status/1971045195333632217,https://x.com/IndoPopBase/status/1970780246560628804,0
2025-09-25 10:43:02+00:00,qMwzzzzz,Kompor gas,0,0,0,11,https://x.com/qMwzzzzz/status/1971163528502640772,https://x.com/IndoPopBase/status/1970780246560628804,0
2025-09-24 09:17:15+00:00,ndroe_,semoga sang suami diangkat penyakitnya ,2,2,0,12577,https://x.com/ndroe_/status/1970779554399875246,https://x.com/IndoPopBase/status/1970768832202694800,4
2025-09-24 08:36:18+00:00,hadilocoboy,"wahh gw seumuran sama dia ternyata..

happy birthday virgo gank ",2,0,0,16048,https://x.com/hadilocoboy/status/1970769249733091768,https://x.com/IndoPopBase/status/1970768832202694800,2
2025-09-24 08:43:47+00:00,sugar_6378,"Kata kak sheila,
""Terima kasih temen temen""

Emang cantik banget ini kak sheila",1,3,0,14242,https://x.com/sugar_6378/status/1970771131063058797,https://x.com/IndoPopBase/status/1970768832202694800,4
2025-09-24 08:52:27+00:00,awansatriawan_,"Tau sheila dara sejak film eggnoid sampe sekarang ga ada perubahan sama sekali dari segi visualnya, damn pusing",0,1,0,2717,https://x.com/awansatriawan_/status/1970773312478630364,https://x.com/IndoPopBase/status/1970768832202694800,1
2025-09-24 10:03:13+00:00,payrenel,"she's 33???? wahh, perasaan waktu pertama kali ngefans, belio ini masih 20-an.. waktu itu masa Stereo ",0,0,0,6095,https://x.com/payrenel/status/1970791123196231756,https://x.com/IndoPopBase/status/1970768832202694800,0
2025-09-24 13:07:49+00:00,lahsiapaaku_,Bukti nyata kalo anak 90'an tuh awet muda ya ,0,0,0,7446,https://x.com/lahsiapaaku_/status/1970837579349287138,https://x.com/IndoPopBase/status/1970768832202694800,0
2025-09-24 12:30:18+00:00,Rzq_NewNormal48,"sblm jadi aktris terkenal, beliau yg mngisi sontrek sinchan, jdi wartawan di Bima Satria Garuda (2013), dan host Breakout NET. TV (skrg MDTV). HBD, Sore!",2,0,0,2825,https://x.com/Rzq_NewNormal48/status/1970828134212907124,https://x.com/IndoPopBase/status/1970768832202694800,2
2025-09-24 09:24:09+00:00,toopynity,Mulai ngidolain beliau sejak jadi host Breakout. Hapi birthday kak Cilaaa,3,0,0,7436,https://x.com/toopynity/status/1970781290455793886,https://x.com/IndoPopBase/status/1970768832202694800,3
2025-09-24 08:36:32+00:00,ursteulyNaveen,Happy 33rd birthday to the amazing Sheila Dara  Wishing her more success and happiness ahead ,0,0,0,3358,https://x.com/ursteulyNaveen/status/1970769308474359903,https://x.com/IndoPopBase/status/1970768832202694800,0
2025-09-24 10:20:50+00:00,B4n6_H4n5,"SUT ya Sheila... 
Semoga kariernya semakin Moncer...",0,1,0,4396,https://x.com/B4n6_H4n5/status/1970795554906259549,https://x.com/IndoPopBase/status/1970768832202694800,1
2025-09-24 10:56:18+00:00,reventhereader,Wow HBD Sheila dan Bai Lu,0,0,0,1725,https://x.com/reventhereader/status/1970804479131062278,https://x.com/IndoPopBase/status/1970768832202694800,0
2025-09-24 08:34:57+00:00,xAvellesch,happy bday queen,0,0,0,7479,https://x.com/xAvellesch/status/1970768908765585531,https://x.com/IndoPopBase/status/1970768832202694800,0
2025-09-24 10:13:38+00:00,favmoneys,happy birthday ka Sheila ,0,0,0,335,https://x.com/favmoneys/status/1970793742195216781,https://x.com/IndoPopBase/status/1970768832202694800,0
2025-09-25 08:00:02+00:00,KETOPR44K,,0,0,0,9,https://x.com/KETOPR44K/status/1971122509891371096,https://x.com/IndoPopBase/status/1970768832202694800,0
2025-09-24 12:41:13+00:00,beautiaf,"happy birthday yg paling cantik 
@sheiladaisha",0,0,0,4827,https://x.com/beautiaf/status/1970830882291491085,https://x.com/IndoPopBase/status/1970768832202694800,0
2025-09-24 08:47:12+00:00,billyiskandar05,Happy birthday Sore ,0,0,0,8425,https://x.com/billyiskandar05/status/1970771990190621108,https://x.com/IndoPopBase/status/1970768832202694800,0
2025-09-24 08:38:10+00:00,PROSPERDEGREAT,She’s been putting out quality work for years,0,0,0,3103,https://x.com/PROSPERDEGREAT/status/1970769716512723219,https://x.com/IndoPopBase/status/1970768832202694800,0
2025-09-24 08:38:04+00:00,PROSPERDEGREAT,Hard to believe she’s 33 already,0,0,0,4817,https://x.com/PROSPERDEGREAT/status/1970769691435024749,https://x.com/IndoPopBase/status/1970768832202694800,0
2025-09-24 08:57:48+00:00,CitaStarstories,Happy birthday kak Sheila dara,0,0,0,606,https://x.com/CitaStarstories/status/1970774658321617239,https://x.com/IndoPopBase/status/1970768832202694800,0
2025-09-24 08:55:55+00:00,0xgasm,baru denger namanya,0,0,0,3054,https://x.com/0xgasm/status/1970774184113705408,https://x.com/IndoPopBase/status/1970768832202694800,0
2025-09-24 08:43:12+00:00,Law_of_manifest,HBD  sheila Dara,0,0,0,1590,https://x.com/Law_of_manifest/status/1970770984308232643,https://x.com/IndoPopBase/status/1970768832202694800,0
2025-09-24 09:17:43+00:00,deepublishstore,"Cantikkkk bangetttt, hepibidiii kakakkkk",0,0,0,112,https://x.com/deepublishstore/status/1970779672658284634,https://x.com/IndoPopBase/status/1970768832202694800,0
2025-09-25 11:21:42+00:00,·,"Happy birthday, kembaranku dr masa depan ",0,0,0,37,https://x.com/w0nderwen/status/1971173262165184521,https://x.com/IndoPopBase/status/1970768832202694800,0
2025-09-24 11:24:48+00:00,xhvkenn,Mbak cantik ulang tahun ,0,0,0,232,https://x.com/xhvkenn/status/1970811654234636725,https://x.com/IndoPopBase/status/1970768832202694800,0
2025-09-24 13:58:16+00:00,pipibersemu,"hbd 
@fasolaleedo",1,0,0,31,https://x.com/pipibersemu/status/1970850271883563288,https://x.com/IndoPopBase/status/1970768832202694800,1
2025-09-25 11:34:45+00:00,Akai_4869,Cakep banget wooyyyy,0,0,0,18,https://x.com/Akai_4869/status/1971176542375116972,https://x.com/IndoPopBase/status/1970768832202694800,0
2025-09-25 03:36:15+00:00,CupskyF,Met ultah ya kak ,0,0,0,39,https://x.com/CupskyF/status/1971056126742626440,https://x.com/IndoPopBase/status/1970768832202694800,0
2025-09-24 11:44:13+00:00,gilmourfracta,,0,0,0,564,https://x.com/gilmourfracta/status/1970816537008492964,https://x.com/IndoPopBase/status/1970768832202694800,0
2025-09-24 13:33:24+00:00,exnanika,happy birthday my wife ,0,0,0,657,https://x.com/exnanika/status/1970844014820933710,https://x.com/IndoPopBase/status/1970768832202694800,0
2025-09-24 10:56:39+00:00,zeatiara,"Happy bday kembaran aku ka 
@sheiladaisha
  bedanya hari ini aku 3* ",1,0,0,9112,https://x.com/zeatiara/status/1970804569086320763,https://x.com/IndoPopBase/status/1970768832202694800,1
2025-09-24 14:47:41+00:00,ironbearrr,Gorgeous ,0,0,0,230,https://x.com/ironbearrr/status/1970862709156839843,https://x.com/IndoPopBase/status/1970768832202694800,0
2025-09-24 13:29:14+00:00,srhandj,Hbd mba soreee,0,0,0,371,https://x.com/srhandj/status/1970842967473901702,https://x.com/IndoPopBase/status/1970768832202694800,0
2025-09-25 06:46:48+00:00,thisishrphinaa,"Kalo liat Sheila Dara, pengen balik ke era nonton Breakout Net. ",0,0,0,272,https://x.com/thisishrphinaa/status/1971104079255572580,https://x.com/IndoPopBase/status/1970768832202694800,0
2025-09-24 12:42:07+00:00,rizky_rp6,,0,0,0,102,https://x.com/rizky_rp6/status/1970831110667206951,https://x.com/IndoPopBase/status/1970768832202694800,0
2025-09-25 02:01:28+00:00,dxtrrr,SORE ,0,0,0,85,https://x.com/dxtrrr/status/1971032271886090672,https://x.com/IndoPopBase/status/1970768832202694800,0
2025-09-24 12:07:15+00:00,exteravaganza,long live the queen,0,0,0,510,https://x.com/exteravaganza/status/1970822337101729953,https://x.com/IndoPopBase/status/1970768832202694800,0
2025-09-25 02:08:54+00:00,ferizast,the Queen of Evening,0,0,0,158,https://x.com/ferizast/status/1971034143590080854,https://x.com/IndoPopBase/status/1970768832202694800,0
2025-09-24 17:00:58+00:00,aspxeca,"Selamat ulang Tahun, ini idolanya my fav person hehehe ",0,0,0,472,https://x.com/aspxeca/status/1970896252247368083,https://x.com/IndoPopBase/status/1970768832202694800,0
2025-09-24 15:39:33+00:00,pecintahayam,"loh udh 33 umurnya, kirain 26 man",0,0,0,262,https://x.com/pecintahayam/status/1970875764154507416,https://x.com/IndoPopBase/status/1970768832202694800,0
2025-09-24 11:30:12+00:00,ahmdya2idane,Hapi BDay kak Dara,0,0,0,165,https://x.com/ahmdya2idane/status/1970813010827776289,https://x.com/IndoPopBase/status/1970768832202694800,0
2025-09-24 13:44:17+00:00,_unclesaam,tjantik banget rambut biru ,0,0,0,149,https://x.com/_unclesaam/status/1970846755647553936,https://x.com/IndoPopBase/status/1970768832202694800,0
2025-09-24 14:22:10+00:00,fesvite__,Cuma beda lima tahun ya ,0,0,0,673,https://x.com/fesvite__/status/1970856288956649782,https://x.com/IndoPopBase/status/1970768832202694800,0
2025-09-25 07:07:02+00:00,itskinoy_,"seumuran ternyata
hbd sore ",0,0,0,42,https://x.com/itskinoy_/status/1971109170616336401,https://x.com/IndoPopBase/status/1970768832202694800,0
2025-09-25 03:48:01+00:00,·,"happy birthday gorgeous 
@sheiladaisha
 ",0,0,0,84,https://x.com/tiwtiwsss/status/1971059088617505038,https://x.com/IndoPopBase/status/1970768832202694800,0
2025-09-24 09:49:23+00:00,prettyriu,Happy birthday queen!!,0,0,0,1101,https://x.com/prettyriu/status/1970787641030524949,https://x.com/IndoPopBase/status/1970768832202694800,0
2025-09-24 10:31:56+00:00,M4NV514,hbd mba syiladaraaa,0,0,0,210,https://x.com/M4NV514/status/1970798347511529599,https://x.com/IndoPopBase/status/1970768832202694800,0
2025-09-24 11:57:44+00:00,gmtmozes,Is it me or she age like a finest wine,0,0,0,3426,https://x.com/gmtmozes/status/1970819941743174026,https://x.com/IndoPopBase/status/1970768832202694800,0
2025-09-24 12:44:22+00:00,yayaaltaf,EMANG SOULMATE BEJIR HBD PACAR LIBRA GUEEEEEEE ILY PUOL MWAH,0,0,0,2770,https://x.com/yayaaltaf/status/1970831677829308762,https://x.com/IndoPopBase/status/1970768832202694800,0
2025-09-24 13:44:51+00:00,pratama_dayu,hbd sore ,0,0,0,120,https://x.com/pratama_dayu/status/1970846897746464903,https://x.com/IndoPopBase/status/1970768832202694800,0
2025-09-25 00:21:04+00:00,Dziennuen,"@drcukutjembur
 tumben gak Nadin Amizah nih Bro",1,0,0,129,https://x.com/Dziennuen/status/1971007008401977433,https://x.com/IndoPopBase/status/1970768832202694800,1
2025-09-23 06:37:40+00:00,0xHarryry,Happy birthday tiaraa,0,0,0,1371,https://x.com/0xHarryry/status/1970377003330347018,https://x.com/IndoPopBase/status/1970373977597190426,0
2025-09-23 06:31:22+00:00,ursteulyNaveen,Happy 24th Tiara Andini  Keep shining ,0,0,0,895,https://x.com/ursteulyNaveen/status/1970375421113049281,https://x.com/IndoPopBase/status/1970373977597190426,0
2025-09-23 08:20:23+00:00,masreyhaan,"Happy birthday Tiara! But still, Lyodra is better",1,0,0,1266,https://x.com/masreyhaan/status/1970402852725293149,https://x.com/IndoPopBase/status/1970373977597190426,1
2025-09-23 06:26:57+00:00,ursteulyNaveen,Happy 24th to the amazing Tiara Andini  Wishing her more success and beautiful music ahead ,0,0,0,1094,https://x.com/ursteulyNaveen/status/1970374306581368848,https://x.com/IndoPopBase/status/1970373977597190426,0
2025-09-23 07:30:56+00:00,ur_mindss,"happiest birthday, queen!",0,0,0,513,https://x.com/ur_mindss/status/1970390409567486410,https://x.com/IndoPopBase/status/1970373977597190426,0
2025-09-23 07:02:14+00:00,mmjussX,Icon,0,0,0,615,https://x.com/mmjussX/status/1970383188053893508,https://x.com/IndoPopBase/status/1970373977597190426,0
2025-09-23 22:29:32+00:00,R_tanque,Kirain dah 29th,0,0,0,96,https://x.com/R_tanque/status/1970616548730773515,https://x.com/IndoPopBase/status/1970373977597190426,0
2025-09-23 06:55:23+00:00,beautiaf,"omg, happy buzzday pretty!!",0,0,0,1136,https://x.com/beautiaf/status/1970381464517976503,https://x.com/IndoPopBase/status/1970373977597190426,0
2025-09-23 06:28:18+00:00,CitaStarstories,Happy birthday Titi,0,0,0,504,https://x.com/CitaStarstories/status/1970374646408356249,https://x.com/IndoPopBase/status/1970373977597190426,0
2025-09-23 07:30:24+00:00,Law_of_manifest,HBD Tiara Andini,0,0,0,1121,https://x.com/Law_of_manifest/status/1970390275832062137,https://x.com/IndoPopBase/status/1970373977597190426,0
2025-09-23 06:29:10+00:00,michh_eth,HAPPY BIRTHDAY TIARA. Gileee makin cantik!!!!!!,0,0,0,914,https://x.com/michh_eth/status/1970374865275527224,https://x.com/IndoPopBase/status/1970373977597190426,0
2025-09-23 06:34:36+00:00,KurniawanRicho,Happy birthday Tiara !,0,0,0,608,https://x.com/KurniawanRicho/status/1970376232836718934,https://x.com/IndoPopBase/status/1970373977597190426,0
2025-09-23 06:50:04+00:00,WitheredShulker,QUEEN,0,0,0,518,https://x.com/WitheredShulker/status/1970380126035795983,https://x.com/IndoPopBase/status/1970373977597190426,0
2025-09-23 06:42:40+00:00,Fernnnjnqp,Haappy birthday Tiara ,0,0,0,442,https://x.com/Fernnnjnqp/status/1970378263987101756,https://x.com/IndoPopBase/status/1970373977597190426,0
2025-09-23 11:27:15+00:00,divardha,"@nengbiker
 ",0,0,0,44,https://x.com/divardha/status/1970449881304310101,https://x.com/IndoPopBase/status/1970373977597190426,0
2025-09-23 06:29:15+00:00,chaechwe,hag,1,0,0,540,https://x.com/chaechwe/status/1970374887979249991,https://x.com/IndoPopBase/status/1970373977597190426,1
2025-09-23 10:39:30+00:00,banafcha,hbd titi,0,0,0,291,https://x.com/banafcha/status/1970437864661098560,https://x.com/IndoPopBase/status/1970373977597190426,0
2025-09-23 09:12:36+00:00,terpamungkas,Beda 2 tahun,0,0,0,260,https://x.com/terpamungkas/status/1970415994805068031,https://x.com/IndoPopBase/status/1970373977597190426,0
2025-09-23 11:05:57+00:00,nathdcx,who?,0,0,0,63,https://x.com/nathdcx/status/1970444519322853877,https://x.com/IndoPopBase/status/1970373977597190426,0
2025-09-23 06:37:46+00:00,Nothing_Mate_9,Happy Birthday,0,0,0,537,https://x.com/Nothing_Mate_9/status/1970377028156473554,https://x.com/IndoPopBase/status/1970373977597190426,0
2025-09-23 06:34:23+00:00,AmberSaira95910,"""Happy 24th Birthday, Tiara Andini!  Keep shining bright! """,0,0,0,988,https://x.com/AmberSaira95910/status/1970376176746070316,https://x.com/IndoPopBase/status/1970373977597190426,0
2025-09-23 06:34:46+00:00,AmberSaira95910,"""Happy 24th Birthday to the amazing Tiara Andini!  Wishing you joy and success always! """,0,0,0,873,https://x.com/AmberSaira95910/status/1970376274284814827,https://x.com/IndoPopBase/status/1970373977597190426,0
2025-09-23 06:27:01+00:00,airdrop_goe,HBD,1,0,0,1537,https://x.com/airdrop_goe/status/1970374324717793732,https://x.com/IndoPopBase/status/1970373977597190426,1
2025-09-23 08:10:29+00:00,jackthegon,Hbd ti,0,0,0,228,https://x.com/jackthegon/status/1970400362332110869,https://x.com/IndoPopBase/status/1970373977597190426,0
2025-09-23 06:33:52+00:00,AmberSaira95910,Happy birthday ,0,0,0,1428,https://x.com/AmberSaira95910/status/1970376048857456942,https://x.com/IndoPopBase/status/1970373977597190426,0
2025-09-23 07:12:49+00:00,brodeldi,Hbd lah pokonya,0,0,0,238,https://x.com/brodeldi/status/1970385851717951970,https://x.com/IndoPopBase/status/1970373977597190426,0
2025-09-24 02:01:48+00:00,Th3Tr4vel3r,"Happy birthday 
@initiaraandini
 semoga sehat dan sukses selalu",0,0,0,177,https://x.com/Th3Tr4vel3r/status/1970669969781490027,https://x.com/IndoPopBase/status/1970373977597190426,0
2025-09-23 06:38:51+00:00,theironcodee,24TJ,0,0,0,290,https://x.com/theironcodee/status/1970377303961280701,https://x.com/IndoPopBase/status/1970373977597190426,0
2025-09-23 06:38:33+00:00,theironcodee,Hello,0,0,0,277,https://x.com/theironcodee/status/1970377225884311898,https://x.com/IndoPopBase/status/1970373977597190426,0
2025-09-23 03:33:56+00:00,wasbrat,"she majored in cuntology, double majored in slay physics, has a phd in motherism and graduated summa cunt laude in girlbossism from the university of servington",2,13,0,2848,https://x.com/wasbrat/status/1970330765398548875,https://x.com/IndoPopBase/status/1970329605824487932,15
2025-09-23 03:31:34+00:00,Anomalindy,Long as i get paid i will keep making shitty musics,0,2,0,1715,https://x.com/Anomalindy/status/1970330173087363209,https://x.com/IndoPopBase/status/1970329605824487932,2
2025-09-23 05:31:52+00:00,sugar_6378,Videonya sih keren loh,1,3,0,1498,https://x.com/sugar_6378/status/1970360447049343371,https://x.com/IndoPopBase/status/1970329605824487932,4
2025-09-23 07:40:40+00:00,B4n6_H4n5,Aktingnya masih lebih bagus daripada suaranya...,0,0,0,905,https://x.com/B4n6_H4n5/status/1970392857975706079,https://x.com/IndoPopBase/status/1970329605824487932,0
2025-09-23 04:53:31+00:00,bad_biiiiitch,"she’s being cunty, but her music flopped so hard. bring back godnes monica!!!!",0,0,0,981,https://x.com/bad_biiiiitch/status/1970350793632162172,https://x.com/IndoPopBase/status/1970329605824487932,0
2025-09-23 03:30:06+00:00,ursteulyNaveen,Still one of AGNEZ MO’s most iconic tracks  8 years and it still hits!,0,1,0,1834,https://x.com/ursteulyNaveen/status/1970329800549228550,https://x.com/IndoPopBase/status/1970329605824487932,1
2025-09-23 04:11:06+00:00,fleurcest_,Sekarang hidung sama bibirnya udah berubah,2,1,0,1055,https://x.com/fleurcest_/status/1970340119547932838,https://x.com/IndoPopBase/status/1970329605824487932,3
2025-09-23 03:45:35+00:00,ardhypam,A cultural reset,0,1,0,509,https://x.com/ardhypam/status/1970333700480225304,https://x.com/IndoPopBase/status/1970329605824487932,1
2025-09-23 05:36:40+00:00,1sf3sbs,tbh ini masih enak sebenernya lagunya,0,1,0,453,https://x.com/1sf3sbs/status/1970361653062771133,https://x.com/IndoPopBase/status/1970329605824487932,1
2025-09-23 03:47:23+00:00,ardhypam,A certain indo pop girls couldn't do this,0,1,0,673,https://x.com/ardhypam/status/1970334150415786274,https://x.com/IndoPopBase/status/1970329605824487932,1
2025-09-23 03:32:11+00:00,interNEZional,gpp asal dibayar,0,0,0,1673,https://x.com/interNEZional/status/1970330325365731754,https://x.com/IndoPopBase/status/1970329605824487932,0
2025-09-23 03:32:56+00:00,aeahi01,Panjang aku dibayar,0,0,0,1761,https://x.com/aeahi01/status/1970330515241836925,https://x.com/IndoPopBase/status/1970329605824487932,0
2025-09-23 03:31:29+00:00,TINAT0G0K,mother,0,0,0,630,https://x.com/TINAT0G0K/status/1970330151348248991,https://x.com/IndoPopBase/status/1970329605824487932,0
2025-09-23 14:37:31+00:00,terkungkungreal,@4nth3mon,0,0,0,89,https://x.com/terkungkungreal/status/1970497762107236667,https://x.com/IndoPopBase/status/1970329605824487932,0
2025-09-23 04:58:38+00:00,blackdogstyle,Mother,0,0,0,328,https://x.com/blackdogstyle/status/1970352081459659240,https://x.com/IndoPopBase/status/1970329605824487932,0
2025-09-24 01:02:43+00:00,AgnationReanMo,,0,0,0,49,https://x.com/AgnationReanMo/status/1970655101246468141,https://x.com/IndoPopBase/status/1970329605824487932,0
2025-09-23 07:17:21+00:00,bornteodie,Never heard about it omg hagnez flopnica,0,0,0,252,https://x.com/bornteodie/status/1970386993675936257,https://x.com/IndoPopBase/status/1970329605824487932,0
2025-09-23 05:43:36+00:00,Virgofav6,Her last best songs,0,0,0,200,https://x.com/Virgofav6/status/1970363397121417639,https://x.com/IndoPopBase/status/1970329605824487932,0
2025-09-23 03:43:00+00:00,WitheredShulker,all of that for a drop of blood,0,0,0,484,https://x.com/WitheredShulker/status/1970333046760186308,https://x.com/IndoPopBase/status/1970329605824487932,0
2025-09-24 10:54:17+00:00,jayZukk,Such a masterpiece,0,0,0,68,https://x.com/jayZukk/status/1970803973641982031,https://x.com/IndoPopBase/status/1970329605824487932,0
2025-09-23 08:29:51+00:00,SINGKITMYLUV,Her peak,0,0,0,191,https://x.com/SINGKITMYLUV/status/1970405237174526003,https://x.com/IndoPopBase/status/1970329605824487932,0
2025-09-24 00:56:28+00:00,professor_tarot,Didn’t know this one existed tbh,0,0,0,120,https://x.com/professor_tarot/status/1970653528361443541,https://x.com/IndoPopBase/status/1970329605824487932,0
2025-09-23 03:45:53+00:00,ardhypam,One of her best work to date,0,0,0,535,https://x.com/ardhypam/status/1970333773356294322,https://x.com/IndoPopBase/status/1970329605824487932,0
2025-09-23 04:01:06+00:00,nanas14z,lupa lagunya tp intinya dulu gue suka,1,0,0,435,https://x.com/nanas14z/status/1970337604903350345,https://x.com/IndoPopBase/status/1970329605824487932,1
2025-09-23 14:08:57+00:00,bright397545603,Legend,0,0,0,260,https://x.com/bright397545603/status/1970490574202622154,https://x.com/IndoPopBase/status/1970329605824487932,0
2025-09-23 07:04:37+00:00,sydnerve,it’s her moment,0,0,0,137,https://x.com/sydnerve/status/1970383786551763060,https://x.com/IndoPopBase/status/1970329605824487932,0
2025-09-23 04:06:23+00:00,etsamaesenas,FORGETTABLE ON HER DAY,0,0,0,307,https://x.com/etsamaesenas/status/1970338932723458527,https://x.com/IndoPopBase/status/1970329605824487932,0
2025-09-23 03:40:02+00:00,Reggga__,Tau tuh lagu nya,0,0,0,327,https://x.com/Reggga__/status/1970332302057324630,https://x.com/IndoPopBase/status/1970329605824487932,0
2025-09-23 08:54:40+00:00,pulentembem,Serving blonde Asian cunt supremacy,0,0,0,662,https://x.com/pulentembem/status/1970411483839533192,https://x.com/IndoPopBase/status/1970329605824487932,0
2025-09-23 07:17:59+00:00,zaharassi,Bisa loh blio rilis lagu kyk gini lagi,0,0,0,176,https://x.com/zaharassi/status/1970387150639374577,https://x.com/IndoPopBase/status/1970329605824487932,0
2025-09-23 05:07:22+00:00,Alexx1992xx,Indonesian culture is packaged internationally and only he can do it,0,0,0,308,https://x.com/Alexx1992xx/status/1970354278616440873,https://x.com/IndoPopBase/status/1970329605824487932,0
2025-09-23 07:05:38+00:00,ikan_ikangoreng,miss the old her,0,0,0,299,https://x.com/ikan_ikangoreng/status/1970384044082020850,https://x.com/IndoPopBase/status/1970329605824487932,0
2025-09-23 07:59:59+00:00,bitchofprey,the beginning of the tankery,0,0,0,150,https://x.com/bitchofprey/status/1970397721753461239,https://x.com/IndoPopBase/status/1970329605824487932,0
2025-09-23 09:43:45+00:00,rizkywdw,Iconic,0,0,0,253,https://x.com/rizkywdw/status/1970423833640476676,https://x.com/IndoPopBase/status/1970329605824487932,0
2025-09-23 03:33:45+00:00,loenpiambaklien,"Rilis lagu ballad berbahasa Indonesia lagi, please.",0,0,0,781,https://x.com/loenpiambaklien/status/1970330720213270801,https://x.com/IndoPopBase/status/1970329605824487932,0
2025-09-23 11:15:43+00:00,·,Ni lagu enak banget anjir,3,0,0,536,https://x.com/pesesif/status/1970446978317504641,https://x.com/IndoPopBase/status/1970329605824487932,3
2025-09-23 03:40:07+00:00,·,Long As I Get Flop.,0,0,0,265,https://x.com/AngeloCalissto/status/1970332323184087472,https://x.com/IndoPopBase/status/1970329605824487932,0
2025-09-23 03:32:21+00:00,AmberSaira95910,"""Legendary move!  Totally dominating! """,1,0,0,1096,https://x.com/AmberSaira95910/status/1970330368546087052,https://x.com/IndoPopBase/status/1970329605824487932,1
2025-09-23 03:30:04+00:00,0xdelula,AGNEZ ,0,0,0,336,https://x.com/0xdelula/status/1970329795704823927,https://x.com/IndoPopBase/status/1970329605824487932,0
2025-09-23 03:41:59+00:00,jackthegon,Stunssss,0,0,0,249,https://x.com/jackthegon/status/1970332794812588386,https://x.com/IndoPopBase/status/1970329605824487932,0
2025-09-23 03:32:13+00:00,AmberSaira95910,"""Crushing every move!  Totally epic! """,0,0,0,852,https://x.com/AmberSaira95910/status/1970330334178005145,https://x.com/IndoPopBase/status/1970329605824487932,0
2025-09-24 02:02:22+00:00,Th3Tr4vel3r,video klipnya keren banget loh,0,0,0,204,https://x.com/Th3Tr4vel3r/status/1970670111272190163,https://x.com/IndoPopBase/status/1970329605824487932,0
2025-09-23 03:35:27+00:00,nezdaily,Tanked,0,0,0,259,https://x.com/nezdaily/status/1970331147994591640,https://x.com/IndoPopBase/status/1970329605824487932,0
2025-09-23 03:51:04+00:00,SaddamWeb3,"suzanna sekarang udah usia brp ya?
legend",1,0,0,1218,https://x.com/SaddamWeb3/status/1970335077122064459,https://x.com/IndoPopBase/status/1970324322335236460,1
2025-09-23 03:51:48+00:00,3usri,,5,20,0,2944,https://x.com/3usri/status/1970335261856088462,https://x.com/IndoPopBase/status/1970324322335236460,25
2025-09-23 03:33:59+00:00,yuliapandaa,"Walau serem, ini salah satu film fav keluarga. Pasti klo ini tayang di TV, ortu selalu manggil anak²nya yg dikamar buat nobar, really miss that moment.

Icon line ""Pah papa cepat pulang pah, mamah jadi setan""",4,1,0,1905,https://x.com/yuliapandaa/status/1970330780833640769,https://x.com/IndoPopBase/status/1970324322335236460,5
2025-09-23 06:49:27+00:00,Gakpedulititik,Bapaknya Mario caesar kan?,1,1,0,715,https://x.com/Gakpedulititik/status/1970379970481659977,https://x.com/IndoPopBase/status/1970324322335236460,2
2025-09-23 05:28:16+00:00,sugar_6378,"Dia tu cantik loh sebenernya, tp imagenya horror terus ",3,0,0,1583,https://x.com/sugar_6378/status/1970359541335498831,https://x.com/IndoPopBase/status/1970324322335236460,3
2025-09-23 06:11:09+00:00,jidatbesar,"Dulu pernah ada urband legend kalau rumah yg jadi lokasi syuting (namanya rumah esmeralda, di menteng) pernah jd tmpt pemujaan setan. Skrg rumahnya udah dibongkar dan jadi bangunan baru.",1,2,0,1422,https://x.com/jidatbesar/status/1970370333132906986,https://x.com/IndoPopBase/status/1970324322335236460,3
2025-09-23 03:45:59+00:00,mimosaFpudica,"Terakhir kali nonton Suzzanna, pas tdr langsung ketindihan",0,1,0,1228,https://x.com/mimosaFpudica/status/1970333798350074321,https://x.com/IndoPopBase/status/1970324322335236460,1
2025-09-23 03:22:12+00:00,vosverseau,Mother suzanna walked so edward could RUN,0,0,0,1312,https://x.com/vosverseau/status/1970327814919594441,https://x.com/IndoPopBase/status/1970324322335236460,0
2025-09-23 07:49:41+00:00,Sugar161892,ckep,0,0,0,60,https://x.com/Sugar161892/status/1970395126662136234,https://x.com/IndoPopBase/status/1970324322335236460,0
2025-09-23 06:10:23+00:00,dttapp,Mahi-mahi,0,0,0,328,https://x.com/dttapp/status/1970370137636409571,https://x.com/IndoPopBase/status/1970324322335236460,0
2025-09-23 05:21:11+00:00,akhirpekansans,"Jangan lupa makan siang gengs
x.com/akhirpekansans
…",0,0,0,30,https://x.com/akhirpekansans/status/1970357757162463412,https://x.com/IndoPopBase/status/1970324322335236460,0
2025-09-23 04:09:03+00:00,beautiaf,"kangen banget nonton film ini di tv, walaupun takut tp tetep ditonton karena bareng-bareng.",0,0,0,1696,https://x.com/beautiaf/status/1970339602943848758,https://x.com/IndoPopBase/status/1970324322335236460,0
2025-09-23 03:08:56+00:00,AnnafiBG,"Weleh serem amat, itu yang jadi setannya siapa yaa btw?",1,0,0,1327,https://x.com/AnnafiBG/status/1970324476375245116,https://x.com/IndoPopBase/status/1970324322335236460,1
2025-09-23 11:25:32+00:00,rivanalf_,Almarhum suzana kalo jadi peran di film horror emang serem banget sih,0,0,0,129,https://x.com/rivanalf_/status/1970449449060389343,https://x.com/IndoPopBase/status/1970324322335236460,0
2025-09-23 03:18:42+00:00,Lightnings23353,"""Pah Papa cepat Pulang Pah, Mamah jadi setan""",0,0,0,1216,https://x.com/Lightnings23353/status/1970326934405161282,https://x.com/IndoPopBase/status/1970324322335236460,0
2025-09-23 04:54:07+00:00,TejaAru05798875,The movie that changed history,0,0,0,172,https://x.com/TejaAru05798875/status/1970350944006385954,https://x.com/IndoPopBase/status/1970324322335236460,0
2025-09-23 14:12:33+00:00,pjssyg,trnyata kalo diliat sekarang ga serem ya malah lucu make up nya,0,0,0,57,https://x.com/pjssyg/status/1970491478230421918,https://x.com/IndoPopBase/status/1970324322335236460,0
2025-09-23 06:06:00+00:00,tieteydye,ini tuh film ayahnya si io ya ,0,0,0,48,https://x.com/tieteydye/status/1970369035226480921,https://x.com/IndoPopBase/status/1970324322335236460,0
2025-09-23 05:53:11+00:00,melekmedia,Tapi buat top 5,0,0,0,316,https://x.com/melekmedia/status/1970365810649739494,https://x.com/IndoPopBase/status/1970324322335236460,0
2025-09-24 22:03:01+00:00,BlacksharkX33,Anjr masih horor aja liat bentukan sundel bolong nya...,0,0,0,23,https://x.com/BlacksharkX33/status/1970972264603713701,https://x.com/IndoPopBase/status/1970324322335236460,0
2025-09-23 04:31:56+00:00,singgihazwar,ada yg tau judul lagu yg dibawain suzana sambil main piano di film ini?,2,0,0,763,https://x.com/singgihazwar/status/1970345364239921543,https://x.com/IndoPopBase/status/1970324322335236460,2
2025-09-23 04:36:23+00:00,JEDRZEJCZYKZ666,Corpse paint blekmetal,0,0,0,254,https://x.com/JEDRZEJCZYKZ666/status/1970346484441981028,https://x.com/IndoPopBase/status/1970324322335236460,0
2025-09-23 12:59:19+00:00,baber168,"foto keempat mirip personil band kiss, wkwkwk",0,0,0,139,https://x.com/baber168/status/1970473051142922257,https://x.com/IndoPopBase/status/1970324322335236460,0
2025-09-23 05:29:12+00:00,Supri50_,"Minggu lalu ada nih film di antv, dulu takut bgt nonton ini

Sekarang? Knapa gua ngakak yak nonton nih film wkwkwk",0,0,0,512,https://x.com/Supri50_/status/1970359776568844478,https://x.com/IndoPopBase/status/1970324322335236460,0
2025-09-23 03:24:13+00:00,·,serem bgt anjir,0,0,0,341,https://x.com/postraumatized/status/1970328322757603821,https://x.com/IndoPopBase/status/1970324322335236460,0
2025-09-23 03:15:01+00:00,arelmantep,Bapaknya mario caesar,0,0,0,287,https://x.com/arelmantep/status/1970326005916320238,https://x.com/IndoPopBase/status/1970324322335236460,0
2025-09-23 08:42:16+00:00,kerangajaibpulu,scene suzzanna nyanyi lagu selamat malam ohh cintakuu ngena bgt lagiii,0,0,0,167,https://x.com/kerangajaibpulu/status/1970408363000529156,https://x.com/IndoPopBase/status/1970324322335236460,0
2025-09-23 03:49:31+00:00,jackkjjohn,mamah jadi ketan,0,0,0,235,https://x.com/jackkjjohn/status/1970334689857863710,https://x.com/IndoPopBase/status/1970324322335236460,0
2025-09-23 13:59:19+00:00,beenhacked2997,alamak suketi,0,0,0,40,https://x.com/beenhacked2997/status/1970488148980547638,https://x.com/IndoPopBase/status/1970324322335236460,0
2025-09-23 04:15:57+00:00,zmdxp,Film bajingaaaannn bikin trauma sampai sekarang,0,0,0,554,https://x.com/zmdxp/status/1970341340719485313,https://x.com/IndoPopBase/status/1970324322335236460,0
2025-09-23 17:34:38+00:00,dampuyuk,gw lebih ngeri nonton film horor lawas daripada nonton film horor sekarang,0,0,0,97,https://x.com/dampuyuk/status/1970542336414490842,https://x.com/IndoPopBase/status/1970324322335236460,0
2025-09-24 02:52:49+00:00,tikaprananda,Oh my legend. Inget banget suka nontonin dia di tv tengah malem jm 10 ditemenin mama,0,0,0,57,https://x.com/tikaprananda/status/1970682806377562548,https://x.com/IndoPopBase/status/1970324322335236460,0
2025-09-23 04:27:00+00:00,naachalatte,bapaknya iooooo wkwkwk,0,0,0,459,https://x.com/naachalatte/status/1970344119945019787,https://x.com/IndoPopBase/status/1970324322335236460,0
2025-09-24 01:29:14+00:00,boibangun,"Malam iniiii…
Sunyi sepi…",0,0,0,18,https://x.com/boibangun/status/1970661774321164482,https://x.com/IndoPopBase/status/1970324322335236460,0
2025-09-23 06:48:03+00:00,vavavonito,mwrindinkk smpe ke biji-biji gw,0,0,0,552,https://x.com/vavavonito/status/1970379618181095671,https://x.com/IndoPopBase/status/1970324322335236460,0
2025-09-23 03:59:42+00:00,JeronePulen,I'm sobbing ,0,0,0,297,https://x.com/JeronePulen/status/1970337250694308288,https://x.com/IndoPopBase/status/1970324322335236460,0
2025-09-23 18:22:20+00:00,oldcaddilacvibe,"The girl next door ini mah, selisih 1 rumah doang dari rumahku.",0,0,0,84,https://x.com/oldcaddilacvibe/status/1970554338776096884,https://x.com/IndoPopBase/status/1970324322335236460,0
2025-09-23 05:00:31+00:00,toogenerick,,0,0,0,271,https://x.com/toogenerick/status/1970352556280029504,https://x.com/IndoPopBase/status/1970324322335236460,0
2025-09-23 04:03:22+00:00,enernad,oh ini bapaknya mahi mahi yaa ini,0,0,0,329,https://x.com/enernad/status/1970338175240622493,https://x.com/IndoPopBase/status/1970324322335236460,0
2025-09-23 03:46:49+00:00,tropiqueta,njir papa nya si mahi mahi,0,0,0,204,https://x.com/tropiqueta/status/1970334008958763472,https://x.com/IndoPopBase/status/1970324322335236460,0
2025-09-23 23:17:04+00:00,Aragstt,@Pashapurple3,0,0,0,17,https://x.com/Aragstt/status/1970628513519804874,https://x.com/IndoPopBase/status/1970324322335236460,0
2025-09-24 00:21:51+00:00,tina110037,Tetanggaku tiap malam buat sw ttg film dia,0,0,0,52,https://x.com/tina110037/status/1970644813587554325,https://x.com/IndoPopBase/status/1970324322335236460,0
2025-09-23 03:32:39+00:00,sendiramadhan_,"Film paling ngehe pada saat gw kecil, pernah sengaja sama emak gw ditontonin ini trus volumenya digedein cuman mau liat gw ketakutan. Bangke wkwkwk",0,0,0,1356,https://x.com/sendiramadhan_/status/1970330445503189134,https://x.com/IndoPopBase/status/1970324322335236460,0
2025-09-23 05:46:30+00:00,nisssanooobi,ada bapaknya mahi mahi,0,0,0,148,https://x.com/nisssanooobi/status/1970364129509810464,https://x.com/IndoPopBase/status/1970324322335236460,0
2025-09-23 05:48:33+00:00,hahakiiim,Trauma masa kecil bjir,0,0,0,300,https://x.com/hahakiiim/status/1970364644985577790,https://x.com/IndoPopBase/status/1970324322335236460,0
2025-09-24 03:28:49+00:00,surrinalla,itu bapaknya mario mahi mahi bukan?,0,0,0,30,https://x.com/surrinalla/status/1970691865566658960,https://x.com/IndoPopBase/status/1970324322335236460,0
2025-09-23 10:38:39+00:00,rully_1996,Biasanya tayang lagi nih di antv ,0,0,0,96,https://x.com/rully_1996/status/1970437651305243130,https://x.com/IndoPopBase/status/1970324322335236460,0
2025-09-23 03:28:53+00:00,bhretanujaya,pahh papaaah... cepet pulang pah,0,0,0,404,https://x.com/bhretanujaya/status/1970329495363342535,https://x.com/IndoPopBase/status/1970324322335236460,0
2025-09-23 03:13:26+00:00,chocoocake16,Ini yg nunjukkin ulangan matematika bukan,0,0,0,588,https://x.com/chocoocake16/status/1970325609911066950,https://x.com/IndoPopBase/status/1970324322335236460,0
2025-09-23 09:14:44+00:00,temeninvest,"""pah pah, mama jadi hantu""",1,0,0,206,https://x.com/temeninvest/status/1970416533408186793,https://x.com/IndoPopBase/status/1970324322335236460,1
2025-09-23 02:32:54+00:00,epthia,“Indonesia will immediately recognize the state of Israel” not in our name wok,13,2659,0,221525,https://x.com/epthia/status/1970315407560237488,https://x.com/IndoPopBase/status/1970314525993034222,2672
2025-09-23 02:31:11+00:00,Adekakjill1,Namanya juga pelanggar HAM jadi yaa gak usah heran pengen bestian,13,1615,0,162479,https://x.com/Adekakjill1/status/1970314974607340004,https://x.com/IndoPopBase/status/1970314525993034222,1628
2025-09-23 03:53:26+00:00,kenekadit_,menolak lupa wkwk,30,1932,0,225496,https://x.com/kenekadit_/status/1970335676408467562,https://x.com/IndoPopBase/status/1970314525993034222,1962
2025-09-23 05:18:28+00:00,kiplizzzzz,you need two balls solutions,49,904,0,137358,https://x.com/kiplizzzzz/status/1970357074946334785,https://x.com/IndoPopBase/status/1970314525993034222,953
2025-09-23 02:43:33+00:00,itsmeovv,"As Indonesian, we do not claim HIM",2,353,0,57001,https://x.com/itsmeovv/status/1970318085895962758,https://x.com/IndoPopBase/status/1970314525993034222,355
2025-09-23 02:48:53+00:00,disedvil,"the way he always embarrasses us. stop yapping wo, kerja yang bener kalau jadi presiden",1,310,0,65611,https://x.com/disedvil/status/1970319429809644016,https://x.com/IndoPopBase/status/1970314525993034222,311
2025-09-23 03:14:31+00:00,gelutgelutgelut,"Bayangin udah ngebunuh banyak orang sampe setengah negara, dikasih reward wilayah",11,281,0,49546,https://x.com/gelutgelutgelut/status/1970325880150073619,https://x.com/IndoPopBase/status/1970314525993034222,292
2025-09-23 04:30:16+00:00,SaddamWeb3,"indonesia menolak segala bentuk hubungan resmi dengan entitas zionis.

indonesia secara resmi menunjukkan dukungan terhadap palestina dan tidak mengakui adanya entitas zionis",18,231,0,124275,https://x.com/SaddamWeb3/status/1970344944566186389,https://x.com/IndoPopBase/status/1970314525993034222,249
2025-09-23 05:46:19+00:00,·,Jangan sampe viral plis,1,179,0,70960,https://x.com/faraduts/status/1970364082688753733,https://x.com/IndoPopBase/status/1970314525993034222,180
2025-09-23 05:18:08+00:00,officialinews_,"Pidato Lengkap Presiden Prabowo di Markas PBB terkait Palestina, Tegaskan Solusi Dua Negara",1,1,0,84316,https://x.com/officialinews_/status/1970356990879899854,https://x.com/IndoPopBase/status/1970314525993034222,2
2025-09-23 04:39:40+00:00,boyisnturbae,"udah skizo, asbun, sok jadi pahlawan, program gajetot, mana mau ngakui israhell lagi (kontol)",0,21,0,3812,https://x.com/boyisnturbae/status/1970347309100851408,https://x.com/IndoPopBase/status/1970314525993034222,21
2025-09-23 04:53:30+00:00,negativisme,Paling realistis untuk perdamaian dunia,4,1,0,7645,https://x.com/negativisme/status/1970350790415106272,https://x.com/IndoPopBase/status/1970314525993034222,5
2025-09-23 02:34:28+00:00,fed_febri,we want a peaceful world immediately!,0,0,0,3613,https://x.com/fed_febri/status/1970315801346613275,https://x.com/IndoPopBase/status/1970314525993034222,0
2025-09-23 06:30:24+00:00,irajule13,"FUCKING ZIONIST!

UDAH DARI KEMERDEKAAN KITA HANYA MENGAKUI PALESTINA DAN BAHKAN KITA BANNING ISRAEL MENYENTUH TANAH AIR & UDARA NKRI!!

Si jancok ini bisa-bisa nyocot gak jelas!",1,9,0,19028,https://x.com/irajule13/status/1970375177449201864,https://x.com/IndoPopBase/status/1970314525993034222,10
2025-09-23 04:43:24+00:00,0xHarryry,hmmmm,0,0,0,1416,https://x.com/0xHarryry/status/1970348248469840350,https://x.com/IndoPopBase/status/1970314525993034222,0
2025-09-23 03:16:22+00:00,boredsaurus,The replies agreeing with this labubu  wallahi we're doomed.,1,10,0,12891,https://x.com/boredsaurus/status/1970326348234195240,https://x.com/IndoPopBase/status/1970314525993034222,11
2025-09-23 05:05:24+00:00,heywannaknoww,"harusnya fokus ke two biji solution, ketimbang two state solution",0,16,0,4396,https://x.com/heywannaknoww/status/1970353784611275249,https://x.com/IndoPopBase/status/1970314525993034222,16
2025-09-23 03:02:31+00:00,argentummen,"Bukan fans wowo tapi dia bener sih, two state solutions udah yg paling bener.",119,38,0,69538,https://x.com/argentummen/status/1970322862709121247,https://x.com/IndoPopBase/status/1970314525993034222,157
2025-09-23 02:50:07+00:00,kaviaksami,palestinian statehood isn’t a bargaining chip. it’s overdue,2,3,0,42248,https://x.com/kaviaksami/status/1970319741157024217,https://x.com/IndoPopBase/status/1970314525993034222,5
2025-09-23 03:12:11+00:00,im2l_y,"stop bawa2 nama indonesia, lo klaim sendiri sebagai wowo goblk",0,0,0,1743,https://x.com/im2l_y/status/1970325294809829662,https://x.com/IndoPopBase/status/1970314525993034222,0
2025-09-23 03:10:27+00:00,humafield,"ngabisin banyak duit rakyat, pergi atas nama indonesia yang mana harusnya suara seluruh rakyat. ini malah kepentingan lu semua. memuakkan",1,7,0,3931,https://x.com/humafield/status/1970324857406792082,https://x.com/IndoPopBase/status/1970314525993034222,8
2025-09-23 06:06:30+00:00,G4C0AN,DUA LIPA ENDED UP UR KOSONG DUA EXISTENCE,0,4,0,1899,https://x.com/G4C0AN/status/1970369159860261045,https://x.com/IndoPopBase/status/1970314525993034222,4
2025-09-23 03:35:01+00:00,akunoppicial,"Its only prabowo say, not Indonesian. Indonesian and USA president is same, its just what they want. Not we want",0,8,0,2451,https://x.com/akunoppicial/status/1970331040590995718,https://x.com/IndoPopBase/status/1970314525993034222,8
2025-09-23 02:45:50+00:00,Kukse123,Pengen ku tutup mulutnya,0,0,0,2130,https://x.com/Kukse123/status/1970318661425700963,https://x.com/IndoPopBase/status/1970314525993034222,0
2025-09-23 03:08:17+00:00,gyuickseunoia,Lucu banget sampe bikin nantinya ngakuin Israel. Mangnye Israel perlu banget pengakuan kita? Oh atau mau cepet-cepetan kerja sama? Wok never beating Zionist allegation,1,5,0,3388,https://x.com/gyuickseunoia/status/1970324313204236289,https://x.com/IndoPopBase/status/1970314525993034222,6
2025-09-23 08:29:49+00:00,zzzeen,Apakah Prabowo baru saja secara resmi melanggar UUD 45?,2,7,0,2361,https://x.com/zzzeen/status/1970405228072825178,https://x.com/IndoPopBase/status/1970314525993034222,9
2025-09-23 03:31:01+00:00,keboydayaan,two state solution itu cuma khayalan liberal zionis.,3,6,0,1517,https://x.com/keboydayaan/status/1970330032834027555,https://x.com/IndoPopBase/status/1970314525993034222,9
2025-09-23 04:30:16+00:00,windaberdelapan,Udah tua bukannya meninggal malah bikin statement tolol.,0,6,0,1994,https://x.com/windaberdelapan/status/1970344943903465705,https://x.com/IndoPopBase/status/1970314525993034222,6
2025-09-23 05:19:50+00:00,JanissaryD_Last,"Wkwkwk jenderaaaal jenderal
Prinsip penjajahan diatas dunia harus dihapuskan aja sampean ga ngerti 🫩",5,4,0,23667,https://x.com/JanissaryD_Last/status/1970357417470009483,https://x.com/IndoPopBase/status/1970314525993034222,9
2025-09-23 03:00:17+00:00,·,tolol bego bodoh benga anjing bangsat gendut tololllllll,0,0,0,2256,https://x.com/postraumatized/status/1970322298835214613,https://x.com/IndoPopBase/status/1970314525993034222,0
2025-09-23 02:49:26+00:00,RizkiChrn,Lu aja wok jangan ngajak kita ,3,0,0,106180,https://x.com/RizkiChrn/status/1970319566590091763,https://x.com/IndoPopBase/status/1970314525993034222,3
2025-09-23 04:32:54+00:00,Ali_M_A_Siregar,Duh kok bisa begini? Tidak ada Solusi dua Negara Israel bukan Negara yang ada itu hanya Negara Palestina,0,5,0,2403,https://x.com/Ali_M_A_Siregar/status/1970345607572398473,https://x.com/IndoPopBase/status/1970314525993034222,5
2025-09-23 05:45:17+00:00,B4n6_H4n5,"Semoga anda tetap sehat Prab..  
Dan semoga juga ada waktu untuk membaca ulang dan meresapi makna Pembukaan UUD 45....",1,4,0,9417,https://x.com/B4n6_H4n5/status/1970363820699984258,https://x.com/IndoPopBase/status/1970314525993034222,5
2025-09-23 02:38:00+00:00,Anomalindy,Keren presiden kita tegas dan memilih jalan damai agar kedua belah pihak diuntungkan ,80,13,0,21843,https://x.com/Anomalindy/status/1970316690153185479,https://x.com/IndoPopBase/status/1970314525993034222,93
2025-09-23 03:53:40+00:00,adhiprmndn,"Org Indonesia dikasi berlian malah minta tai 
@deawasatriya
 ",5,1,0,2301,https://x.com/adhiprmndn/status/1970335733069337064,https://x.com/IndoPopBase/status/1970314525993034222,6
2025-09-23 03:45:55+00:00,r0sblok,apa yg lu harapin dari seorang pelanggar HAM?,0,0,0,1113,https://x.com/r0sblok/status/1970333783783362696,https://x.com/IndoPopBase/status/1970314525993034222,0
2025-09-23 22:17:10+00:00,meliksumanandar,"Pidato Prabowo: 
""Jika Israel mengakui Kemerdekaan & Negara Palestina, Indonesia akan mengakui Negara Israel dan mendukung jaminan keamanan untuk Israel"".

Prabowo KEBABLASAN! 
SIAPA yg IJINKAN Prabowo putuskan pengakuan Indonesia thd Israel jika Israel mengakui Negara Palestina?",2,2,0,513,https://x.com/meliksumanandar/status/1970613436393627896,https://x.com/IndoPopBase/status/1970314525993034222,4
2025-09-23 05:49:23+00:00,motherlander,,0,0,0,10237,https://x.com/motherlander/status/1970364856156270622,https://x.com/IndoPopBase/status/1970314525993034222,0
2025-09-23 06:09:44+00:00,bitterthanpills,,0,2,0,956,https://x.com/bitterthanpills/status/1970369977359487470,https://x.com/IndoPopBase/status/1970314525993034222,2
2025-09-23 03:58:31+00:00,rouvenoir,kntol lu aja sendiri sama keluarga lu,0,0,0,918,https://x.com/rouvenoir/status/1970336955356586484,https://x.com/IndoPopBase/status/1970314525993034222,0
2025-09-23 04:07:38+00:00,beautiaf,"stop ngomong yg jelek-jelek dong wok, malu bjir.",0,0,0,17351,https://x.com/beautiaf/status/1970339247816405399,https://x.com/IndoPopBase/status/1970314525993034222,0
2025-09-23 05:05:33+00:00,iwantyoubaby258,"pentingnya milih presiden yang punya empati

sayangnya presiden terpilih ga pernah diajari soal empati dari kecil.",1,1,0,1186,https://x.com/iwantyoubaby258/status/1970353822192333144,https://x.com/IndoPopBase/status/1970314525993034222,2
2025-09-23 06:42:37+00:00,spiderk1tt1,thn depan kiamat yg setuju like,0,1,0,372,https://x.com/spiderk1tt1/status/1970378249940410736,https://x.com/IndoPopBase/status/1970314525993034222,1
2025-09-23 03:32:50+00:00,helloseakun,"udah lah ga pernah dianggep, pas ngomong keluar bawa2 kita",0,2,0,1243,https://x.com/helloseakun/status/1970330492269666550,https://x.com/IndoPopBase/status/1970314525993034222,2
2025-09-23 08:42:20+00:00,kencilii,"negara islam majority punya presiden ga teges gini ngarepin apa, maen aman ternyata",0,1,0,694,https://x.com/kencilii/status/1970408376418083053,https://x.com/IndoPopBase/status/1970314525993034222,1
2025-09-23 03:44:07+00:00,notyourones,najis huek zionis bangsat,0,0,0,755,https://x.com/notyourones/status/1970333331826086368,https://x.com/IndoPopBase/status/1970314525993034222,0
2025-09-23 05:32:43+00:00,LailaTamsin,"Opsi selain two-state-solution adalah one-state-only dan memperhatikan situasi terkini itu adalah Israel Raya, Palestina musnah. Heran orang2 kritik Prabowo padahal itu posisi Indonesia sejak awal dan tidak berubah.",2,0,0,3112,https://x.com/LailaTamsin/status/1970360660208099767,https://x.com/IndoPopBase/status/1970314525993034222,2
2025-09-23 04:53:41+00:00,jerrymoontz,"Apa ya dosa indonesia di masa lalu, sekarang punya presiden kaya dia",1,0,0,4639,https://x.com/jerrymoontz/status/1970350836753858652,https://x.com/IndoPopBase/status/1970314525993034222,1
2025-09-23 02:51:05+00:00,shaawturnus,What expect dari pemikiran seorang penjahat ham,1,0,0,7762,https://x.com/shaawturnus/status/1970319984258883821,https://x.com/IndoPopBase/status/1970314525993034222,1
2025-09-23 03:41:10+00:00,viachandesu,We're so doomed RRAGHHHH,1,0,0,1280,https://x.com/viachandesu/status/1970332585302859804,https://x.com/IndoPopBase/status/1970314525993034222,1
2025-09-23 03:58:43+00:00,SaddamWeb3,jd hari balance dunia versi alam semesta,0,0,0,1641,https://x.com/SaddamWeb3/status/1970337002068550005,https://x.com/IndoPopBase/status/1970309879584956899,0
2025-09-23 05:26:48+00:00,Kemenirr,"I am not leaving my air conditioned room today, and will be taking a nap on my lunch time. Thank you",1,2,0,3250,https://x.com/Kemenirr/status/1970359169623761169,https://x.com/IndoPopBase/status/1970309879584956899,3
2025-09-23 03:02:30+00:00,wolgrave_id,They done turned off shadows,0,0,0,3037,https://x.com/wolgrave_id/status/1970322857231294498,https://x.com/IndoPopBase/status/1970309879584956899,0
2025-09-23 05:53:12+00:00,kaelovelution,oalah pantes hari ini panas banget ,0,0,0,2721,https://x.com/kaelovelution/status/1970365816668655906,https://x.com/IndoPopBase/status/1970309879584956899,0
2025-09-23 06:41:42+00:00,jiyeox,the autumnal equinox is upon us ,0,0,0,3047,https://x.com/jiyeox/status/1970378019555652010,https://x.com/IndoPopBase/status/1970309879584956899,0
2025-09-23 07:17:19+00:00,·,Pantesan neraka bocor,0,0,0,793,https://x.com/patungmacan/status/1970386981831225399,https://x.com/IndoPopBase/status/1970309879584956899,0
2025-09-23 08:40:13+00:00,datuyulianto,And let's we recreate experimentation on how erasthotenes measure the circumference of the earth,1,0,0,1496,https://x.com/datuyulianto/status/1970407844790026339,https://x.com/IndoPopBase/status/1970309879584956899,1
2025-09-23 08:15:06+00:00,yeagerist666,Low graphic settings shadow off,0,1,0,577,https://x.com/yeagerist666/status/1970401525534244977,https://x.com/IndoPopBase/status/1970309879584956899,1
2025-09-23 06:10:17+00:00,sugar_6378,ini bukannya udah tutup yah?,0,0,0,914,https://x.com/sugar_6378/status/1970370112244109520,https://x.com/IndoPopBase/status/1970309879584956899,0
2025-09-23 15:03:23+00:00,Faris7_,Pantesan panas bin gerah,0,0,0,191,https://x.com/Faris7_/status/1970504274347212898,https://x.com/IndoPopBase/status/1970309879584956899,0
2025-09-23 06:55:22+00:00,enggginerr,"pantesan puuanasssssss 
@davinaarifin27",1,0,0,257,https://x.com/enggginerr/status/1970381460470468946,https://x.com/IndoPopBase/status/1970309879584956899,1
2025-09-23 11:11:32+00:00,Aqvaaaa,And I just had to read this right after sunset,0,0,0,327,https://x.com/Aqvaaaa/status/1970445926969053380,https://x.com/IndoPopBase/status/1970309879584956899,0
2025-09-23 08:06:40+00:00,awdelee,pantesan panas bgt gila,0,0,0,15,https://x.com/awdelee/status/1970399401052090839,https://x.com/IndoPopBase/status/1970309879584956899,0
2025-09-24 09:51:19+00:00,snell_ius_sil3,The southern part of the world is getting sauna-steamed every day until February next year~~~,0,0,0,12,https://x.com/snell_ius_sil3/status/1970788125317439554,https://x.com/IndoPopBase/status/1970309879584956899,0
2025-09-23 15:08:58+00:00,·,o pantes,0,0,0,38,https://x.com/proudanorexic/status/1970505677950054756,https://x.com/IndoPopBase/status/1970309879584956899,0
2025-09-23 17:41:21+00:00,Noir_68,,0,0,0,89,https://x.com/Noir_68/status/1970544024567324723,https://x.com/IndoPopBase/status/1970309879584956899,0
2025-09-23 08:17:29+00:00,ssriize_,"Panas luar dalam 

Dalam ku asli ubun2 organ panas 

Gobs yang bikin kek gini",1,1,0,412,https://x.com/ssriize_/status/1970402126556995679,https://x.com/IndoPopBase/status/1970309879584956899,2
2025-09-23 07:22:43+00:00,whiteforest___,And then..?,0,0,0,501,https://x.com/whiteforest___/status/1970388343654601080,https://x.com/IndoPopBase/status/1970309879584956899,0
2025-09-23 11:16:59+00:00,ratnasekar,Pantesan Very hot isn't general,0,0,0,149,https://x.com/ratnasekar/status/1970447296409321878,https://x.com/IndoPopBase/status/1970309879584956899,0
2025-09-23 03:00:46+00:00,felixputrinoble,Where's the photo on the right from?,0,0,0,1539,https://x.com/felixputrinoble/status/1970322419849343182,https://x.com/IndoPopBase/status/1970309879584956899,0
2025-09-23 08:44:29+00:00,allofthestarsxo,@palamuter,1,0,0,38,https://x.com/allofthestarsxo/status/1970408918158581920,https://x.com/IndoPopBase/status/1970309879584956899,1
2025-09-23 07:43:06+00:00,leondincht,We blame our khia vice prez ,0,0,0,142,https://x.com/leondincht/status/1970393473846255974,https://x.com/IndoPopBase/status/1970309879584956899,0
2025-09-23 11:58:14+00:00,chipashuu,pantes panas bangett,0,0,0,449,https://x.com/chipashuu/status/1970457677898928209,https://x.com/IndoPopBase/status/1970309879584956899,0
2025-09-23 02:48:47+00:00,VanAdrian25,Equinox mentioned,0,0,0,2998,https://x.com/VanAdrian25/status/1970319404085977151,https://x.com/IndoPopBase/status/1970309879584956899,0
2025-09-23 02:11:32+00:00,JavaJimmyMaukar,solar eclipse nz,0,0,0,927,https://x.com/JavaJimmyMaukar/status/1970310031758483915,https://x.com/IndoPopBase/status/1970309879584956899,0
2025-09-23 02:11:20+00:00,JavaJimmyMaukar,whatabout ecplipse?,0,0,0,1165,https://x.com/JavaJimmyMaukar/status/1970309978692223333,https://x.com/IndoPopBase/status/1970309879584956899,0
2025-09-23 07:47:08+00:00,zyaadaaaa,Pantes puanase potato potatooo,1,0,0,187,https://x.com/zyaadaaaa/status/1970394485998997816,https://x.com/IndoPopBase/status/1970309879584956899,1
2025-09-24 03:04:27+00:00,luvinurcahya,Pantesan. Padahal udah didlm rumah terus kipasan tp tetep panasnya kek gak biasanya,0,0,0,50,https://x.com/luvinurcahya/status/1970685734509219890,https://x.com/IndoPopBase/status/1970309879584956899,0
2025-09-23 07:55:55+00:00,rodokkasinen,layaknoooo,0,0,0,167,https://x.com/rodokkasinen/status/1970396697357623649,https://x.com/IndoPopBase/status/1970309879584956899,0
2025-09-23 05:28:45+00:00,vesviez,"@grok
 apakah bakal panas sekali hari ini?",1,0,0,814,https://x.com/vesviez/status/1970359661955310049,https://x.com/IndoPopBase/status/1970309879584956899,1
2025-09-23 02:46:57+00:00,deethemedia,"@grok
 what that mean ?",1,0,0,544,https://x.com/deethemedia/status/1970318944700715064,https://x.com/IndoPopBase/status/1970309879584956899,1
2025-09-23 04:08:08+00:00,Nagiiiiseishiro,my dih will divided into two symmetrical parts at 12:00 am,1,0,0,503,https://x.com/Nagiiiiseishiro/status/1970339375356543406,https://x.com/IndoPopBase/status/1970309879584956899,1
2025-09-23 02:12:23+00:00,airdrop_goe,"@grok
 jelaskan tentang ini",2,1,0,3308,https://x.com/airdrop_goe/status/1970310244489416914,https://x.com/IndoPopBase/status/1970309879584956899,3
2025-09-23 07:50:02+00:00,brodeldi,Oalah pantesan,0,0,0,74,https://x.com/brodeldi/status/1970395217909162083,https://x.com/IndoPopBase/status/1970309879584956899,0
2025-09-23 02:21:27+00:00,AmberSaira95910,"""Rise and shine, beauty!  Time to serve face and slay the day """,0,0,0,1223,https://x.com/AmberSaira95910/status/1970312526006231488,https://x.com/IndoPopBase/status/1970309879584956899,0
2025-09-23 02:37:10+00:00,Th3Tr4vel3r,dampaknya apa ?,0,0,0,2056,https://x.com/Th3Tr4vel3r/status/1970316479779479582,https://x.com/IndoPopBase/status/1970309879584956899,0
2025-09-21 06:36:36+00:00,akunbermanfaat,hbs release trus dibawain di farewell party leeds record,0,3,0,3476,https://x.com/akunbermanfaat/status/1969651959134372265,https://x.com/IndoPopBase/status/1969632970924572738,3
2025-09-21 05:24:27+00:00,PROSPERDEGREAT,Feast proved that music could be protested and poetry at the same time.,0,2,0,3258,https://x.com/PROSPERDEGREAT/status/1969633805482017201,https://x.com/IndoPopBase/status/1969632970924572738,2
2025-09-21 11:50:56+00:00,kuahencr,,0,1,0,1620,https://x.com/kuahencr/status/1969731065926582427,https://x.com/IndoPopBase/status/1969632970924572738,1
2025-09-21 09:38:52+00:00,azaqmr,Listening to Berita Kehilangan still giving me chills,0,0,0,1730,https://x.com/azaqmr/status/1969697828818813307,https://x.com/IndoPopBase/status/1969632970924572738,0
2025-09-21 06:17:28+00:00,Law_of_manifest,Feast proved that music could be protested and poetry at the same time.,0,0,0,1520,https://x.com/Law_of_manifest/status/1969647144945795514,https://x.com/IndoPopBase/status/1969632970924572738,0
2025-09-21 05:24:05+00:00,PROSPERDEGREAT,That album hit harder than most political speeches in 2016.,0,0,0,1757,https://x.com/PROSPERDEGREAT/status/1969633711596408985,https://x.com/IndoPopBase/status/1969632970924572738,0
2025-09-21 19:54:01+00:00,ilhamsheszhhh,karena lagu ini gw ga tone deaf sedari smp.,0,0,0,652,https://x.com/ilhamsheszhhh/status/1969852636141846757,https://x.com/IndoPopBase/status/1969632970924572738,0
2025-09-22 04:36:11+00:00,ondodagomez,"cover paling mind blowing dari semua album yg pernah gw liat.
apalagi yang pas mereka ngeremake last supper. ",0,0,0,313,https://x.com/ondodagomez/status/1969984043140964749,https://x.com/IndoPopBase/status/1969632970924572738,0
2025-09-21 05:44:45+00:00,manesnoire,"Inget waktu pertama kali lihat ini rilis di twt, amazed sama cover artnya yg terasa deket tapi masih terlalu berani buat tahun itu, of course karena itu Bunda Maria. Langsung gw dengerin dan cocok, akhirnya ngikutin mereka sampe sekarang.",0,0,0,19,https://x.com/manesnoire/status/1969638911606735255,https://x.com/IndoPopBase/status/1969632970924572738,0
2025-09-22 06:57:37+00:00,·,"Duck Down Bar, 14 July 2019. Good old days 
@listentofeast",0,0,0,354,https://x.com/plagoande/status/1970019638533664779,https://x.com/IndoPopBase/status/1969632970924572738,0
2025-09-21 08:29:04+00:00,ananurulfzh,dengerin dari zaman SMA,0,0,0,1390,https://x.com/ananurulfzh/status/1969680265766453462,https://x.com/IndoPopBase/status/1969632970924572738,0
2025-09-22 03:18:51+00:00,pelurukuhabis,"Sejarah di negeri ini bukan ditulis dengan tinta, melainkan dengan darah yang diminta untuk dilupakan dan 7 tahun pun berlalu",0,0,0,184,https://x.com/pelurukuhabis/status/1969964583722062310,https://x.com/IndoPopBase/status/1969632970924572738,0
2025-09-21 09:12:54+00:00,w0rdfengs,masterpiece,0,0,0,1117,https://x.com/w0rdfengs/status/1969691296513315111,https://x.com/IndoPopBase/status/1969632970924572738,0
2025-09-21 05:29:12+00:00,0xgasm,never heard the album,0,0,0,1697,https://x.com/0xgasm/status/1969635000518918652,https://x.com/IndoPopBase/status/1969632970924572738,0
2025-09-21 10:26:43+00:00,helmxbox,Banger,0,0,0,965,https://x.com/helmxbox/status/1969709869684134084,https://x.com/IndoPopBase/status/1969632970924572738,0
2025-09-22 11:06:06+00:00,hedonkuy,Klo orang ini mah udh masuk sd,0,0,0,167,https://x.com/hedonkuy/status/1970082172724990077,https://x.com/IndoPopBase/status/1969632970924572738,0
2025-09-21 07:27:54+00:00,hizkiyeahhh,generational.,0,0,0,1669,https://x.com/hizkiyeahhh/status/1969664871542514017,https://x.com/IndoPopBase/status/1969632970924572738,0
2025-09-21 13:41:18+00:00,RizkiChrn,Lit album,0,0,0,729,https://x.com/RizkiChrn/status/1969758841077399842,https://x.com/IndoPopBase/status/1969632970924572738,0
2025-09-21 13:53:16+00:00,bigdre_25,Banger,0,0,0,615,https://x.com/bigdre_25/status/1969761853346885972,https://x.com/IndoPopBase/status/1969632970924572738,0
2025-09-21 05:35:09+00:00,rebelbaachi,Okay ,0,0,0,1347,https://x.com/rebelbaachi/status/1969636497004642540,https://x.com/IndoPopBase/status/1969632970924572738,0
2025-09-21 05:22:51+00:00,airdrop_goe,Hmm,0,1,0,1708,https://x.com/airdrop_goe/status/1969633399175594239,https://x.com/IndoPopBase/status/1969632970924572738,1
2025-09-22 01:46:03+00:00,Th3Tr4vel3r,siapakah mereka ?,0,0,0,146,https://x.com/Th3Tr4vel3r/status/1969941227467673909,https://x.com/IndoPopBase/status/1969632970924572738,0
2025-09-21 05:20:24+00:00,PROSPERDEGREAT,"‘Merakit’ wasn’t just an album, it set the standard for Indonesian pop storytelling",0,0,0,197,https://x.com/PROSPERDEGREAT/status/1969632784403648791,https://x.com/IndoPopBase/status/1969631620476125480,0
2025-09-21 08:30:31+00:00,sugar_6378,teh Yunita cantik,0,0,0,146,https://x.com/sugar_6378/status/1969680629433581885,https://x.com/IndoPopBase/status/1969631620476125480,0
2025-09-21 05:57:10+00:00,repxkomh13,She had that hairstyle and a dream,0,0,0,115,https://x.com/repxkomh13/status/1969642038061908129,https://x.com/IndoPopBase/status/1969631620476125480,0
2025-09-21 05:18:48+00:00,airdrop_goe,Wow,0,1,0,191,https://x.com/airdrop_goe/status/1969632381197041762,https://x.com/IndoPopBase/status/1969631620476125480,1
2025-09-21 06:24:14+00:00,jackthegon,7 years ago? Wow,0,0,0,82,https://x.com/jackthegon/status/1969648850731405367,https://x.com/IndoPopBase/status/1969631620476125480,0
2025-09-22 01:46:50+00:00,Th3Tr4vel3r,indonesia asli nih,0,0,0,57,https://x.com/Th3Tr4vel3r/status/1969941424704741599,https://x.com/IndoPopBase/status/1969631620476125480,0
2025-10-10 09:12:06+00:00,IndoPopBase,Amanda Manopo and Kenny Austin have married.,161,495,0,202624,https://x.com/IndoPopBase/status/1976576461684519229,https://x.com/IndoPopBase/status/1969631620476125480,656
2025-10-09 09:27:44+00:00,QUEERAUSAHAAN,ammar zoni is the best anti-drug ad cause WTF HAPPENED like oh my god…..,124,904,0,584645,https://x.com/QUEERAUSAHAAN/status/1976218010957512842,https://x.com/IndoPopBase/status/1969631620476125480,1028
2025-10-09 06:42:03+00:00,Keangae_Mk2,,269,58958,0,7768627,https://x.com/Keangae_Mk2/status/1976176315322728818,https://x.com/IndoPopBase/status/1969631620476125480,59227
2025-10-09 14:34:33+00:00,findormeme,bunch of elementary school kids revealing their exam passing status while slipping through my fingers is playing on the background meryl streep tidak lulus anak sd nangis dramatic hasil ujian nangis,379,2216,0,1439491,https://x.com/findormeme/status/1976295222960427487,https://x.com/IndoPopBase/status/1969631620476125480,2595
2025-09-21 06:18:00+00:00,SaddamWeb3,"nih alasan knp seblak trending di thailand
efek before after nya nyata",12,298,0,137147,https://x.com/SaddamWeb3/status/1969647279805251961,https://x.com/IndoPopBase/status/1969628625139089670,310
2025-09-21 06:00:47+00:00,irsanpratama,ini baru namanya séblaqùe,37,70,0,99897,https://x.com/irsanpratama/status/1969642947026305179,https://x.com/IndoPopBase/status/1969628625139089670,107
2025-09-21 05:10:32+00:00,motherlander,"It's expected, as subregion of Sundaland",4,95,0,111262,https://x.com/motherlander/status/1969630301484957883,https://x.com/IndoPopBase/status/1969628625139089670,99
2025-09-21 05:41:46+00:00,redermoree,"Komentar penuh sama orang pick me najis, kalo gasuka ya gausah komen disini. Seblak itu makanan, sebagian orang khususnya orang sunda suka, gak etis ""rendahin"" makanan orang lain.",15,58,0,30757,https://x.com/redermoree/status/1969638159916154894,https://x.com/IndoPopBase/status/1969628625139089670,73
2025-09-21 06:55:00+00:00,huedaya,"Dear Thai people, let's propose today as International Seblak Day as a celebration of our brotherhood, deal? ",5,74,0,95625,https://x.com/huedaya/status/1969656591520841734,https://x.com/IndoPopBase/status/1969628625139089670,79
2025-09-21 06:18:02+00:00,guoliangtjia,SEBLAK HERE WE GO,0,2,0,25621,https://x.com/guoliangtjia/status/1969647287254302962,https://x.com/IndoPopBase/status/1969628625139089670,2
2025-09-21 05:39:38+00:00,TorroSTY,The real dihina di negeri sendiri digemari di negeri orang,1,0,0,2689,https://x.com/TorroSTY/status/1969637625251377404,https://x.com/IndoPopBase/status/1969628625139089670,1
2025-09-21 21:44:21+00:00,rcrhm,"Aslii.. fyp Tiktok isinya orang Thai pada makan Seblak  ini kalau gak di manfaatin momennya sama orang Indo buat bikin seblak instan skala industri, bakalan langsung dibuat dan di expor sama orang Thai sendiri. Thai's food industry was so advanced",1,0,0,1207,https://x.com/rcrhm/status/1969880403533238644,https://x.com/IndoPopBase/status/1969628625139089670,1
2025-09-21 05:58:52+00:00,Ichitanindo,"bentar bentar, siapa yang bawa seblak kesana ",13,1,0,105173,https://x.com/Ichitanindo/status/1969642463741821303,https://x.com/IndoPopBase/status/1969628625139089670,14
2025-09-21 05:14:49+00:00,yuliapandaa,Siapa yg sama kek aku makan seblak tapi bilang ke tetehnya jgn dimasukin kerupuk,10,2,0,30457,https://x.com/yuliapandaa/status/1969631380423524528,https://x.com/IndoPopBase/status/1969628625139089670,12
2025-09-21 07:17:38+00:00,__Astari,As my thai friend’s explanation this is the start of the the seblak craze in Thailand. We should award this guy ,0,4,0,10699,https://x.com/__Astari/status/1969662288195174818,https://x.com/IndoPopBase/status/1969628625139089670,4
2025-09-21 11:12:29+00:00,·,It's time seblak conquering the world. We've had enough of ramen.,0,2,0,35347,https://x.com/agunsux/status/1969721389935730883,https://x.com/IndoPopBase/status/1969628625139089670,2
2025-09-21 06:01:21+00:00,haikarrll85,"Dulu bisa banget gak suka seblak, tapi jadi suka.. 

Seblak tuh enak banget, bisa ngangetin tubuh,
(wajar sih kenapa dimakannya pas ujan juga)",0,0,0,1383,https://x.com/haikarrll85/status/1969643089045438967,https://x.com/IndoPopBase/status/1969628625139089670,0
2025-09-21 05:07:51+00:00,moodjianto,and my fave BNK48?,2,3,0,3958,https://x.com/moodjianto/status/1969629627120566333,https://x.com/IndoPopBase/status/1969628625139089670,5
2025-09-21 06:11:06+00:00,faykazia,"ngeliat reply nya, ternyata seblak banyak hatersnya",0,0,0,772,https://x.com/faykazia/status/1969645543656996899,https://x.com/IndoPopBase/status/1969628625139089670,0
2025-09-21 12:53:21+00:00,afternoondtea,cobain seblak instan ini gaes enaaakk,0,0,0,8811,https://x.com/afternoondtea/status/1969746774119313852,https://x.com/IndoPopBase/status/1969628625139089670,0
2025-09-21 08:22:13+00:00,RakaSudi,"This may be our third trending topic in Thailand this year, following homophobic behavior and government corruption.",1,2,0,11370,https://x.com/RakaSudi/status/1969678540619800955,https://x.com/IndoPopBase/status/1969628625139089670,3
2025-09-21 07:20:27+00:00,mozardien,Seblak - Sundanese dish based on wet crackers cooked with a mixture of typical Sundanese spices,0,5,0,3592,https://x.com/mozardien/status/1969662994474025421,https://x.com/IndoPopBase/status/1969628625139089670,5
2025-09-21 05:34:06+00:00,Lengkuas,"Seharusnya yang viral seblak originalnya jangan yang kuah banyak isinya kea suki-sukian, apalagi ada yang ga pake kencur.",3,0,0,7656,https://x.com/Lengkuas/status/1969636233539437000,https://x.com/IndoPopBase/status/1969628625139089670,3
2025-09-21 05:55:15+00:00,xxxaryadi,"Seblak bukan makanan manusia kata pegawai BUMN 
@unmagnetism",1,0,0,11144,https://x.com/xxxaryadi/status/1969641555360432552,https://x.com/IndoPopBase/status/1969628625139089670,1
2025-09-21 05:16:04+00:00,PROSPERDEGREAT,"The question is, will Thailand make it spicier or sweeter?",6,2,0,47219,https://x.com/PROSPERDEGREAT/status/1969631693851279393,https://x.com/IndoPopBase/status/1969628625139089670,8
2025-09-21 11:57:40+00:00,B4n6_H4n5,Ternyata begitu menggodanya seblak....,0,0,0,4205,https://x.com/B4n6_H4n5/status/1969732760530194907,https://x.com/IndoPopBase/status/1969628625139089670,0
2025-09-21 06:54:30+00:00,SifaAul88106597,"Org thailand pasti bahagia kalau main ke Garut,tiap pengkolan tiap gang buanyak buanget yg jualan seblak ",0,0,0,618,https://x.com/SifaAul88106597/status/1969656463946854666,https://x.com/IndoPopBase/status/1969628625139089670,0
2025-09-21 06:49:41+00:00,Xunloaders,"Don't tell me the seblak without kencur version
Seblak without kencur isn't seblak anymore",0,0,0,1526,https://x.com/Xunloaders/status/1969655252850004013,https://x.com/IndoPopBase/status/1969628625139089670,0
2025-09-21 06:42:41+00:00,is_pelssy,"Yukk nyanyikan ""seblak sarapan is my country""",0,0,0,11661,https://x.com/is_pelssy/status/1969653490701255036,https://x.com/IndoPopBase/status/1969628625139089670,0
2025-09-21 05:55:39+00:00,bsideofhell,"Pantesan dari kmren banyak bgt org Thailand yg posting bikin seblak di Tiktok anjir

Ada yg bikin ala2 seblak prasmanan dirumah buat anaknya, gemes ",0,0,0,1259,https://x.com/bsideofhell/status/1969641656623513834,https://x.com/IndoPopBase/status/1969628625139089670,0
2025-09-22 00:56:30+00:00,fiqobxt,"Orang Indonesia ini pickme bgt perkara perkulineran.Rendang salah masak ribut, Seblak menu simpel viral ribut,bahkan Soto Daging dagingnya diiris tipis² aja juga ribut.Sudahlah masakan Indonesia hampir semuanya gk punya standar resep yg pasti,ketika viral/terkenal diluar gk semua",1,0,0,450,https://x.com/fiqobxt/status/1969928760666497359,https://x.com/IndoPopBase/status/1969628625139089670,1
2025-09-21 10:17:31+00:00,musadz_,"@wabbylikethings
 @IHitMySelfOuch
 @D1N0_S4R3
 
is it true lol",3,0,0,526,https://x.com/musadz_/status/1969707555950911809,https://x.com/IndoPopBase/status/1969628625139089670,3
2025-09-21 06:46:02+00:00,ch4wp,"seblak 7k digang emg paling worth it
#seblakbundatitibdg",2,0,0,2976,https://x.com/ch4wp/status/1969654332992995610,https://x.com/IndoPopBase/status/1969628625139089670,2
2025-09-21 06:40:05+00:00,galangilman,"Gak tau asal muasal kok bisa viral, tpi dilihat dri konten seblak thailand yg ada, merek ini selalu ada",0,0,0,797,https://x.com/galangilman/status/1969652835995566349,https://x.com/IndoPopBase/status/1969628625139089670,0
2025-09-21 06:08:03+00:00,Law_of_manifest,apa cuma gw yang ngerasa kalo seblak itu gak enak sama sekali,4,0,0,4409,https://x.com/Law_of_manifest/status/1969644775600243081,https://x.com/IndoPopBase/status/1969628625139089670,4
2025-09-22 04:05:02+00:00,Marshayangg,"Komennya pada aneh bgt anjer, kalo gasuka yaudah diem aja anjir gausah ngehina makanan. Lo pikir lo lebih oke karena belom pernah makan seblak atau gak suka seblak?",0,0,0,248,https://x.com/Marshayangg/status/1969976205668745252,https://x.com/IndoPopBase/status/1969628625139089670,0
2025-09-21 05:10:30+00:00,evermorhe,ended tom yum,1,0,0,6895,https://x.com/evermorhe/status/1969630291301191968,https://x.com/IndoPopBase/status/1969628625139089670,1
2025-09-21 06:27:20+00:00,AnggodoJosh,Nggak doyan ,2,1,0,170,https://x.com/AnggodoJosh/status/1969649630729421026,https://x.com/IndoPopBase/status/1969628625139089670,3
2025-09-21 06:45:58+00:00,AdangS94,Malah kaya mie instan cara bikinnya. Tapi seblak.,0,0,0,7624,https://x.com/AdangS94/status/1969654320183591067,https://x.com/IndoPopBase/status/1969628625139089670,0
2025-09-22 09:56:52+00:00,BaeEvelyn24,Islam was ended,0,0,0,29,https://x.com/BaeEvelyn24/status/1970064747749048691,https://x.com/IndoPopBase/status/1969628625139089670,0
2025-09-21 06:47:52+00:00,Ini_Ibil,"Makanan ini paling banyak hatersnya, padahal kalo nggak suka ya sesimple gak usah koar2 bilang gak suka. Sesuai selera aja
Ini yang menghambat kuliner Indonesia dikenal dunia, padahal kan enak ya kalo jalan2 di LN tiba2 makanan angkringan",0,0,0,699,https://x.com/Ini_Ibil/status/1969654794785865777,https://x.com/IndoPopBase/status/1969628625139089670,0
2025-09-21 05:05:48+00:00,calmdownhunny,ended mango sticky rice,0,0,0,766,https://x.com/calmdownhunny/status/1969629108482293926,https://x.com/IndoPopBase/status/1969628625139089670,0
2025-09-22 08:41:06+00:00,·,"คนไทยมาทางนี้เลยค้า ใครอยากลอง
อันนี้คือเหมือนสุด ชั้นลองมาแล้ว! (อย่าลืมใส่ไข่ไปด้วยนะตอนต้ม) นัวร์!!!!",1,1,0,106,https://x.com/sawaddeekaesad/status/1970045679969210681,https://x.com/IndoPopBase/status/1969628625139089670,2
2025-09-21 07:21:01+00:00,discreet_banget,"Tahun 2025 belum sempat makan seblak karna di tahun 2024 makan seblak sekali kurang enak, ada rekomendasi seblak yg enak di Depok - Jkt?",6,0,0,14377,https://x.com/discreet_banget/status/1969663139546612202,https://x.com/IndoPopBase/status/1969628625139089670,6
2025-09-21 13:24:14+00:00,phibays,"sumpahh dari tadi fyp orang thailand makan seblak, apakah harus buka seblak prasmanan di keung thep mahanakhon?",0,0,0,269,https://x.com/phibays/status/1969754545342628202,https://x.com/IndoPopBase/status/1969628625139089670,0
2025-09-22 08:47:13+00:00,·,"Wah, bagus nih progress Gastrodiplomacy nya, walaupun ga expect ya hidangan yang melejit justru seblak (padahal yang sering digadang-gadang itu nasi goreng, sate, rendang, dll.)",0,0,0,139,https://x.com/kapiaaang/status/1970047220188930054,https://x.com/IndoPopBase/status/1969628625139089670,0
2025-09-21 05:47:30+00:00,dipuisikan,From Bandung to the world.,0,0,0,340,https://x.com/dipuisikan/status/1969639603826278834,https://x.com/IndoPopBase/status/1969628625139089670,0
2025-09-21 11:34:35+00:00,Littlejaduu,"wihhh keren si, tapi gue ga suka seblak",0,0,0,6828,https://x.com/Littlejaduu/status/1969726951557664957,https://x.com/IndoPopBase/status/1969628625139089670,0
2025-09-21 17:47:05+00:00,saltybabyyyyy,astagaaa wkwkwkw,0,0,0,2864,https://x.com/saltybabyyyyy/status/1969820692876333312,https://x.com/IndoPopBase/status/1969628625139089670,0
2025-09-22 04:25:29+00:00,Sugilico3,"ada yang tau trendingnya gara2 apa tah?
makanan favorit gue banget ini!
bentar lagi kayanya keluar Seblak Tom Yam",0,0,0,3607,https://x.com/Sugilico3/status/1969981353111568551,https://x.com/IndoPopBase/status/1969628625139089670,0
2025-09-21 06:07:36+00:00,Law_of_manifest,I don't know about Seblak anybody tell about this,0,0,0,7556,https://x.com/Law_of_manifest/status/1969644663893344737,https://x.com/IndoPopBase/status/1969628625139089670,0
2025-09-21 06:52:39+00:00,cornetto_bnw,ow yeaaa seblak go internesyenel,1,0,0,25,https://x.com/cornetto_bnw/status/1969656000518242327,https://x.com/IndoPopBase/status/1969628625139089670,1
2025-09-22 01:23:34+00:00,MrGensta,"""apa cuma"" ""apa cuma"" ahhhh moment",0,0,0,35,https://x.com/MrGensta/status/1969935570462998942,https://x.com/IndoPopBase/status/1969628625139089670,0
2025-09-21 13:50:47+00:00,chocopit96,I always thinking that seblak can be as popular as tteokppokki,0,0,0,94,https://x.com/chocopit96/status/1969761225430220894,https://x.com/IndoPopBase/status/1969628625139089670,0
2025-09-20 04:17:13+00:00,fed_febri,temporary? so will continue tot tot wut wut? ,0,1,0,6116,https://x.com/fed_febri/status/1969254497760280808,https://x.com/IndoPopBase/status/1969252499526684858,1
2025-09-20 04:44:04+00:00,bareda,Boleh nyalain kalau lagi ngejar pejabat korup.,1,7,0,8032,https://x.com/bareda/status/1969261254691705020,https://x.com/IndoPopBase/status/1969252499526684858,8
2025-09-20 04:18:33+00:00,SaddamWeb3,tot tot wut wut,0,1,0,3717,https://x.com/SaddamWeb3/status/1969254830884434094,https://x.com/IndoPopBase/status/1969252499526684858,1
2025-09-20 06:25:46+00:00,officialinews_,"BREAKING NEWS: Sirine 'Tot Tot Wuk Wuk' untuk Patwal Dibekukan, Ini Rincian Aturan Resminya",0,2,0,3462,https://x.com/officialinews_/status/1969286847743373539,https://x.com/IndoPopBase/status/1969252499526684858,2
2025-09-20 04:14:18+00:00,0xHarryry,okayy? yakin gak di pakai lagi?,1,0,0,1818,https://x.com/0xHarryry/status/1969253762578473323,https://x.com/IndoPopBase/status/1969252499526684858,1
2025-09-20 05:33:00+00:00,beautiaf,"PRETTT kamis gue di Bandung ketemu tetot terot sampe 2x dlm kurun waktu kurang dr 3 jam

mending sekalian aja permanent, ganggu warga tau gak sih",7,0,0,6090,https://x.com/beautiaf/status/1969273565670256786,https://x.com/IndoPopBase/status/1969252499526684858,7
2025-09-20 04:30:43+00:00,schfreuss,"permanent aja lah kocak, apalagi kalo cuma ngawal pejabat, kaya kepentinganya mentingin rakyat aja kocak. dasar jongos pejabat",1,0,0,2208,https://x.com/schfreuss/status/1969257895335264378,https://x.com/IndoPopBase/status/1969252499526684858,1
2025-09-20 04:24:49+00:00,sergei_Nikolaii,Kenapa ga permanen?,0,0,0,4455,https://x.com/sergei_Nikolaii/status/1969256407510700100,https://x.com/IndoPopBase/status/1969252499526684858,0
2025-09-20 04:15:13+00:00,ursteulyNaveen,"Finally, some peace for our ears … now Jakarta traffic sounds like traffic again, not a nightclub on wheels. ",0,0,0,3668,https://x.com/ursteulyNaveen/status/1969253993218978169,https://x.com/IndoPopBase/status/1969252499526684858,0
2025-09-20 07:42:53+00:00,·,selamanya,0,0,0,22,https://x.com/worcofart/status/1969306252200030533,https://x.com/IndoPopBase/status/1969252499526684858,0
2025-09-20 06:38:57+00:00,aralierve,Gedeg banget dengernya tau ga sih klo lewat di jalan,0,0,0,2032,https://x.com/aralierve/status/1969290162996686865,https://x.com/IndoPopBase/status/1969252499526684858,0
2025-09-20 05:36:19+00:00,·,wkwkwwkwk kebohongan apalagi ini,0,0,0,97,https://x.com/eternalkokie/status/1969274403583050109,https://x.com/IndoPopBase/status/1969252499526684858,0
2025-09-20 04:48:45+00:00,bekind80108,"Berhenti bukan atas kesadaran, tp karena banyak yg protes.

Yhaa what do you expect from this superior institution",0,0,0,6,https://x.com/bekind80108/status/1969262432863330639,https://x.com/IndoPopBase/status/1969252499526684858,0
2025-09-20 04:44:13+00:00,pluemonac,Wak wok wak wok,0,0,0,103,https://x.com/pluemonac/status/1969261289122746612,https://x.com/IndoPopBase/status/1969252499526684858,0
2025-09-20 04:10:35+00:00,xcyvpz,owh,0,0,0,128,https://x.com/xcyvpz/status/1969252824715284941,https://x.com/IndoPopBase/status/1969252499526684858,0
2025-09-20 06:11:36+00:00,sugar_6378,"Nah iya pak,
pernah aku waktu di jkt macet malem2, dibelakang nyalain lampu biru merah gitu silau. ",0,0,0,1127,https://x.com/sugar_6378/status/1969283280911446178,https://x.com/IndoPopBase/status/1969252499526684858,0
2025-09-20 15:01:02+00:00,k0py0,"Kita liat aja, sampe ke daerah gak ini",0,0,0,334,https://x.com/k0py0/status/1969416517340250259,https://x.com/IndoPopBase/status/1969252499526684858,0
2025-09-20 09:16:48+00:00,michh_eth,NINUNINUNINUNINUUUUUUUUU!!!,0,0,0,425,https://x.com/michh_eth/status/1969329886721351893,https://x.com/IndoPopBase/status/1969252499526684858,0
2025-09-20 07:40:54+00:00,arganheimer,"rangorang udh pada gada yg suka sama itu. Yang masi sungkem sama gituan cuma driver kendaraan ""mending lu yg mati drpd gw""",0,0,0,48,https://x.com/arganheimer/status/1969305756399751630,https://x.com/IndoPopBase/status/1969252499526684858,0
2025-09-20 06:41:41+00:00,StupidJefferson,"Terpantau sepertinya tidak semua daerah. Di tangerang masih banyak tuh.
ada bbrp org lempar helm ke mobilnya sih jadi biar tau rasa kaca pecah",0,0,0,68,https://x.com/StupidJefferson/status/1969290851411964054,https://x.com/IndoPopBase/status/1969252499526684858,0
2025-09-21 03:40:51+00:00,slordegh,just TEMPORARY,0,0,0,5,https://x.com/slordegh/status/1969607730152554937,https://x.com/IndoPopBase/status/1969252499526684858,0
2025-09-21 03:11:51+00:00,RrangeRmeRrah,sisan toa tahu bulat tulung,0,1,0,8,https://x.com/RrangeRmeRrah/status/1969600433158287675,https://x.com/IndoPopBase/status/1969252499526684858,1
2025-09-20 05:38:21+00:00,natasha_saja,Why temporary?,0,0,0,97,https://x.com/natasha_saja/status/1969274915296592034,https://x.com/IndoPopBase/status/1969252499526684858,0
2025-09-20 10:27:46+00:00,2yuca3sadina,Tetot tetot doang yg di hentikan? Ngawal plat sipilnya tetep?,0,0,0,44,https://x.com/2yuca3sadina/status/1969347748789915662,https://x.com/IndoPopBase/status/1969252499526684858,0
2025-09-20 11:35:08+00:00,sevenpots,MAKE IT PERMANENT!,0,0,0,28,https://x.com/sevenpots/status/1969364702359929092,https://x.com/IndoPopBase/status/1969252499526684858,0
2025-09-20 04:20:29+00:00,batagwhore,selamanya aja anjg,0,0,0,139,https://x.com/batagwhore/status/1969255316387684798,https://x.com/IndoPopBase/status/1969252499526684858,0
2025-09-20 05:52:36+00:00,·,"oh cuma sementara doang, bsk juga bakal tot tot lagi ",0,0,0,106,https://x.com/riicydwaa/status/1969278499778159102,https://x.com/IndoPopBase/status/1969252499526684858,0
2025-09-20 16:11:52+00:00,belbelaaaaaaa,Emg annoying bgt apalagi ternyata yg di kawal plat putih fakkkk,0,0,0,30,https://x.com/belbelaaaaaaa/status/1969434344554185028,https://x.com/IndoPopBase/status/1969252499526684858,0
2025-09-20 23:59:31+00:00,_amolasfresas_,yah ada polkis yg nganggur,0,0,0,11,https://x.com/_amolasfresas_/status/1969552031552848189,https://x.com/IndoPopBase/status/1969252499526684858,0
2025-09-20 08:20:16+00:00,DeradPersian,"Sementara, dibekukan, ditunda.. dan kata sejenisnya sampai perhatian publik teralihkan kemudian dilanjutkan kembali.",1,0,0,427,https://x.com/DeradPersian/status/1969315661529637228,https://x.com/IndoPopBase/status/1969252499526684858,1
2025-09-20 05:42:59+00:00,g182z,"halah gitu aja terus, emg di konoha harus viral dan masif biar peka ",0,0,0,166,https://x.com/g182z/status/1969276080054845790,https://x.com/IndoPopBase/status/1969252499526684858,0
2025-09-20 08:33:45+00:00,revemil,"Make it forever, not temporary.",0,0,0,61,https://x.com/revemil/status/1969319056722350119,https://x.com/IndoPopBase/status/1969252499526684858,0
2025-09-20 04:32:25+00:00,sarlippies,lmaooo,0,0,0,101,https://x.com/sarlippies/status/1969258323133218954,https://x.com/IndoPopBase/status/1969252499526684858,0
2025-09-20 11:27:12+00:00,norcal_bandit,"The ban is temporary, but the anger is forever #1312",0,0,0,19,https://x.com/norcal_bandit/status/1969362704910729649,https://x.com/IndoPopBase/status/1969252499526684858,0
2025-09-20 14:01:32+00:00,Kode_Bagus,"Temporary 
Biar pada seneng
Begitu lupa wot wot lg dehh",0,0,0,9,https://x.com/Kode_Bagus/status/1969401545700884586,https://x.com/IndoPopBase/status/1969252499526684858,0
2025-09-20 05:14:54+00:00,Kemenirr,"sampe masih ada yang tot tot ngentot, gw timpuk pake batu",0,0,0,597,https://x.com/Kemenirr/status/1969269013223010685,https://x.com/IndoPopBase/status/1969252499526684858,0
2025-09-20 08:21:02+00:00,bayuwicak14,"(((Temporary))) 

Ya harusnya permanen lah",0,0,0,135,https://x.com/bayuwicak14/status/1969315854635483356,https://x.com/IndoPopBase/status/1969252499526684858,0
2025-09-20 05:09:03+00:00,baber168,"temporary doang, permanent bisa gak?",0,0,0,161,https://x.com/baber168/status/1969267542154772680,https://x.com/IndoPopBase/status/1969252499526684858,0
2025-09-20 04:46:20+00:00,springtree_jk,Keyword: temporary wkwkw,0,0,0,117,https://x.com/springtree_jk/status/1969261823070228538,https://x.com/IndoPopBase/status/1969252499526684858,0
2025-09-20 05:58:57+00:00,Timenew45,Halahh bacot anjg. Polri dipercaya? Mustahil,0,0,0,107,https://x.com/Timenew45/status/1969280099930271836,https://x.com/IndoPopBase/status/1969252499526684858,0
2025-09-20 06:41:18+00:00,peachsunhoney,Dibikin permanen aja plis sama itu lampu yg terang bgt juga ditilang apa gmn ganggu bgt,0,0,0,109,https://x.com/peachsunhoney/status/1969290755987456319,https://x.com/IndoPopBase/status/1969252499526684858,0
2025-09-20 07:21:38+00:00,eddoarddot,Strobes adalah teroris sebenarnya,0,0,0,175,https://x.com/eddoarddot/status/1969300906446397618,https://x.com/IndoPopBase/status/1969252499526684858,0
2025-09-20 10:55:06+00:00,lemon_taa,"Temporary? 
Permanent dong",0,0,0,11,https://x.com/lemon_taa/status/1969354627146465474,https://x.com/IndoPopBase/status/1969252499526684858,0
2025-09-20 22:20:45+00:00,iris_4evermore,"Kata gw kalo ada polisi begini terus ngawal yg ngga darurat tegur aja ditempat. Pejabat publik ngga punya hak istimewa apa2 di jalan. Mereka dibayar pake pajak kita, bahkan ada dari mereka yang ngga bayar pajak. Ngga perlu ngasih jalan dulu, kalo maksa maki aja ditempat",0,0,0,51,https://x.com/iris_4evermore/status/1969527176925233209,https://x.com/IndoPopBase/status/1969252499526684858,0
2025-09-20 05:23:47+00:00,svnwcloudie,temporaryyy??????????? yg bener ajeee. permanen lah anjai. tot tot wut wut lu gausah dibunyiin kl ga urgent bgtt cukimay,0,0,0,239,https://x.com/svnwcloudie/status/1969271249181262193,https://x.com/IndoPopBase/status/1969252499526684858,0
2025-09-20 04:16:31+00:00,ScarySony,"Kok temporary?

Permanen lah! Kaya penting aja",0,0,0,530,https://x.com/ScarySony/status/1969254320165068903,https://x.com/IndoPopBase/status/1969252499526684858,0
2025-09-20 04:16:22+00:00,Angelina_S_S,They better make it permanent real soon,0,0,0,306,https://x.com/Angelina_S_S/status/1969254284123410637,https://x.com/IndoPopBase/status/1969252499526684858,0
2025-09-20 15:51:26+00:00,Fajar_ABhi,"Setuju, Agar pejabat segera naik angkutan umum, kalau mau cepat naik dari awal",0,0,0,9,https://x.com/Fajar_ABhi/status/1969429203037635001,https://x.com/IndoPopBase/status/1969252499526684858,0
2025-09-20 05:04:25+00:00,orangeybee,we want it permanent!!!!,0,0,0,100,https://x.com/orangeybee/status/1969266372724097304,https://x.com/IndoPopBase/status/1969252499526684858,0
2025-09-20 07:32:41+00:00,strawbaekiii,kok cuma temporary?? permanent dong,0,0,0,100,https://x.com/strawbaekiii/status/1969303685617287225,https://x.com/IndoPopBase/status/1969252499526684858,0
2025-09-20 04:59:01+00:00,The_RedsIndo,jir kirain map gta v,0,0,0,2405,https://x.com/The_RedsIndo/status/1969265017410265500,https://x.com/IndoPopBase/status/1969247674445517148,0
2025-09-20 04:08:55+00:00,SaddamWeb3,"dgr2 di IKN 2028 tiang listrik bs ngasih rute & mobil terbang
real ga nih?",0,0,0,405,https://x.com/SaddamWeb3/status/1969252408464142669,https://x.com/IndoPopBase/status/1969247674445517148,0
2025-09-20 04:08:01+00:00,0xHarryry,setelah itu apaa?,0,0,0,272,https://x.com/0xHarryry/status/1969252178947707136,https://x.com/IndoPopBase/status/1969247674445517148,0
2025-09-20 03:52:55+00:00,Rumahdepok_,Lebih jelas kualitas youtube 144p daripada proyek IKN,1,0,0,2134,https://x.com/Rumahdepok_/status/1969248381684924765,https://x.com/IndoPopBase/status/1969247674445517148,1
2025-09-20 04:05:03+00:00,Flashdllah,oh great! another lies has been announced!,0,0,0,1530,https://x.com/Flashdllah/status/1969251432952918221,https://x.com/IndoPopBase/status/1969247674445517148,0
2025-09-20 04:29:34+00:00,bareda,"Ibu Kota Negara tetep di Jakarta, IKN ganti aja jadi Bapak Kota Negara.",2,0,0,2013,https://x.com/bareda/status/1969257603713597925,https://x.com/IndoPopBase/status/1969247674445517148,2
2025-09-20 07:27:09+00:00,caleviar,"Wkwk, mundur lagi. Besok pas tahun 2028, mundur jadi 2030, gitu aja terus sampe Prabowo punya anak lagi",0,0,0,530,https://x.com/caleviar/status/1969302295113339235,https://x.com/IndoPopBase/status/1969247674445517148,0
2025-09-20 06:43:53+00:00,Pawangmagang,2028:,0,0,0,991,https://x.com/Pawangmagang/status/1969291407383842932,https://x.com/IndoPopBase/status/1969247674445517148,0
2025-09-20 03:58:33+00:00,fransrich1,"yup, sebagaimana sudah diprediksi sebelumnya, IKN bakal jadi pusat kantor pemerintahan dan Jakarta akan jadi pusat perekonomian. 

not bad, tapi sangat disayangkan karena momentumnya tidak diawali dengan studi dan diskusi yang meluas.",1,0,0,1953,https://x.com/fransrich1/status/1969249797572878700,https://x.com/IndoPopBase/status/1969247674445517148,1
2025-09-20 03:53:57+00:00,sourbutterbeans,jadiin las vegas aja,0,0,0,880,https://x.com/sourbutterbeans/status/1969248642860019742,https://x.com/IndoPopBase/status/1969247674445517148,0
2025-09-20 04:04:14+00:00,pelurukuhabis,"IKN makin jelas arahnya dari green capital jadi elit capital. hanya kalangan elit yang mampu tinggal, sementara masyarakat lokal dan kelas menengah tersisih.",0,0,0,1027,https://x.com/pelurukuhabis/status/1969251227708907536,https://x.com/IndoPopBase/status/1969247674445517148,0
2025-09-20 05:23:11+00:00,containsclouds,Ended flopkarta,0,0,0,358,https://x.com/containsclouds/status/1969271096110203150,https://x.com/IndoPopBase/status/1969247674445517148,0
2025-09-20 04:00:07+00:00,·,Insert video ratusan investor asing antri,0,0,0,1412,https://x.com/tidursaja/status/1969250193506734347,https://x.com/IndoPopBase/status/1969247674445517148,0
2025-09-20 10:48:40+00:00,jengglongan,Apaan sih ga jelas gblok,0,0,0,149,https://x.com/jengglongan/status/1969353009265066012,https://x.com/IndoPopBase/status/1969247674445517148,0
2025-09-20 04:42:09+00:00,dontolicious_,Ibu Khia Nusantara,0,0,0,272,https://x.com/dontolicious_/status/1969260770522272046,https://x.com/IndoPopBase/status/1969247674445517148,0
2025-09-20 03:58:38+00:00,nezdaily,"All these damage, they should make it worth it",0,0,0,675,https://x.com/nezdaily/status/1969249818565300527,https://x.com/IndoPopBase/status/1969247674445517148,0
2025-09-20 04:52:36+00:00,craftzhka,plot twistnya nnt Gibran jadi presiden,0,0,0,369,https://x.com/craftzhka/status/1969263398627017136,https://x.com/IndoPopBase/status/1969247674445517148,0
2025-09-20 05:46:46+00:00,ferizast,"buruan, dah buang buang uang dahal",0,0,0,557,https://x.com/ferizast/status/1969277033147449526,https://x.com/IndoPopBase/status/1969247674445517148,0
2025-09-20 07:51:51+00:00,eddoarddot,Keren,0,0,0,226,https://x.com/eddoarddot/status/1969308511675744485,https://x.com/IndoPopBase/status/1969247674445517148,0
2025-09-20 06:37:32+00:00,tuleighte,Girl whatever,0,0,0,234,https://x.com/tuleighte/status/1969289806480855338,https://x.com/IndoPopBase/status/1969247674445517148,0
2025-09-20 04:01:02+00:00,xxxaryadi,Make it happen,0,0,0,390,https://x.com/xxxaryadi/status/1969250421358161999,https://x.com/IndoPopBase/status/1969247674445517148,0
2025-09-20 06:13:57+00:00,sugar_6378,Ini nih bentukannya aku nemu do yutub.,0,0,0,588,https://x.com/sugar_6378/status/1969283872740323752,https://x.com/IndoPopBase/status/1969247674445517148,0
2025-09-20 12:13:26+00:00,AuslanderDon,Info berita? Info regulasi?,0,0,0,142,https://x.com/AuslanderDon/status/1969374341931680135,https://x.com/IndoPopBase/status/1969247674445517148,0
2025-09-20 16:22:24+00:00,invevt,"Kenapa sih indo kalo buat kota pasti potongan tanahnya gak rapih? Jd kalo diliat dr atas bentukannya gak indah anjr, rudet apa krna medan tanahnya yg ga rata atau gmn?",0,0,0,231,https://x.com/invevt/status/1969436992401523003,https://x.com/IndoPopBase/status/1969247674445517148,0
2025-09-20 13:07:35+00:00,kenjuwuw,Gua kira mangkrak beneran,0,0,0,131,https://x.com/kenjuwuw/status/1969387967195333013,https://x.com/IndoPopBase/status/1969247674445517148,0
2025-09-20 04:09:17+00:00,rorippe,IKNugu,0,0,0,530,https://x.com/rorippe/status/1969252497559593312,https://x.com/IndoPopBase/status/1969247674445517148,0
2025-09-20 04:04:25+00:00,kantiskanting,Maksudnya jadi kaya Putrajaya gitu?,0,0,0,937,https://x.com/kantiskanting/status/1969251275574280670,https://x.com/IndoPopBase/status/1969247674445517148,0
2025-09-20 03:55:12+00:00,JavaJimmyMaukar,,0,0,0,430,https://x.com/JavaJimmyMaukar/status/1969248957311160409,https://x.com/IndoPopBase/status/1969247674445517148,0
2025-09-20 05:25:55+00:00,comingsun_,"katanya lc lc pada pindah ke IKN, itu valid gk?",0,0,0,358,https://x.com/comingsun_/status/1969271784445755533,https://x.com/IndoPopBase/status/1969247674445517148,0
2025-09-20 09:17:33+00:00,michh_eth,GILA KEREN JG. Kaya diluar negeri ga tuh kira2?,1,0,0,115,https://x.com/michh_eth/status/1969330077058965560,https://x.com/IndoPopBase/status/1969247674445517148,1
2025-09-20 05:28:22+00:00,gudpuzzi,Notice how its always before pemilu?,0,0,0,117,https://x.com/gudpuzzi/status/1969272401364979809,https://x.com/IndoPopBase/status/1969247674445517148,0
2025-09-20 04:23:27+00:00,tigerisliv,PUBG map ,0,0,0,165,https://x.com/tigerisliv/status/1969256065532403800,https://x.com/IndoPopBase/status/1969247674445517148,0
2025-09-22 01:47:31+00:00,Th3Tr4vel3r,setuju jadikan saja IKN sebagi Ibu Kota Politik,0,0,0,27,https://x.com/Th3Tr4vel3r/status/1969941597367439706,https://x.com/IndoPopBase/status/1969247674445517148,0
2025-09-20 03:53:36+00:00,SaddamWeb3,,1,1,0,1144,https://x.com/SaddamWeb3/status/1969248550719541356,https://x.com/IndoPopBase/status/1969246428221382976,2
2025-09-20 03:55:29+00:00,akbacrypto,,1,0,0,822,https://x.com/akbacrypto/status/1969249027318292823,https://x.com/IndoPopBase/status/1969246428221382976,1
2025-09-20 03:50:14+00:00,TempeXBT,"Asli Presiden yang sesudah masa jabatannya tidak lagi cawe"" secara langsung soal politik di Indonesia.. 2 periode pula ",0,0,0,758,https://x.com/TempeXBT/status/1969247707140116906,https://x.com/IndoPopBase/status/1969246428221382976,0
2025-09-20 04:13:26+00:00,ndroe_,pak sby menang telak,1,1,0,471,https://x.com/ndroe_/status/1969253544889827610,https://x.com/IndoPopBase/status/1969246428221382976,2
2025-09-20 11:19:26+00:00,guttebening,"2004 adalah pesta pemilu paling epik dan sesuai dgn konsep demokrasi, i mean kita pure bersenang2 gada konflik buzzer dll gada curang apapun meskipun calonnya dominan tni dan ga nabrak aturan apapun. paslonnya jg banyak bgt jd kita bisa bebas milih. ahh miss good old days",0,0,0,141,https://x.com/guttebening/status/1969360749249380776,https://x.com/IndoPopBase/status/1969246428221382976,0
2025-09-20 03:49:49+00:00,Twittysweetie_,Belum punya hak pilih coyyyy....,0,0,0,636,https://x.com/Twittysweetie_/status/1969247601808613724,https://x.com/IndoPopBase/status/1969246428221382976,0
2025-09-20 04:07:01+00:00,michh_eth,WKWKWKWJWKWWKWKKW,0,0,0,444,https://x.com/michh_eth/status/1969251927553671654,https://x.com/IndoPopBase/status/1969246428221382976,0
2025-09-20 03:48:17+00:00,pyonnsuke000320,It's been a long time since the last time our political ecosystem was relatively sane back then,0,0,0,334,https://x.com/pyonnsuke000320/status/1969247213814526193,https://x.com/IndoPopBase/status/1969246428221382976,0
2025-09-20 04:23:49+00:00,abittermeringue,"2004 umurku 6 tahun, baru masuk sd

Bapakku cerita, waktu itu lagi jalan2 ke pasar, ada spanduk KPU yang ada gambar semua capres, pak wiranto no urut 1. 

Dengan polosnya aku bertanya ‘kenapa kita harus pilih presiden lagi? Kan itu udah ada bapak Wiranto yang jadi nomor satu’ ",0,0,0,321,https://x.com/abittermeringue/status/1969256157991542945,https://x.com/IndoPopBase/status/1969246428221382976,0
2025-09-20 03:56:10+00:00,pelurukuhabis,21 tahun demokrasi… masih ada tapi makin sering digeret ke arah kepentingan elit. Kita? tetap cuma jadi penonton setia.,0,0,0,739,https://x.com/pelurukuhabis/status/1969249198026432572,https://x.com/IndoPopBase/status/1969246428221382976,0
2025-09-21 16:04:30+00:00,andersowen75550,"@fabian21e8
 die Zahl omg",0,0,0,39,https://x.com/andersowen75550/status/1969794878075809842,https://x.com/IndoPopBase/status/1969246428221382976,0
2025-09-20 05:55:15+00:00,_serang_banten_,baru lahir ,0,0,0,53,https://x.com/_serang_banten_/status/1969279168182464621,https://x.com/IndoPopBase/status/1969246428221382976,0
2025-09-20 04:01:25+00:00,yhoxcendolz,"Foto yang bernada "" Gimana ? Walau saya sudah tak jadi Presiden , tapi saya masih suka nimbrung di pemerintahan""",0,0,0,295,https://x.com/yhoxcendolz/status/1969250521119588507,https://x.com/IndoPopBase/status/1969246428221382976,0
2025-09-20 04:57:33+00:00,gddxnzjscj,And its not sacred wednesday.,0,0,0,176,https://x.com/gddxnzjscj/status/1969264646243721470,https://x.com/IndoPopBase/status/1969246428221382976,0
2025-09-20 12:46:20+00:00,setanidol,Just two chop ho,0,0,0,42,https://x.com/setanidol/status/1969382619415707844,https://x.com/IndoPopBase/status/1969246428221382976,0
2025-09-20 04:35:53+00:00,klassicsys,Orang dewasa yang punya hak suara saat itu masih banyak yg waras dan bertanggungjawab,0,0,0,219,https://x.com/klassicsys/status/1969259192469918138,https://x.com/IndoPopBase/status/1969246428221382976,0
2025-09-20 05:53:52+00:00,Jumadil62948032,Started Mega - SBY beefing,0,0,0,23,https://x.com/Jumadil62948032/status/1969278818461397426,https://x.com/IndoPopBase/status/1969246428221382976,0
2025-09-20 03:52:59+00:00,·,Waktu dollar masih 8ribu ,0,0,0,243,https://x.com/X_BLlSS/status/1969248395807129852,https://x.com/IndoPopBase/status/1969246428221382976,0
2025-09-20 03:58:00+00:00,Kryptonomanos,"Tidak terasa sudah 21 tahun berlalu, habis ini tidak berasa juga …",0,0,0,423,https://x.com/Kryptonomanos/status/1969249659852836889,https://x.com/IndoPopBase/status/1969246428221382976,0
2025-09-22 01:47:53+00:00,Th3Tr4vel3r,sehat selalu untuk ke-2 nya,0,0,0,31,https://x.com/Th3Tr4vel3r/status/1969941691386970376,https://x.com/IndoPopBase/status/1969246428221382976,0
2025-09-20 03:52:47+00:00,pelurukuhabis,"Nggak kerasa 8 tahun berlalu tp lirik Feast soal bumi dieksploitasi masih relevan. Alam terus diperas, kapitalisme makin jadi, n kita cuma duduk jadi penonton krisis.",2,10,0,7685,https://x.com/pelurukuhabis/status/1969248348050768236,https://x.com/IndoPopBase/status/1969237331241521409,12
2025-09-20 04:46:57+00:00,mustbobb,album identitas selamat/sukses™,0,1,0,2992,https://x.com/mustbobb/status/1969261977466810814,https://x.com/IndoPopBase/status/1969237331241521409,1
2025-09-20 07:20:37+00:00,·,Dan ada satu lagu yg udh ga pernah naik di panggung karena pandangan si bas yg berubah ttg konflik di gaza,1,4,0,5399,https://x.com/itszwnkl/status/1969300648396030017,https://x.com/IndoPopBase/status/1969237331241521409,5
2025-09-20 17:29:46+00:00,menjadiJoyBoy,hadir,1,0,0,1505,https://x.com/menjadiJoyBoy/status/1969453947208548566,https://x.com/IndoPopBase/status/1969237331241521409,1
2025-09-20 09:30:49+00:00,Bmgstwn,Dari perjalanannya yg bego cuman bodat wkwkwk,1,2,0,1561,https://x.com/Bmgstwn/status/1969333416102412446,https://x.com/IndoPopBase/status/1969237331241521409,3
2025-09-20 05:09:28+00:00,tubruktanpagula,"one of the best album i’ve listened to, and still related to current situation in this god damn nation",0,1,0,2179,https://x.com/tubruktanpagula/status/1969267645200396790,https://x.com/IndoPopBase/status/1969237331241521409,1
2025-09-20 04:48:37+00:00,brayvaldi,Jadi keinget discovering album ini dari live .Feast perform Sectumsempra di bukalapak tahun 2018,1,1,0,9170,https://x.com/brayvaldi/status/1969262397895418184,https://x.com/IndoPopBase/status/1969237331241521409,2
2025-09-20 06:15:49+00:00,sugar_6378,"Eh wow, aku taunya kelelawar doang, dah 8tahun lalu tp gak tau judul albumnya ",0,1,0,5389,https://x.com/sugar_6378/status/1969284344574300664,https://x.com/IndoPopBase/status/1969237331241521409,1
2025-09-20 11:45:35+00:00,nandaiqbal11,"Salah satu album cover terkeren bagi gw, sampe ngulik style fotonya mikealdo",0,0,0,1116,https://x.com/nandaiqbal11/status/1969367330481455214,https://x.com/IndoPopBase/status/1969237331241521409,0
2025-09-20 03:24:40+00:00,velvetthorns_,peak .Feast album,0,1,0,1287,https://x.com/velvetthorns_/status/1969241270561181712,https://x.com/IndoPopBase/status/1969237331241521409,1
2025-09-20 09:46:42+00:00,OynRetriever,Kelelawar and Sectumsempra will always be my favorites,0,0,0,459,https://x.com/OynRetriever/status/1969337413278249211,https://x.com/IndoPopBase/status/1969237331241521409,0
2025-09-20 05:53:30+00:00,Ekokucayy,Yng dlu ikutan ngatain feast peradaban trus skrng pda dngerin lagunya ada?,10,1,0,4889,https://x.com/Ekokucayy/status/1969278725628825613,https://x.com/IndoPopBase/status/1969237331241521409,11
2025-09-20 08:00:29+00:00,good_day_freze,Emang ada ya yang dengerin??,6,0,0,2850,https://x.com/good_day_freze/status/1969310683784262089,https://x.com/IndoPopBase/status/1969237331241521409,6
2025-09-20 08:11:25+00:00,dupreeehhh,jerusalem still the goat,0,0,0,22,https://x.com/dupreeehhh/status/1969313435411169717,https://x.com/IndoPopBase/status/1969237331241521409,0
2025-09-21 10:10:29+00:00,fahmiau,Punya parfum gantung bentukannya Safira aka the mother,0,1,0,171,https://x.com/fahmiau/status/1969705784339816780,https://x.com/IndoPopBase/status/1969237331241521409,1
2025-09-20 16:07:02+00:00,kotycecan,sectumsempra my fav omggg,0,0,0,289,https://x.com/kotycecan/status/1969433127534936350,https://x.com/IndoPopBase/status/1969237331241521409,0
2025-09-20 05:29:47+00:00,Pi_to524,album bagus setelah m&m,0,0,0,456,https://x.com/Pi_to524/status/1969272756043727324,https://x.com/IndoPopBase/status/1969237331241521409,0
2025-09-20 08:06:20+00:00,sushiportal,best.,1,0,0,361,https://x.com/sushiportal/status/1969312157113237645,https://x.com/IndoPopBase/status/1969237331241521409,1
2025-09-20 19:53:13+00:00,Arilay_x,"Album galak nih, pendengarnya brengos2",0,0,0,356,https://x.com/Arilay_x/status/1969490048551960608,https://x.com/IndoPopBase/status/1969237331241521409,0
2025-09-21 16:53:18+00:00,badzozo_,"1 paket rilisan fisiknya. Booklet, cd, parfum gantung, stiker. Dapet moshing beberapa kali di teko.",0,0,0,154,https://x.com/badzozo_/status/1969807158931026073,https://x.com/IndoPopBase/status/1969237331241521409,0
2025-09-21 23:52:03+00:00,iceberrygvrl,Sectumsempra jagoanku di album ini ,0,0,0,31,https://x.com/iceberrygvrl/status/1969912539627803027,https://x.com/IndoPopBase/status/1969237331241521409,0
2025-09-21 00:39:09+00:00,haitaniy,goat,0,0,0,125,https://x.com/haitaniy/status/1969562004810842302,https://x.com/IndoPopBase/status/1969237331241521409,0
2025-09-21 00:00:00+00:00,deemaskitink,"Bisa kali press vinylnya nih 
@listentofeast",0,0,0,145,https://x.com/deemaskitink/status/1969552154706002343,https://x.com/IndoPopBase/status/1969237331241521409,0
2025-09-20 07:38:23+00:00,gruisthenames,"fastest man alive lagu terbagus di album inih, nobody can't change my mind ",1,0,0,1898,https://x.com/gruisthenames/status/1969305122078437403,https://x.com/IndoPopBase/status/1969237331241521409,1
2025-09-20 05:36:55+00:00,qrorun,Wow,0,0,0,396,https://x.com/qrorun/status/1969274554007658642,https://x.com/IndoPopBase/status/1969237331241521409,0
2025-09-20 18:16:16+00:00,ferizast,i-Pop is so cultured like... why it has a lot of good photograph ,0,0,0,341,https://x.com/ferizast/status/1969465649803247822,https://x.com/IndoPopBase/status/1969237331241521409,0
2025-09-20 20:15:16+00:00,RanggaEkaSakti1,Still their best i guess,0,0,0,204,https://x.com/RanggaEkaSakti1/status/1969495597247054260,https://x.com/IndoPopBase/status/1969237331241521409,0
2025-09-20 10:19:53+00:00,wannabehappyboy,riphunter jagoan saya,0,0,0,226,https://x.com/wannabehappyboy/status/1969345762728329263,https://x.com/IndoPopBase/status/1969237331241521409,0
2025-09-20 04:59:15+00:00,fixrevpsd,cikal bakal karangan bunga mpos,0,0,0,852,https://x.com/fixrevpsd/status/1969265073513275497,https://x.com/IndoPopBase/status/1969237331241521409,0
2025-09-20 06:41:50+00:00,shoegaz3e,lagu urat nadiku seribu nyawa,0,0,0,165,https://x.com/shoegaz3e/status/1969290889966043152,https://x.com/IndoPopBase/status/1969237331241521409,0
2025-09-20 04:20:02+00:00,yodashams,Track no 7 masih terbaik,0,0,0,940,https://x.com/yodashams/status/1969255206018756950,https://x.com/IndoPopBase/status/1969237331241521409,0
2025-09-21 03:07:02+00:00,ld_subway,tel aviv featuring bin idris,0,0,0,298,https://x.com/ld_subway/status/1969599221100921255,https://x.com/IndoPopBase/status/1969237331241521409,0
2025-09-20 10:07:32+00:00,Twt_dr_je,"Pernah punya rilisan fisiknya karena ingin bantu teman. Sering diputar di mobil karena keterbatasan Mp3 Player. 

Berujung hilang karena lupa dieject pas jual mobil dulu hehe.",0,0,0,1601,https://x.com/Twt_dr_je/status/1969342656737079632,https://x.com/IndoPopBase/status/1969237331241521409,0
2025-09-20 14:26:06+00:00,khongpopp,Gerbang pembuka,0,0,0,151,https://x.com/khongpopp/status/1969407726246903995,https://x.com/IndoPopBase/status/1969237331241521409,0
2025-09-20 06:20:07+00:00,caypai,kelelawarrrr ,0,0,0,272,https://x.com/caypai/status/1969285426776064161,https://x.com/IndoPopBase/status/1969237331241521409,0
2025-09-20 12:44:15+00:00,_Davmoreee,wowowoww,0,0,0,154,https://x.com/_Davmoreee/status/1969382093462651300,https://x.com/IndoPopBase/status/1969237331241521409,0
2025-09-21 00:58:58+00:00,bawahproyekmusi,bakar styrofoam gak bae untuk lingkungan dan kesehatan ,0,0,0,444,https://x.com/bawahproyekmusi/status/1969566992421306731,https://x.com/IndoPopBase/status/1969237331241521409,0
2025-09-20 12:30:30+00:00,tootheel,peak feast,0,0,0,278,https://x.com/tootheel/status/1969378635732947094,https://x.com/IndoPopBase/status/1969237331241521409,0
2025-09-21 09:36:56+00:00,decafeinate,gaggy,0,0,0,56,https://x.com/decafeinate/status/1969697341713403989,https://x.com/IndoPopBase/status/1969237331241521409,0
2025-09-20 08:00:13+00:00,wiztrippiee,spesial show setlist ini bakal ada kaga yee,0,0,0,548,https://x.com/wiztrippiee/status/1969310616029368828,https://x.com/IndoPopBase/status/1969237331241521409,0
2025-09-21 02:59:58+00:00,arhfelix_,banger album,0,0,0,95,https://x.com/arhfelix_/status/1969597442053325131,https://x.com/IndoPopBase/status/1969237331241521409,0
2025-09-20 04:23:37+00:00,berkalam_,kangen feast multiverse ini,0,0,0,659,https://x.com/berkalam_/status/1969256107261501549,https://x.com/IndoPopBase/status/1969237331241521409,0
2025-09-20 06:43:02+00:00,kucingpiknik,Jujurly cover albumnya keren,0,0,0,707,https://x.com/kucingpiknik/status/1969291193361015205,https://x.com/IndoPopBase/status/1969237331241521409,0
2025-09-21 02:07:24+00:00,Bluegraps,Fastest man alive is a banger,0,0,0,357,https://x.com/Bluegraps/status/1969584216238407995,https://x.com/IndoPopBase/status/1969237331241521409,0
2025-09-20 11:15:06+00:00,mishimakazuyaaa,Sectumsempra ,0,0,0,172,https://x.com/mishimakazuyaaa/status/1969359660772966678,https://x.com/IndoPopBase/status/1969237331241521409,0
2025-09-20 05:52:18+00:00,dedechaws,The weirdest album,0,0,0,390,https://x.com/dedechaws/status/1969278423613751442,https://x.com/IndoPopBase/status/1969237331241521409,0
2025-09-21 12:15:37+00:00,palingbercanda,Awal mula kenal lagu feast lewat Sectumsempra,0,0,0,117,https://x.com/palingbercanda/status/1969737276617093512,https://x.com/IndoPopBase/status/1969237331241521409,0
2025-09-22 00:49:22+00:00,wingsofsadness_,"track “wives of gojira” adalah jatuh cinta pertama, album terbaik pada masanya",0,0,0,77,https://x.com/wingsofsadness_/status/1969926964971745415,https://x.com/IndoPopBase/status/1969237331241521409,0
2025-09-21 17:11:08+00:00,danieonn,"waktu diliatin artworknya sm mantan, gw langsung mindblown bgt, ide kyk gni mahal bgt asli...",0,0,0,88,https://x.com/danieonn/status/1969811647809331587,https://x.com/IndoPopBase/status/1969237331241521409,0
2025-09-20 22:21:42+00:00,·,good old days,0,0,0,180,https://x.com/legarasi_/status/1969527416562573496,https://x.com/IndoPopBase/status/1969237331241521409,0
2025-09-20 18:59:49+00:00,VirgilsQuill,"I am Harambe the White. And I come back to you now, at the turn of the tide",11,53,0,54867,https://x.com/VirgilsQuill/status/1969476611570336042,https://x.com/IndoPopBase/status/1969024637276131734,64
2025-09-19 13:17:24+00:00,alkaAdhitya,Alba >>>>>> Bahlil,24,128,0,35985,https://x.com/alkaAdhitya/status/1969028050965934288,https://x.com/IndoPopBase/status/1969024637276131734,152
2025-09-20 17:52:07+00:00,exo_thoth,How do the other orangutans act around it and does it display enhanced intelligence,8,20,0,32628,https://x.com/exo_thoth/status/1969459572139032784,https://x.com/IndoPopBase/status/1969024637276131734,28
2025-09-21 05:02:04+00:00,WomenPostingLs,Oh my Hitler…,0,2,0,9541,https://x.com/WomenPostingLs/status/1969628168882463181,https://x.com/IndoPopBase/status/1969024637276131734,2
2025-09-21 07:44:36+00:00,Machine_Civ,Very high IQ individual,2,0,0,10487,https://x.com/Machine_Civ/status/1969669074419437808,https://x.com/IndoPopBase/status/1969024637276131734,2
2025-09-19 13:44:49+00:00,rrnebae,"kawal hutan kalimantan dan satwa disana guys jgn sampe dibabat habis semua sma ulah manusia serakah, karna satwa disana udh banyak bgtt yg terancam punah",3,32,0,21132,https://x.com/rrnebae/status/1969034950990082232,https://x.com/IndoPopBase/status/1969024637276131734,35
2025-09-19 13:09:01+00:00,SaddamWeb3,,3,5,0,45085,https://x.com/SaddamWeb3/status/1969025940614230247,https://x.com/IndoPopBase/status/1969024637276131734,8
2025-09-20 18:35:22+00:00,lurkerintec,,1,9,0,5992,https://x.com/lurkerintec/status/1969470456651497955,https://x.com/IndoPopBase/status/1969024637276131734,10
2025-09-20 18:49:22+00:00,Jakubzbanowany,HAIL ALBA,0,2,0,14010,https://x.com/Jakubzbanowany/status/1969473978793083196,https://x.com/IndoPopBase/status/1969024637276131734,2
2025-09-19 13:10:21+00:00,ursteulyNaveen,Truly one of nature’s rarest wonders  Alba is a reminder of how unique and fragile wildlife can be  Central Kalimantan is blessed to have her.,0,12,0,28769,https://x.com/ursteulyNaveen/status/1969026276997444026,https://x.com/IndoPopBase/status/1969024637276131734,12
2025-09-20 04:03:59+00:00,Agprst,,0,10,0,10356,https://x.com/Agprst/status/1969251165771546977,https://x.com/IndoPopBase/status/1969024637276131734,10
2025-09-21 05:13:17+00:00,Hewhothrowsthi2,,0,3,0,1228,https://x.com/Hewhothrowsthi2/status/1969630993381539923,https://x.com/IndoPopBase/status/1969024637276131734,3
2025-09-19 14:59:14+00:00,fake_blondes,,0,0,0,5631,https://x.com/fake_blondes/status/1969053675717902396,https://x.com/IndoPopBase/status/1969024637276131734,0
2025-09-20 11:41:28+00:00,huedaya,"My question was, what did other orang utan react when they met them? Do they still think they are accepted into the same tribe? or being isolated?",8,3,0,32020,https://x.com/huedaya/status/1969366295067181330,https://x.com/IndoPopBase/status/1969024637276131734,11
2025-09-19 13:54:15+00:00,tallycination,the way the alba outvisuals bahlul is hilarious,0,2,0,5075,https://x.com/tallycination/status/1969037324441800756,https://x.com/IndoPopBase/status/1969024637276131734,2
2025-09-21 19:44:36+00:00,AdrinFl70123517,,0,0,0,1051,https://x.com/AdrinFl70123517/status/1969850268540960954,https://x.com/IndoPopBase/status/1969024637276131734,0
2025-09-21 09:57:37+00:00,Bul98293659,,0,0,0,1108,https://x.com/Bul98293659/status/1969702550258532615,https://x.com/IndoPopBase/status/1969024637276131734,0
2025-09-20 22:13:36+00:00,B4n6_H4n5,"Populasi orang Utan semakin sedikit, dan sudah terancam punah... 
Akibat perusakan lingkungan tempat hidup mereka, yang berubah menjadi tambang dan kebun sawit...",0,10,0,9238,https://x.com/B4n6_H4n5/status/1969525375102566840,https://x.com/IndoPopBase/status/1969024637276131734,10
2025-09-20 19:16:44+00:00,ThumosRebirthed,Handsome,1,0,0,9794,https://x.com/ThumosRebirthed/status/1969480867480228116,https://x.com/IndoPopBase/status/1969024637276131734,1
2025-09-21 07:05:55+00:00,grasshper1,,1,0,0,1449,https://x.com/grasshper1/status/1969659339532116329,https://x.com/IndoPopBase/status/1969024637276131734,1
2025-09-20 15:32:55+00:00,groyperlicious,aryan beast,0,1,0,1078,https://x.com/groyperlicious/status/1969424541798531147,https://x.com/IndoPopBase/status/1969024637276131734,1
2025-09-20 02:18:59+00:00,penikmat_hujann,cakep juga orangutannya,0,0,0,18725,https://x.com/penikmat_hujann/status/1969224740180017453,https://x.com/IndoPopBase/status/1969024637276131734,0
2025-09-19 13:51:29+00:00,charlesxcxtheII,Alba showing of her eyes,0,1,0,3802,https://x.com/charlesxcxtheII/status/1969036625146744974,https://x.com/IndoPopBase/status/1969024637276131734,1
2025-09-21 05:35:20+00:00,doofthedead,"Well shit, looks like I got doxxed.",0,1,0,3266,https://x.com/doofthedead/status/1969636544592900596,https://x.com/IndoPopBase/status/1969024637276131734,1
2025-09-19 15:09:43+00:00,ko0cheng,"yg bandingin alba sm bahlil penghinaan parah sih, buat alba",0,0,0,2454,https://x.com/ko0cheng/status/1969056314778120641,https://x.com/IndoPopBase/status/1969024637276131734,0
2025-09-20 15:49:33+00:00,portella0,White boy summer,0,0,0,1036,https://x.com/portella0/status/1969428725549629769,https://x.com/IndoPopBase/status/1969024637276131734,0
2025-09-21 13:59:58+00:00,NCwhite_man,I bet this orangutan is more intelligent than the other sub orangutan races.,0,0,0,1986,https://x.com/NCwhite_man/status/1969763536306917833,https://x.com/IndoPopBase/status/1969024637276131734,0
2025-09-21 09:39:31+00:00,HagazagaH,We will never die out.,1,0,0,5030,https://x.com/HagazagaH/status/1969697993772126397,https://x.com/IndoPopBase/status/1969024637276131734,1
2025-09-21 09:49:15+00:00,hreidhmarr,"released into the wild, the primary concern is that Alba will be poached by humans. i do not understand why any human would feel the need to murder this creature due to its blue-eyes and fair complexion",5,1,0,3489,https://x.com/hreidhmarr/status/1969700444738929137,https://x.com/IndoPopBase/status/1969024637276131734,6
2025-09-20 05:25:29+00:00,TheDsqualified,Blud can't says nigga,1,1,0,1514,https://x.com/TheDsqualified/status/1969271674471108893,https://x.com/IndoPopBase/status/1969024637276131734,2
2025-09-21 02:37:52+00:00,flotrghode,2nd pic vibe :,0,0,0,1657,https://x.com/flotrghode/status/1969591882406572295,https://x.com/IndoPopBase/status/1969024637276131734,0
2025-09-20 22:33:24+00:00,FentWokeSSB,,0,0,0,275,https://x.com/FentWokeSSB/status/1969530358229004384,https://x.com/IndoPopBase/status/1969024637276131734,0
2025-09-20 19:07:03+00:00,rathisnew,And we hail him back,0,0,0,536,https://x.com/rathisnew/status/1969478431206240338,https://x.com/IndoPopBase/status/1969024637276131734,0
2025-09-20 03:28:55+00:00,baby12am,"YaAllah lindungi selalu Alba dan kawan² dan tempat tinggalnya, aamiin.",0,1,0,1812,https://x.com/baby12am/status/1969242340305846330,https://x.com/IndoPopBase/status/1969024637276131734,1
2025-09-20 12:03:37+00:00,syamisu9,"That monkey's facial shape is considered attractive too! look at this comparison from an AI Attractiveness Test

The monkey                           Bahlil Lahadalia
                                                  from an article",0,1,0,2251,https://x.com/syamisu9/status/1969371868445753650,https://x.com/IndoPopBase/status/1969024637276131734,1
2025-09-19 15:57:25+00:00,rahmimimi,"Fyi, the word “Alba” in Spanish means “white”. ",1,0,0,2134,https://x.com/rahmimimi/status/1969068319161372677,https://x.com/IndoPopBase/status/1969024637276131734,1
2025-09-20 13:42:05+00:00,HimenosAshtray,Whiteboys changing the game ,0,0,0,413,https://x.com/HimenosAshtray/status/1969396650813899124,https://x.com/IndoPopBase/status/1969024637276131734,0
2025-09-20 03:37:48+00:00,SVD_Revolver,I believe Yeti just some Albino Gorilla or primates now,0,0,0,1095,https://x.com/SVD_Revolver/status/1969244578441048416,https://x.com/IndoPopBase/status/1969024637276131734,0
2025-09-19 15:37:18+00:00,makutyre,He will open the gate to hyperborhea in our nation. ,0,0,0,539,https://x.com/makutyre/status/1969063256560906681,https://x.com/IndoPopBase/status/1969024637276131734,0
2025-09-21 14:18:49+00:00,YoungOneJosh1,He’s literally me.,0,0,0,3630,https://x.com/YoungOneJosh1/status/1969768282291863761,https://x.com/IndoPopBase/status/1969024637276131734,0
2025-09-21 07:54:36+00:00,FastestPayout,Bro has bluer eyes than me..,0,0,0,10979,https://x.com/FastestPayout/status/1969671588296737123,https://x.com/IndoPopBase/status/1969024637276131734,0
2025-09-20 04:07:52+00:00,michh_eth,"IH GEMOY BANGET !!! Kenapa namanya alba ? 
@grok",3,0,0,19910,https://x.com/michh_eth/status/1969252141282767301,https://x.com/IndoPopBase/status/1969024637276131734,3
2025-09-22 05:12:30+00:00,oiefbvoieboke,you can just tell by its hair color and blue eyes its way less likely to  be violent,0,0,0,122,https://x.com/oiefbvoieboke/status/1969993182751687153,https://x.com/IndoPopBase/status/1969024637276131734,0
2025-09-20 00:26:57+00:00,dindaakusumo,"May God always protect him from any destruction within the country, aameen yra ",0,1,0,1383,https://x.com/dindaakusumo/status/1969196548467650902,https://x.com/IndoPopBase/status/1969024637276131734,1
2025-09-20 17:27:52+00:00,fishard_,"@bronzeagemantis
 would he make good animool fren?",0,0,0,941,https://x.com/fishard_/status/1969453471238672720,https://x.com/IndoPopBase/status/1969024637276131734,0
2025-09-20 20:15:11+00:00,CyrusDeranged,But you didnt have to cuuuuutttt me off...,0,0,0,426,https://x.com/CyrusDeranged/status/1969495576157773940,https://x.com/IndoPopBase/status/1969024637276131734,0
2025-09-21 03:50:43+00:00,tohofuny,Me,0,0,0,238,https://x.com/tohofuny/status/1969610213545181531,https://x.com/IndoPopBase/status/1969024637276131734,0
2025-09-20 09:29:24+00:00,OkyYuzi,,0,0,0,290,https://x.com/OkyYuzi/status/1969333059993456643,https://x.com/IndoPopBase/status/1969024637276131734,0
2025-09-20 19:17:44+00:00,Riffwraith,good to know yakub is still out there working.,0,0,0,862,https://x.com/Riffwraith/status/1969481118106747001,https://x.com/IndoPopBase/status/1969024637276131734,0
2025-09-20 19:09:01+00:00,AJerked19768,Aryan monke,0,0,0,185,https://x.com/AJerked19768/status/1969478924926402843,https://x.com/IndoPopBase/status/1969024637276131734,0
2025-09-19 12:52:08+00:00,mrfadillah__,"Udah jelek, tolol, dongo, pemabok, item pula si lintah laut ini.",9,184,0,21143,https://x.com/mrfadillah__/status/1969021689301246148,https://x.com/IndoPopBase/status/1969020268766236902,193
2025-09-19 12:58:51+00:00,leekssucker,"Dear indopopbase pls use trigger warning if you're gonna post bahlul & gibran, i'm assholephobic",1,34,0,11058,https://x.com/leekssucker/status/1969023379660247440,https://x.com/IndoPopBase/status/1969020268766236902,35
2025-09-19 12:53:40+00:00,kiokio878,Ini si Bahlil GOBLOK apa tolol? Phk terjadi karena kebijakan GOBLOK lu bangsat muka goblin,1,20,0,8338,https://x.com/kiokio878/status/1969022076808827369,https://x.com/IndoPopBase/status/1969020268766236902,21
2025-09-19 13:23:11+00:00,SanuBari_,,0,9,0,10224,https://x.com/SanuBari_/status/1969029504644657359,https://x.com/IndoPopBase/status/1969020268766236902,9
2025-09-19 12:59:25+00:00,coolgirlII,The 0.01% bacteria in hand sanitizer advertisement,2,14,0,8944,https://x.com/coolgirlII/status/1969023523722305938,https://x.com/IndoPopBase/status/1969020268766236902,16
2025-09-19 13:23:03+00:00,SaddamWeb3,"bahlil ini siapanya bahlul?
@grok",3,0,0,1057,https://x.com/SaddamWeb3/status/1969029473665450155,https://x.com/IndoPopBase/status/1969020268766236902,3
2025-09-20 05:07:44+00:00,0xpolynesia_,goblin,0,0,0,163,https://x.com/0xpolynesia_/status/1969267208128716845,https://x.com/IndoPopBase/status/1969020268766236902,0
2025-09-19 13:36:23+00:00,admiralkizaruuu,Tiap liat muka bapak ini,0,18,0,8806,https://x.com/admiralkizaruuu/status/1969032825849749762,https://x.com/IndoPopBase/status/1969020268766236902,18
2025-09-19 16:32:06+00:00,dhimasss_s,sumpah ini goblin kalau ngebacot enteng bgt anj,0,0,0,610,https://x.com/dhimasss_s/status/1969077048023962077,https://x.com/IndoPopBase/status/1969020268766236902,0
2025-09-19 13:59:30+00:00,diaumond,pengen tau ni orang ending hidupnya kayak apa,1,0,0,336,https://x.com/diaumond/status/1969038646532505919,https://x.com/IndoPopBase/status/1969020268766236902,1
2025-09-19 13:48:17+00:00,writebysteph,"Bisa gak, gak usah pake fotonya ",1,0,0,154,https://x.com/writebysteph/status/1969035821056753993,https://x.com/IndoPopBase/status/1969020268766236902,1
2025-09-19 13:51:54+00:00,kornetgakenak,pengen ngeludahin mulu bawaan kalo liat tampang lu lil,0,0,0,1157,https://x.com/kornetgakenak/status/1969036733732831290,https://x.com/IndoPopBase/status/1969020268766236902,0
2025-09-19 12:47:56+00:00,·,apaansi lo bahlil jelek,0,0,0,780,https://x.com/helfut/status/1969020635079712992,https://x.com/IndoPopBase/status/1969020268766236902,0
2025-09-19 13:53:25+00:00,hpypatia,Ho can you stop be a manchild ?,0,0,0,59,https://x.com/hpypatia/status/1969037112197435408,https://x.com/IndoPopBase/status/1969020268766236902,0
2025-09-19 13:51:22+00:00,2highfordrugs,gila gila ngatur,0,0,0,229,https://x.com/2highfordrugs/status/1969036596834898311,https://x.com/IndoPopBase/status/1969020268766236902,0
2025-09-20 11:49:48+00:00,rafnotsimons,kowe ki dungu,0,0,0,32,https://x.com/rafnotsimons/status/1969368393280340023,https://x.com/IndoPopBase/status/1969020268766236902,0
2025-09-19 16:11:52+00:00,mclarrensz,"eh mending elu aja ga sih yang di phk? udah jelas abis itu semua pihak akan damai. sumber masalahnya kan elu, goblin.",0,0,0,175,https://x.com/mclarrensz/status/1969071957376204945,https://x.com/IndoPopBase/status/1969020268766236902,0
2025-09-19 13:53:46+00:00,brayenXeyen,Please put a TW next time whenever you include his face in your tweet,0,0,0,368,https://x.com/brayenXeyen/status/1969037200147816499,https://x.com/IndoPopBase/status/1969020268766236902,0
2025-09-19 12:51:59+00:00,ambivertgirlcns,this guy ugh najis,0,0,0,183,https://x.com/ambivertgirlcns/status/1969021654069104980,https://x.com/IndoPopBase/status/1969020268766236902,0
2025-09-19 23:56:13+00:00,MujibAsrori,"ga ada yang pengen ngajak Bahlil naik ring 3 ronde aja? 
se-banyak ini orang mengutuk tapi ga ada yang pengen ngajakin baku hantam",0,0,0,176,https://x.com/MujibAsrori/status/1969188811771895901,https://x.com/IndoPopBase/status/1969020268766236902,0
2025-09-19 13:39:21+00:00,blinkerss,"@grok
 rubah wajah di foto sebelah kiri menjadi kerang",0,0,0,684,https://x.com/blinkerss/status/1969033573517717595,https://x.com/IndoPopBase/status/1969020268766236902,0
2025-09-19 13:04:56+00:00,ridwanhere,"untuk lulusan S3 UI , output keluarannya orang begini",0,0,0,752,https://x.com/ridwanhere/status/1969024913563377821,https://x.com/IndoPopBase/status/1969020268766236902,0
2025-09-19 13:41:12+00:00,Abdoeljegger202,Njiji'i kau tuh Lil ,0,0,0,41,https://x.com/Abdoeljegger202/status/1969034040276570576,https://x.com/IndoPopBase/status/1969020268766236902,0
2025-09-19 14:26:34+00:00,sabrinongs,"Ngomong mah enak pak kyk ngmg ke orang ""eh kamu jangan tenggelem dulu tapi ga ngasih bantuan apa-apa""",0,0,0,827,https://x.com/sabrinongs/status/1969045455506907501,https://x.com/IndoPopBase/status/1969020268766236902,0
2025-09-19 13:47:51+00:00,utdstewie,Semoga lekas diterima di sisinya deh kayak Sutan,0,0,0,42,https://x.com/utdstewie/status/1969035711488606472,https://x.com/IndoPopBase/status/1969020268766236902,0
2025-09-19 16:23:27+00:00,saltybabyyyyy,anjing,0,0,0,54,https://x.com/saltybabyyyyy/status/1969074869422751840,https://x.com/IndoPopBase/status/1969020268766236902,0
2025-09-20 05:14:28+00:00,Rujakcinguur,Sok paling care ngurusi negara des bedes,0,0,0,65,https://x.com/Rujakcinguur/status/1969268904334643565,https://x.com/IndoPopBase/status/1969020268766236902,0
2025-09-19 13:53:59+00:00,aditya_bp,Tunjangan mentri lu buat bayarin gaji mereka cuk!,0,0,0,526,https://x.com/aditya_bp/status/1969037256980562112,https://x.com/IndoPopBase/status/1969020268766236902,0
2025-09-19 13:47:06+00:00,surgadikakiwibu,Can you cover his face please.,0,0,0,171,https://x.com/surgadikakiwibu/status/1969035525693796857,https://x.com/IndoPopBase/status/1969020268766236902,0
2025-09-19 14:28:55+00:00,sugar_6378,"jenis-jenis pajak yang relevan untuk Shell:
Pajak Penghasilan, Pajak Penghasilan, Pajak Pertambahan Nilai, Pajak Bahan Bakar Kendaraan Bermotor, Royalti.

mungkin ini pak, yang membuat mereka kecempit sama harga persaingan pasar.

mungkin bisa dibantu diringankan..",0,0,0,428,https://x.com/sugar_6378/status/1969046045515538801,https://x.com/IndoPopBase/status/1969020268766236902,0
2025-09-20 21:46:44+00:00,CanYusan4218,K,0,0,0,1,https://x.com/CanYusan4218/status/1969518616908611904,https://x.com/IndoPopBase/status/1969020268766236902,0
2025-09-19 13:12:14+00:00,manesnoire,Najis,0,0,0,10,https://x.com/manesnoire/status/1969026748806238665,https://x.com/IndoPopBase/status/1969020268766236902,0
2025-09-19 14:14:35+00:00,2706pages,tiap ni org muncul cuma bisa bikin para wni marah²,0,0,0,202,https://x.com/2706pages/status/1969042438372106284,https://x.com/IndoPopBase/status/1969020268766236902,0
2025-09-20 03:31:55+00:00,3ft79,Goblok bahlil,0,0,0,8,https://x.com/3ft79/status/1969243094261301719,https://x.com/IndoPopBase/status/1969020268766236902,0
2025-09-19 15:41:46+00:00,rabkarydla,tolol nih menteri,0,0,0,19,https://x.com/rabkarydla/status/1969064380433051690,https://x.com/IndoPopBase/status/1969020268766236902,0
2025-09-19 13:11:33+00:00,tfbykbyk,Dzolim,0,0,0,85,https://x.com/tfbykbyk/status/1969026578370969777,https://x.com/IndoPopBase/status/1969020268766236902,0
2025-09-19 17:47:24+00:00,quaswex00,biji pelerrr bahlul,0,0,0,21,https://x.com/quaswex00/status/1969095996173951378,https://x.com/IndoPopBase/status/1969020268766236902,0
2025-09-19 20:59:36+00:00,ettttttttta,,0,0,0,29,https://x.com/ettttttttta/status/1969144366020075867,https://x.com/IndoPopBase/status/1969020268766236902,0
2025-09-20 06:05:08+00:00,eeparkeww,"ni beliau ga udah2 dah kemarin gas LPG sekarang bensin, masa die mulu dul",0,0,0,58,https://x.com/eeparkeww/status/1969281655966716257,https://x.com/IndoPopBase/status/1969020268766236902,0
2025-09-19 13:58:21+00:00,mingyudepokkk,Tolol,0,0,0,51,https://x.com/mingyudepokkk/status/1969038353346482588,https://x.com/IndoPopBase/status/1969020268766236902,0
2025-09-20 09:32:58+00:00,teertralala,Mengolah naon sih? Ngacak ngacak hah?,0,0,0,23,https://x.com/teertralala/status/1969333957037572571,https://x.com/IndoPopBase/status/1969020268766236902,0
2025-09-20 03:57:46+00:00,noiretfleurir,Pig emang,0,0,0,3,https://x.com/noiretfleurir/status/1969249599496856048,https://x.com/IndoPopBase/status/1969020268766236902,0
2025-09-20 12:36:45+00:00,gusgusanomali,MINTA MINTA DOANG GA ADA KEBIJAKAN ATAU AKSI YANG DIA LAKUIN,0,0,0,8,https://x.com/gusgusanomali/status/1969380206390771959,https://x.com/IndoPopBase/status/1969020268766236902,0
2025-09-19 13:21:23+00:00,jiwoongchingu05,Aturan mainnya ya memonopoli rakyatnya,0,0,0,237,https://x.com/jiwoongchingu05/status/1969029052070867303,https://x.com/IndoPopBase/status/1969020268766236902,0
2025-09-20 02:50:56+00:00,freakin_monday,bacot jelek anj,0,0,0,11,https://x.com/freakin_monday/status/1969232782636229116,https://x.com/IndoPopBase/status/1969020268766236902,0
2025-09-21 00:39:39+00:00,Indocyber100625,"""tidak boleh ada gerakan tambahan"" pemilihan kata2nya ga banget wkwk",0,0,0,18,https://x.com/Indocyber100625/status/1969562129742381309,https://x.com/IndoPopBase/status/1969020268766236902,0
2025-09-19 21:04:08+00:00,granturismos_,Haduh dia lagi dia lagi,0,0,0,22,https://x.com/granturismos_/status/1969145505557971397,https://x.com/IndoPopBase/status/1969020268766236902,0
2025-09-19 15:00:12+00:00,akzidan28,,0,0,0,12,https://x.com/akzidan28/status/1969053918337356041,https://x.com/IndoPopBase/status/1969020268766236902,0
2025-09-20 03:28:26+00:00,jhjhjhyoo,"pahlawan mana nih, pahlawan.. ooo pahlawan",0,0,0,31,https://x.com/jhjhjhyoo/status/1969242217547022551,https://x.com/IndoPopBase/status/1969020268766236902,0
2025-09-19 15:20:46+00:00,ClassicalSeven,halahhhh,0,0,0,16,https://x.com/ClassicalSeven/status/1969059095693942843,https://x.com/IndoPopBase/status/1969020268766236902,0
2025-09-19 12:10:37+00:00,Alifbatasajim24,time so fast and being wni stres welcome 2026 soon,0,15,0,17224,https://x.com/Alifbatasajim24/status/1969011244309844345,https://x.com/IndoPopBase/status/1969008879640957347,15
2025-09-19 12:13:27+00:00,SaddamWeb3,"ini berita bagus buat pengangguran kyk gw ga sih 
@gork
 ?",1,0,0,14003,https://x.com/SaddamWeb3/status/1969011956959814070,https://x.com/IndoPopBase/status/1969008879640957347,1
2025-09-19 15:36:19+00:00,skingameofc,otw siapin alesan cuti di hari kejepit mulai dari sekarang,0,0,0,7918,https://x.com/skingameofc/status/1969063009210314976,https://x.com/IndoPopBase/status/1969008879640957347,0
2025-09-19 12:02:49+00:00,SHUTCH00,who says theres gonna be 2026 in indonesia,0,7,0,9435,https://x.com/SHUTCH00/status/1969009281543393718,https://x.com/IndoPopBase/status/1969008879640957347,7
2025-09-19 14:31:06+00:00,terpenlanting,no holiday or collective leave in September October and November is diabolical cause wdym we have to go to work in rainy season ,1,3,0,5891,https://x.com/terpenlanting/status/1969046596013719642,https://x.com/IndoPopBase/status/1969008879640957347,4
2025-09-19 12:15:59+00:00,Twittysweetie_,"Banyak betul jadwal cuti bersamanya
Negara lain libur nasional dikit.
Ini 17 Masih ditambah cuti bersama",7,5,0,22550,https://x.com/Twittysweetie_/status/1969012592820539629,https://x.com/IndoPopBase/status/1969008879640957347,12
2025-09-19 12:28:39+00:00,ndroe_,cuti idul fitri paling banyak,1,2,0,4444,https://x.com/ndroe_/status/1969015781137514530,https://x.com/IndoPopBase/status/1969008879640957347,3
2025-09-19 12:41:00+00:00,zingwind,"Waw, 1 Januari hari Kamis.
2 Januari hari Jumat.

Karyawan yg belum punya cuti, siap2lah masuk kerja di hari kejepit nan menyiksa ",0,4,0,5432,https://x.com/zingwind/status/1969018890362491135,https://x.com/IndoPopBase/status/1969008879640957347,4
2025-09-19 12:12:08+00:00,·,"not for retail, fnb, nakes",0,0,0,1392,https://x.com/shutsline/status/1969011624423174490,https://x.com/IndoPopBase/status/1969008879640957347,0
2025-09-19 21:42:08+00:00,sumoyed,idul fitri sabtu minggu ,0,0,0,224,https://x.com/sumoyed/status/1969155069871378895,https://x.com/IndoPopBase/status/1969008879640957347,0
2025-09-19 14:37:18+00:00,PutriNurIndahP,"Libur nasional dan cuti bersama hanya bagi yang merayakan aja.

Untuk nakes kan tetap kerja. ",0,0,0,1590,https://x.com/PutriNurIndahP/status/1969048157070757889,https://x.com/IndoPopBase/status/1969008879640957347,0
2025-09-19 14:34:58+00:00,madiesct,"Cuman di tempat kerja gw, hak cuti tahunan malah ke potong sama cuti bersama ada kah yang SMA ???",0,0,0,705,https://x.com/madiesct/status/1969047571147501790,https://x.com/IndoPopBase/status/1969008879640957347,0
2025-09-19 14:46:55+00:00,amltrisnawati,Cant wait,0,0,0,55,https://x.com/amltrisnawati/status/1969050575485477073,https://x.com/IndoPopBase/status/1969008879640957347,0
2025-09-19 18:31:41+00:00,mffyach,Cuti bersama kaga ngaruh wir,0,0,0,58,https://x.com/mffyach/status/1969107141194547289,https://x.com/IndoPopBase/status/1969008879640957347,0
2025-09-19 14:34:20+00:00,nadhiadom,Lebaran hari sabtu sama minggu…,0,0,0,227,https://x.com/nadhiadom/status/1969047412795678818,https://x.com/IndoPopBase/status/1969008879640957347,0
2025-09-19 12:27:02+00:00,bareda,"Santaiiii, ini masih September. Buat tahun baruan aja belum ada rencana.",2,0,0,14364,https://x.com/bareda/status/1969015376110301327,https://x.com/IndoPopBase/status/1969008879640957347,2
2025-09-19 14:27:52+00:00,huangdaef,ya allah 2026...,0,0,0,6255,https://x.com/huangdaef/status/1969045784315281656,https://x.com/IndoPopBase/status/1969008879640957347,0
2025-09-19 16:07:01+00:00,s_eishu,"ANNELICIOUS 
@mvdaye",1,0,0,35,https://x.com/s_eishu/status/1969070735483142312,https://x.com/IndoPopBase/status/1969008879640957347,1
2025-09-19 16:50:21+00:00,ikan_mainan,"Gaskeun 
@crindilkutil",0,0,0,7,https://x.com/ikan_mainan/status/1969081638555427173,https://x.com/IndoPopBase/status/1969008879640957347,0
2025-09-19 16:37:56+00:00,kawrnp,"anjir lebaran fitri weekend:"")))",0,0,0,65,https://x.com/kawrnp/status/1969078516051279921,https://x.com/IndoPopBase/status/1969008879640957347,0
2025-09-19 15:53:13+00:00,jeffryrisandy,"nice info. finally, tomorrow I can start printing orders for next year's calendar project",0,0,0,256,https://x.com/jeffryrisandy/status/1969067264138789315,https://x.com/IndoPopBase/status/1969008879640957347,0
2025-09-19 16:28:26+00:00,michh_eth,ASYIKKKKKK LIBURRRRRR,0,0,0,2492,https://x.com/michh_eth/status/1969076125226684586,https://x.com/IndoPopBase/status/1969008879640957347,0
2025-09-20 06:25:29+00:00,magunganugrah,Bocah pabrik ga relate,0,0,0,22,https://x.com/magunganugrah/status/1969286775051804867,https://x.com/IndoPopBase/status/1969008879640957347,0
2025-09-20 12:11:31+00:00,kepoused,Need more holiday,0,0,0,11,https://x.com/kepoused/status/1969373858970157411,https://x.com/IndoPopBase/status/1969008879640957347,0
2025-09-19 16:13:46+00:00,centang2biru,"Hamdallah, tanggal merah di weekday ada 13, bisa lembur. ",0,0,0,463,https://x.com/centang2biru/status/1969072434033660026,https://x.com/IndoPopBase/status/1969008879640957347,0
2025-09-20 09:17:37+00:00,feexxyz,"Njir, ini orang indo pinter banget ngepas-ngepasin ke angka 17/8/45.
Segala banyaknya libur & cuti bisa dipasin ke angka tersebut.",0,0,0,51,https://x.com/feexxyz/status/1969330094440079801,https://x.com/IndoPopBase/status/1969008879640957347,0
2025-09-20 07:00:30+00:00,fajarlyeh,so we get 17+8 afterall huh,0,0,0,23,https://x.com/fajarlyeh/status/1969295587464941979,https://x.com/IndoPopBase/status/1969008879640957347,0
2025-09-19 16:21:41+00:00,halcyoneva,"Banyak juga cuti bersamanya, tapi kayanya udah ga bisa ikut nikmatin",0,0,0,346,https://x.com/halcyoneva/status/1969074424465789353,https://x.com/IndoPopBase/status/1969008879640957347,0
2025-09-19 16:29:17+00:00,GloryHunterrss,"Para anjing ini masih menulis isa almasih, dasar uclim kontol",0,0,0,185,https://x.com/GloryHunterrss/status/1969076337206841690,https://x.com/IndoPopBase/status/1969008879640957347,0
2025-09-20 06:32:16+00:00,3yan2002,"Pas nganggur gak peduli ama tgl merah. Semua hari sama
Sekarang dah kerja lagi, seneng bgt klo tgl merah",0,0,0,115,https://x.com/3yan2002/status/1969288483500863555,https://x.com/IndoPopBase/status/1969008879640957347,0
2025-09-19 16:53:23+00:00,adolescentsssss,Dan yap september - desember gaada libur nasional lagi wkwkwk selain nataru,0,0,0,7,https://x.com/adolescentsssss/status/1969082402929627490,https://x.com/IndoPopBase/status/1969008879640957347,0
2025-09-19 14:44:07+00:00,jadigmnmksdnya,why udah mau 2026 aja ,0,0,0,101,https://x.com/jadigmnmksdnya/status/1969049871316390077,https://x.com/IndoPopBase/status/1969008879640957347,0
2025-09-20 02:21:22+00:00,yash_doum,Berarti pegawai pemerintah dpt 25 hari libur gratis ya.......,0,0,0,208,https://x.com/yash_doum/status/1969225340456182084,https://x.com/IndoPopBase/status/1969008879640957347,0
2025-09-19 14:32:55+00:00,halloagit,pegawai swasta gausah liat yang bawah  yang bawah khusus YGGA (Yang Gov Gov Aja) ,0,0,0,597,https://x.com/halloagit/status/1969047053922701656,https://x.com/IndoPopBase/status/1969008879640957347,0
2025-09-19 13:39:31+00:00,kkokonnnnn,Super scan nyari libur nasional hari Jum'at sama Senin,1,0,0,939,https://x.com/kkokonnnnn/status/1969033614001094999,https://x.com/IndoPopBase/status/1969008879640957347,1
2025-09-19 15:45:33+00:00,mygptrart,2026 bisa yokk cuti menikah nya dikape ,1,0,0,414,https://x.com/mygptrart/status/1969065331227275714,https://x.com/IndoPopBase/status/1969008879640957347,1
2025-09-20 02:04:08+00:00,_ifa_,,0,0,0,14,https://x.com/_ifa_/status/1969221003113812001,https://x.com/IndoPopBase/status/1969008879640957347,0
2025-09-20 00:33:54+00:00,muammarfadhilah,26 Agustus - 24 Desember ,0,0,0,153,https://x.com/muammarfadhilah/status/1969198296351621161,https://x.com/IndoPopBase/status/1969008879640957347,0
2025-09-20 00:42:14+00:00,arkho_,"Ohh no.. idul fitri hari sabtu & minggu.
Rugi 2 hari libur ini mah.. ",0,0,0,123,https://x.com/arkho_/status/1969200393042198743,https://x.com/IndoPopBase/status/1969008879640957347,0
2025-09-19 15:50:32+00:00,Darth_Aryo,Ah…nanti kan tahun berjalan ada revisi SK ,0,0,0,211,https://x.com/Darth_Aryo/status/1969066587404595402,https://x.com/IndoPopBase/status/1969008879640957347,0
2025-09-19 12:43:14+00:00,tuty_frutti,masih semptember lho ini ,0,0,0,892,https://x.com/tuty_frutti/status/1969019450968924585,https://x.com/IndoPopBase/status/1969008879640957347,0
2025-09-19 15:02:41+00:00,adjsnts,Ga ngaruh buat gw sebagai buruh f&b,0,0,0,184,https://x.com/adjsnts/status/1969054543427019028,https://x.com/IndoPopBase/status/1969008879640957347,0
2025-09-19 14:02:11+00:00,exsoodae,akhirnya keluarr,0,0,0,108,https://x.com/exsoodae/status/1969039319261126916,https://x.com/IndoPopBase/status/1969008879640957347,0
2025-09-20 00:08:57+00:00,edinostuz,Tahun depan Ultah di hari Senin,0,0,0,24,https://x.com/edinostuz/status/1969192019760185786,https://x.com/IndoPopBase/status/1969008879640957347,0
2025-09-19 12:54:35+00:00,siapanisiapasi,"Meanwhile yg kagak ikutan cuti bersama, sibuk ngitungin ROPH",0,0,0,797,https://x.com/siapanisiapasi/status/1969022307457790218,https://x.com/IndoPopBase/status/1969008879640957347,0
2025-09-19 13:24:57+00:00,syaafrin,ya Allah cepet banget,0,0,0,236,https://x.com/syaafrin/status/1969029949131501682,https://x.com/IndoPopBase/status/1969008879640957347,0
2025-09-19 14:50:48+00:00,·,Cuti 12 kyknya ga cukup deh,0,0,0,94,https://x.com/ravidalAkbar/status/1969051554515697889,https://x.com/IndoPopBase/status/1969008879640957347,0
2025-09-19 15:05:24+00:00,myungjaefisipol,yah kagak surprise,0,0,0,94,https://x.com/myungjaefisipol/status/1969055228637880674,https://x.com/IndoPopBase/status/1969008879640957347,0
2025-09-19 13:03:09+00:00,·,"""Cuti bersama"" tidak berlaku di semua kantor",0,0,0,1027,https://x.com/chooocolatae/status/1969024463925850362,https://x.com/IndoPopBase/status/1969008879640957347,0
2025-09-19 13:05:14+00:00,formerlyAbyan,5 holidays in May and also that 1st June,0,0,0,504,https://x.com/formerlyAbyan/status/1969024988997984709,https://x.com/IndoPopBase/status/1969008879640957347,0
2025-09-19 04:33:37+00:00,SaddamWeb3,"waduh rame banget, 250 orang masuk RS itu udah level bencana massal loh
hentikan program MBG king Prabowo",0,0,0,1399,https://x.com/SaddamWeb3/status/1968896236204806197,https://x.com/IndoPopBase/status/1968885776889823370,0
2025-09-19 09:39:13+00:00,negativisme,Hmm kalo ini seskab mengandung rasa wapres?,0,0,0,388,https://x.com/negativisme/status/1968973140563742956,https://x.com/IndoPopBase/status/1968885776889823370,0
2025-09-19 04:01:03+00:00,hadilocoboy,program bagus tapi eksekusinya engga banget,0,0,0,1231,https://x.com/hadilocoboy/status/1968888040144662616,https://x.com/IndoPopBase/status/1968885776889823370,0
2025-09-19 04:06:05+00:00,hazelnoode,"lebih banyak mudharat dibanding manfaatnya...yaAllah, stop aja bisa ga si mending sekalian siswa diwajibin bekel dr rumah aja dah drpd gini, nyawa loh itu malah ky dipermainkan",3,2,0,3149,https://x.com/hazelnoode/status/1968889306304426138,https://x.com/IndoPopBase/status/1968885776889823370,5
2025-09-19 04:03:09+00:00,stihff,"apa pun programnya, yang salah bukan presidennya. tapi kalau programnya bagus, presidennya dipuja puja ",2,7,0,1265,https://x.com/stihff/status/1968888567008002363,https://x.com/IndoPopBase/status/1968885776889823370,9
2025-09-19 03:57:26+00:00,Rumahdepok_,"Program yang bisa jadi haram dalam kacamata agama, karena ni program gaada manfaatnya dan lebih banyak mudharatnya ",2,1,0,2685,https://x.com/Rumahdepok_/status/1968887128403706284,https://x.com/IndoPopBase/status/1968885776889823370,3
2025-09-19 04:10:44+00:00,bareda,What caused it?,1,1,0,3263,https://x.com/bareda/status/1968890477052055619,https://x.com/IndoPopBase/status/1968885776889823370,2
2025-09-19 04:09:14+00:00,CakRedi,,0,0,0,584,https://x.com/CakRedi/status/1968890097828282509,https://x.com/IndoPopBase/status/1968885776889823370,0
2025-09-19 07:00:50+00:00,orang2_biasa,This is Indonesia,0,0,0,28,https://x.com/orang2_biasa/status/1968933282445222381,https://x.com/IndoPopBase/status/1968885776889823370,0
2025-09-19 05:44:52+00:00,rvbaharktik,I still blame all the 02 Voters!!!,0,0,0,69,https://x.com/rvbaharktik/status/1968914165273071803,https://x.com/IndoPopBase/status/1968885776889823370,0
2025-09-19 04:16:51+00:00,0xgasm,man just stop di shitty program,0,0,0,638,https://x.com/0xgasm/status/1968892014008610952,https://x.com/IndoPopBase/status/1968885776889823370,0
2025-09-19 07:24:23+00:00,k0py0,Makan beracun gratis,0,0,0,1001,https://x.com/k0py0/status/1968939211035234530,https://x.com/IndoPopBase/status/1968885776889823370,0
2025-09-19 07:07:15+00:00,TejaAru05798875,We blame ndut’s asbun for this.,0,0,0,57,https://x.com/TejaAru05798875/status/1968934897608696289,https://x.com/IndoPopBase/status/1968885776889823370,0
2025-09-19 06:37:13+00:00,Hydelism,harus ada korban jiwa meninggal dunia dulukah wowo and the gank baru sadar!,0,0,0,6,https://x.com/Hydelism/status/1968927341607792853,https://x.com/IndoPopBase/status/1968885776889823370,0
2025-09-19 05:20:34+00:00,dundunthetruth,Makanya jangan makan racun berkedok MBG,0,0,0,61,https://x.com/dundunthetruth/status/1968908050955161981,https://x.com/IndoPopBase/status/1968885776889823370,0
2025-09-19 04:45:16+00:00,ddpwp__,Mau sampe kapan?,0,0,0,42,https://x.com/ddpwp__/status/1968899166911823894,https://x.com/IndoPopBase/status/1968885776889823370,0
2025-09-19 06:10:01+00:00,originalgeprek,"Keracunan dikit ga ngaruh,yang penting anak2 wajib bermoral tinggi ya pak buk",0,0,0,38,https://x.com/originalgeprek/status/1968920495413137918,https://x.com/IndoPopBase/status/1968885776889823370,0
2025-09-19 04:26:16+00:00,nettle_daughter,"Buset, hari-hari ada terus yg keracunan",0,0,0,85,https://x.com/nettle_daughter/status/1968894385757507597,https://x.com/IndoPopBase/status/1968885776889823370,0
2025-09-19 04:01:14+00:00,chrono_joe,"Semoga cepat sembuh, namanya error pasti ada aja, semoga errornya itu tidak sefatal India yang mbgnya merenggut korban jiwa.

Di korsel dan jepang juga ada ribuan, tapi semuanya sehat kembali.",0,0,0,248,https://x.com/chrono_joe/status/1968888085581561983,https://x.com/IndoPopBase/status/1968885776889823370,0
2025-09-19 04:00:49+00:00,shakesapear,even netanyahu won’t genocide his own zionist people. holy FUCKKK,0,0,0,95,https://x.com/shakesapear/status/1968887979629228096,https://x.com/IndoPopBase/status/1968885776889823370,0
2025-09-19 12:49:19+00:00,popo0737,Again... The cases... Just to many...,0,0,0,59,https://x.com/popo0737/status/1969020984050016428,https://x.com/IndoPopBase/status/1968885776889823370,0
2025-09-19 07:20:01+00:00,roweeasley,I bet peoples doesn't even know the tea about the tray is also a part of the problem.,0,0,0,86,https://x.com/roweeasley/status/1968938110286217711,https://x.com/IndoPopBase/status/1968885776889823370,0
2025-09-19 14:51:38+00:00,MX9885,"Sigendut tau gk sih ada berita ginian, apa segala informasi yg masuk diatur buna teddy? Dikasih tau yg bagus2 doang, maklum dah jompo jadi gampang dibohongi & dibodohi",0,0,0,23,https://x.com/MX9885/status/1969051766281977872,https://x.com/IndoPopBase/status/1968885776889823370,0
2025-09-19 06:26:03+00:00,bingkaiputih2,Pemerintah tolong dong jangan denial sama berita kayak gini! Evaluasi! Bukan sibuk percitraan sana sini,0,0,0,60,https://x.com/bingkaiputih2/status/1968924531398942722,https://x.com/IndoPopBase/status/1968885776889823370,0
2025-09-19 08:26:03+00:00,Anthonyfool100,Mana korbannya anak sekolah lagi yang bikin miris. Ini serius negara mau racuni generasi penerus bangsa?,0,0,0,46,https://x.com/Anthonyfool100/status/1968954729267879960,https://x.com/IndoPopBase/status/1968885776889823370,0
2025-09-19 04:33:01+00:00,rongoround,Aku masih bingung ini penyebabnya apa karena kalau keracunan makanan biasa gk mungkin sampe separah itu sampe sesak napas kejang kejang. Malah kepikiran ada yang sengaja naruh racun,2,0,0,412,https://x.com/rongoround/status/1968896083481788822,https://x.com/IndoPopBase/status/1968885776889823370,2
2025-09-19 09:51:36+00:00,Molekul_Ceria,Banggai is central sulawesi,0,0,0,22,https://x.com/Molekul_Ceria/status/1968976260173824334,https://x.com/IndoPopBase/status/1968885776889823370,0
2025-09-19 16:55:29+00:00,creamycump,Makan Beracun Gratis,0,0,0,6,https://x.com/creamycump/status/1969082932590510197,https://x.com/IndoPopBase/status/1968885776889823370,0
2025-09-19 07:24:39+00:00,byeworkk,"Banyak banget berita keracunan MBG, kejadiannya juga bukan di satu atau dua daerah aja, respon pemerintah cuma ""belum biasa makan makanan enak"". Pas ada yang bikin video anaknya muntah karena MBG malah didatengin tentara & polisi disuruh klarifikasi, Indonesia gak ketolong. Gila.",0,0,0,101,https://x.com/byeworkk/status/1968939275845595250,https://x.com/IndoPopBase/status/1968885776889823370,0
2025-09-19 21:07:55+00:00,NyankoAngy,"Aku liat videonya di tikt0k kasian adek2nya  beneran berhentiin aja sih. Dan lebih herannya lg banyak yg dukung si prabs dan bilang ""ini siapa yg masak, jangan salahin si onoh"" ",0,0,0,28,https://x.com/NyankoAngy/status/1969146459766317494,https://x.com/IndoPopBase/status/1968885776889823370,0
2025-09-19 04:15:59+00:00,McBonnieCat,Sebenarnya apa si yg dimasak,0,0,0,3,https://x.com/McBonnieCat/status/1968891798018720145,https://x.com/IndoPopBase/status/1968885776889823370,0
2025-09-19 04:09:13+00:00,oethelcrowded,"Proyek ini merusak harga pasaran kitchen equipment, otomatis kualitas kitchen equipment akan di down grade! Coba cek di tiap daerah, ada berapa catering yang menggunakan equipment food grade! Dari puluhan catering, mungkin hanya 1 atau 2 yang menggunakan equipment food grade!",0,0,0,467,https://x.com/oethelcrowded/status/1968890095240356221,https://x.com/IndoPopBase/status/1968885776889823370,0
2025-09-19 05:24:23+00:00,dtstvrb,pasti ada ulah anak abah selama proses bikinnya,1,0,0,289,https://x.com/dtstvrb/status/1968909010972598397,https://x.com/IndoPopBase/status/1968885776889823370,1
2025-09-19 06:55:22+00:00,sendiri_uWu,"Dan gw nemuin beberapa yg sudah berkarat, padahal belum dipake",0,0,0,64,https://x.com/sendiri_uWu/status/1968931906445086981,https://x.com/IndoPopBase/status/1968885776889823370,0
2025-09-19 05:59:30+00:00,chichaseed,"crazy…… harus ada penanggulangannya sumpah udh too much, atp we’re all gonna die",0,0,0,60,https://x.com/chichaseed/status/1968917850392846555,https://x.com/IndoPopBase/status/1968885776889823370,0
2025-09-19 05:26:12+00:00,_hotpiccolo,"Uangnya dikasih ke orang tua aja, biar orang tuanya yang suruh masak ",0,0,0,88,https://x.com/_hotpiccolo/status/1968909467031843085,https://x.com/IndoPopBase/status/1968885776889823370,0
2025-09-19 06:29:09+00:00,marian_mariee,perlu berapa banyak orang lagi buat jadi korbannya?,0,0,0,41,https://x.com/marian_mariee/status/1968925309652107415,https://x.com/IndoPopBase/status/1968885776889823370,0
2025-09-19 08:45:33+00:00,dioz19,"Sukses nya sekarang berapa persen pak 
@prabowo
 @Gerindra",0,0,0,49,https://x.com/dioz19/status/1968959636033204436,https://x.com/IndoPopBase/status/1968885776889823370,0
2025-09-19 04:09:54+00:00,lostranslation5,keluar lu pengecut gendut,0,0,0,84,https://x.com/lostranslation5/status/1968890265470447853,https://x.com/IndoPopBase/status/1968885776889823370,0
2025-09-19 06:59:49+00:00,achmed63588963,Hari-hari disuguhkan berita yg innalillah,0,0,0,41,https://x.com/achmed63588963/status/1968933028773667247,https://x.com/IndoPopBase/status/1968885776889823370,0
2025-09-19 07:18:22+00:00,yulviantoni,"should be ""BY MASS POISONING""",0,0,0,19,https://x.com/yulviantoni/status/1968937697365393556,https://x.com/IndoPopBase/status/1968885776889823370,0
2025-09-19 10:40:38+00:00,peristereiya,"@prabowo
 @ListyoSigitP",0,0,0,16,https://x.com/peristereiya/status/1968988596628554056,https://x.com/IndoPopBase/status/1968885776889823370,0
2025-09-19 22:50:52+00:00,nahdatulemma,Konoha,0,0,0,6,https://x.com/nahdatulemma/status/1969172366166007829,https://x.com/IndoPopBase/status/1968885776889823370,0
2025-09-19 04:38:13+00:00,_bbbfemoes,Who do we blame?,0,0,0,57,https://x.com/_bbbfemoes/status/1968897393186783244,https://x.com/IndoPopBase/status/1968885776889823370,0
2025-09-19 06:48:50+00:00,kayu_otong,"Woow..?! 
@prabowo
 @Gerindra
 @bang_dasco",0,0,0,28,https://x.com/kayu_otong/status/1968930263422927028,https://x.com/IndoPopBase/status/1968885776889823370,0
2025-09-19 09:54:53+00:00,ravenerts,"@prabowo
 Kindly take an immediate action for this case. Don't wait until someone dies because of food poisoning like this.",0,0,0,52,https://x.com/ravenerts/status/1968977084849570001,https://x.com/IndoPopBase/status/1968885776889823370,0
2025-09-19 04:53:08+00:00,kemalkamel08,Banggai itu di Sulteng min bukan Sulsel,0,0,0,65,https://x.com/kemalkamel08/status/1968901148242330067,https://x.com/IndoPopBase/status/1968885776889823370,0
2025-09-19 04:03:33+00:00,bayoeoe,"Cuma 1% kejadian itu, kan 99% MBG aman. Udah jangan diributin, error kecil aja kok dibesar2kan........

Palingan juga dijawab gitu ntar di didepan wartawan.",0,0,0,153,https://x.com/bayoeoe/status/1968888669135065377,https://x.com/IndoPopBase/status/1968885776889823370,0
2025-09-19 09:37:38+00:00,SinK_al,At this point I think the government trying to control the mass population by poisoning them,0,0,0,10,https://x.com/SinK_al/status/1968972742947918229,https://x.com/IndoPopBase/status/1968885776889823370,0
2025-09-20 03:58:18+00:00,jjkags,Catat ya gess,0,0,0,5,https://x.com/jjkags/status/1969249737271288116,https://x.com/IndoPopBase/status/1968885776889823370,0
2025-09-19 04:42:42+00:00,SaddamWeb3,"bayangin kalo bung karno masih ada, ngatur ultah keluarga.
tiap bulan ada yg ultah.
rayain satu2 apa gabung sekalian ya? 
istri 8, anak 11, cucu puluhan ",2,3,0,2786,https://x.com/SaddamWeb3/status/1968898520850542692,https://x.com/IndoPopBase/status/1968703669433426257,5
2025-09-19 00:32:04+00:00,okezonenews,Kabar Duka! Istri ke-7 Presiden Soekarno Meninggal Dunia di Amerika Serikat,0,0,0,3925,https://x.com/okezonenews/status/1968835445615198304,https://x.com/IndoPopBase/status/1968703669433426257,0
2025-09-18 17:28:59+00:00,Piriewonpirie,"Waktu dia proklamasi, mendiang baru lahir ",5,3,0,6361,https://x.com/Piriewonpirie/status/1968728976685228487,https://x.com/IndoPopBase/status/1968703669433426257,8
2025-09-18 16:10:29+00:00,svadrlf,"Soekarno punya istri 8, anak anak dari istrinya pada ke mana ya btw. Knapa yang kliatan cuma liat megawati ya?",2,2,0,8203,https://x.com/svadrlf/status/1968709219277852989,https://x.com/IndoPopBase/status/1968703669433426257,4
2025-09-18 15:51:04+00:00,ursteulyNaveen,May she rest in peace  Condolences to her family and loved ones during this time of loss.,0,0,0,7235,https://x.com/ursteulyNaveen/status/1968704334817800554,https://x.com/IndoPopBase/status/1968703669433426257,0
2025-09-19 00:42:51+00:00,Momotaro1883,That nigga collecting wives like pokemons,0,1,0,1526,https://x.com/Momotaro1883/status/1968838159480807576,https://x.com/IndoPopBase/status/1968703669433426257,1
2025-09-18 17:06:25+00:00,kowalskuy,"Gak ke-7 ya, Min?",1,0,0,5787,https://x.com/kowalskuy/status/1968723297173926356,https://x.com/IndoPopBase/status/1968703669433426257,1
2025-09-19 12:34:46+00:00,·,"anak sukarno selain dari fatmawati dari siapa lagi ya 
@grok",1,0,0,599,https://x.com/agunsux/status/1969017321013317662,https://x.com/IndoPopBase/status/1968703669433426257,1
2025-09-18 15:58:54+00:00,0xgasm,Rest in Peace,0,0,0,7157,https://x.com/0xgasm/status/1968706304639386007,https://x.com/IndoPopBase/status/1968703669433426257,0
2025-09-18 16:03:15+00:00,RIGAM07,Turut berdukacita,0,0,0,6760,https://x.com/RIGAM07/status/1968707398513696983,https://x.com/IndoPopBase/status/1968703669433426257,0
2025-09-19 06:00:29+00:00,comingsun_,Turut berduka cita,0,0,0,1234,https://x.com/comingsun_/status/1968918095394717756,https://x.com/IndoPopBase/status/1968703669433426257,0
2025-09-18 16:40:58+00:00,Nothing_Mate_9,80 ,0,0,0,1760,https://x.com/Nothing_Mate_9/status/1968716892878565601,https://x.com/IndoPopBase/status/1968703669433426257,0
2025-09-19 05:30:07+00:00,unanevesoffice,EIGHTH!?,0,0,0,351,https://x.com/unanevesoffice/status/1968910453460865213,https://x.com/IndoPopBase/status/1968703669433426257,0
2025-09-19 07:35:13+00:00,natasha_saja,Yg resmi ada berapa istrinya?,0,0,0,277,https://x.com/natasha_saja/status/1968941937731265008,https://x.com/IndoPopBase/status/1968703669433426257,0
2025-09-18 16:58:56+00:00,PutriNovela9,trut berduka cita,0,0,0,3126,https://x.com/PutriNovela9/status/1968721411599396940,https://x.com/IndoPopBase/status/1968703669433426257,0
2025-09-19 03:38:53+00:00,AerondTargaryen,Wdym 'EIGHTH WIFE'?,0,0,0,438,https://x.com/AerondTargaryen/status/1968882460126585159,https://x.com/IndoPopBase/status/1968703669433426257,0
2025-09-19 06:05:15+00:00,tropiqueta,wasnt this the girl who legit dumped her high school bf in high school for soekarno cuz she felt that her ex didnt have anything while soekarno was alr settled?,0,0,0,550,https://x.com/tropiqueta/status/1968919295259247062,https://x.com/IndoPopBase/status/1968703669433426257,0
2025-09-18 16:54:30+00:00,YogiWepe,Turut berduka cita ,0,0,0,2829,https://x.com/YogiWepe/status/1968720294928871866,https://x.com/IndoPopBase/status/1968703669433426257,0
2025-09-19 00:19:22+00:00,48squadsama,"RIP, Merupakan hal Yang tidak diceritakan di buku sejarah",0,0,0,1444,https://x.com/48squadsama/status/1968832250289541482,https://x.com/IndoPopBase/status/1968703669433426257,0
2025-09-18 22:56:55+00:00,KurniawanRicho,Turut berdukacita,0,0,0,1565,https://x.com/KurniawanRicho/status/1968811503575863759,https://x.com/IndoPopBase/status/1968703669433426257,0
2025-09-19 08:01:31+00:00,cumaberkeliaran,"Pada saat Soekarno membacakan teks proklamasi, usia Yurike Sanger belum genap 3 bulan.",0,0,0,283,https://x.com/cumaberkeliaran/status/1968948555877355615,https://x.com/IndoPopBase/status/1968703669433426257,0
2025-09-19 06:09:24+00:00,Yabo_Black,"Apakah beliau ada hubungan dengan rumor ibukota Sulawesi Tengah itu harusnya Poso, bukan Palu, seperti yg sekarang.",0,0,0,346,https://x.com/Yabo_Black/status/1968920342031630528,https://x.com/IndoPopBase/status/1968703669433426257,0
2025-09-19 06:07:09+00:00,Yabo_Black,80 tahun. Berarti waktu menikah masih under age?,0,0,0,282,https://x.com/Yabo_Black/status/1968919772592021540,https://x.com/IndoPopBase/status/1968703669433426257,0
2025-09-18 15:52:47+00:00,JavaJimmyMaukar,turut berduka cita ,0,0,0,3111,https://x.com/JavaJimmyMaukar/status/1968704765027664280,https://x.com/IndoPopBase/status/1968703669433426257,0
2025-09-18 19:37:37+00:00,freddieshoover,"Source 
tagar.id",1,1,0,1650,https://x.com/freddieshoover/status/1968761348369580106,https://x.com/IndoPopBase/status/1968703669433426257,2
2025-09-19 02:04:17+00:00,Th3Tr4vel3r,apakah ada anak dari sukarno ?,0,0,0,2157,https://x.com/Th3Tr4vel3r/status/1968858655740100723,https://x.com/IndoPopBase/status/1968703669433426257,0
2025-09-18 17:48:07+00:00,dalampukie,Rip,0,0,0,1433,https://x.com/dalampukie/status/1968733791104475211,https://x.com/IndoPopBase/status/1968703669433426257,0
2025-09-18 13:13:16+00:00,0x_PingPing,Hahahahaha,0,0,0,170,https://x.com/0x_PingPing/status/1968664622958821707,https://x.com/IndoPopBase/status/1968664468285702523,0
2025-09-18 13:13:02+00:00,widzeth,Sambalado,0,0,0,161,https://x.com/widzeth/status/1968664562246246699,https://x.com/IndoPopBase/status/1968664468285702523,0
2025-09-18 13:15:06+00:00,T3RIP4NG,when the course isnt selling…..,6,2,0,1071,https://x.com/T3RIP4NG/status/1968665081698206193,https://x.com/IndoPopBase/status/1968664468285702523,8
2025-09-18 13:39:38+00:00,dontolicious_,I uninstalled duolingo coz this possessive bird scared me,0,1,0,338,https://x.com/dontolicious_/status/1968671258947531172,https://x.com/IndoPopBase/status/1968664468285702523,1
2025-09-19 09:52:25+00:00,KrystalMHj94,Padahal dia rekrut AI makanya dia sok ke Indonesian buat gaet viewers,0,1,0,47,https://x.com/KrystalMHj94/status/1968976465518538792,https://x.com/IndoPopBase/status/1968664468285702523,1
2025-09-18 14:46:57+00:00,bobbyalfaridzhi,Has anyone seen this?,5,0,0,302,https://x.com/bobbyalfaridzhi/status/1968688195865833943,https://x.com/IndoPopBase/status/1968664468285702523,5
2025-09-18 13:21:48+00:00,BOYSFORT0RI,"@bestiesaurus
 have u heard this song sis",1,0,0,367,https://x.com/BOYSFORT0RI/status/1968666768274059743,https://x.com/IndoPopBase/status/1968664468285702523,1
2025-09-19 13:25:01+00:00,·,"when i was growing up
mama always told me to report duolingo
so i never had to rely on fraud lessons to get knowledge
but luis von ahn needs to be doxxed and i have his address
so cant a girl just end duolingo",0,0,0,24,https://x.com/ther2diodept/status/1969029966588207491,https://x.com/IndoPopBase/status/1968664468285702523,0
2025-09-18 13:30:37+00:00,Nothing_Mate_9,Tiktok,0,0,0,104,https://x.com/Nothing_Mate_9/status/1968668988700803103,https://x.com/IndoPopBase/status/1968664468285702523,0
2025-09-19 03:36:25+00:00,firzafp,Maskot burung hijau terobsesi dengan masakan pedas yang 'kolesterol ehem',0,0,0,62,https://x.com/firzafp/status/1968881841084960886,https://x.com/IndoPopBase/status/1968664468285702523,0
2025-09-18 14:18:09+00:00,roweeasley,,0,0,0,200,https://x.com/roweeasley/status/1968680950520275113,https://x.com/IndoPopBase/status/1968664468285702523,0
2025-09-18 19:51:49+00:00,shofauh1,Make tu burung. ,0,0,0,67,https://x.com/shofauh1/status/1968764921115460062,https://x.com/IndoPopBase/status/1968664468285702523,0
2025-09-18 16:19:40+00:00,·,BARU TAU ADA AKUN IG DUO INDO WKK,0,0,0,78,https://x.com/memekcita/status/1968711530687447540,https://x.com/IndoPopBase/status/1968664468285702523,0
2025-09-19 03:19:37+00:00,25centsphoto,now why do you post irrelevant ass??,0,0,0,50,https://x.com/25centsphoto/status/1968877614589952176,https://x.com/IndoPopBase/status/1968664468285702523,0
2025-09-18 13:13:51+00:00,yohkkubi,Untry it,0,0,0,245,https://x.com/yohkkubi/status/1968664767066743143,https://x.com/IndoPopBase/status/1968664468285702523,0
2025-09-19 12:15:43+00:00,Aquavo_,Back to eat your plain chicken taste,0,0,0,29,https://x.com/Aquavo_/status/1969012525208322432,https://x.com/IndoPopBase/status/1968664468285702523,0
2025-09-18 13:22:36+00:00,·,that's dongolingo,0,0,0,296,https://x.com/helfut/status/1968666971429286312,https://x.com/IndoPopBase/status/1968664468285702523,0
2025-09-18 13:18:51+00:00,JavaJimmyMaukar,gue jadi Poliglot negara burung hantu  ini,1,0,0,382,https://x.com/JavaJimmyMaukar/status/1968666027094327668,https://x.com/IndoPopBase/status/1968664468285702523,1
2025-09-18 13:22:15+00:00,michh_eth,GEMOY!!!,0,0,0,120,https://x.com/michh_eth/status/1968666884108112274,https://x.com/IndoPopBase/status/1968664468285702523,0
2025-09-18 13:28:40+00:00,ursteulyNaveen,,0,0,0,80,https://x.com/ursteulyNaveen/status/1968668498055270554,https://x.com/IndoPopBase/status/1968664468285702523,0
2025-09-18 13:17:03+00:00,Kryptonomanos,HahahahA anjayani,0,0,0,140,https://x.com/Kryptonomanos/status/1968665575128789450,https://x.com/IndoPopBase/status/1968664468285702523,0
2025-09-18 13:44:11+00:00,Th3Tr4vel3r,So cute,0,0,0,99,https://x.com/Th3Tr4vel3r/status/1968672401882841401,https://x.com/IndoPopBase/status/1968664468285702523,0
2025-09-16 06:55:58+00:00,SaddamWeb3,happy birthday legend,0,0,0,362,https://x.com/SaddamWeb3/status/1967844893751197780,https://x.com/IndoPopBase/status/1967844781230530794,0
2025-09-16 09:45:28+00:00,0xHarryry,Happy birthday Legend ,0,0,0,371,https://x.com/0xHarryry/status/1967887552612098102,https://x.com/IndoPopBase/status/1967844781230530794,0
2025-09-16 06:55:52+00:00,widzeth,Crrisye udah 76? Wow happy bday!,0,0,0,296,https://x.com/widzeth/status/1967844869558374892,https://x.com/IndoPopBase/status/1967844781230530794,0
2025-09-16 06:56:33+00:00,AnnafiBG,"HBD Almarhum Chrisye! 

Btw, lagu C.H.R.I.S.Y.E itu tentang beliau ya? Atau ciptaan beliau?",2,0,0,943,https://x.com/AnnafiBG/status/1967845040522506698,https://x.com/IndoPopBase/status/1967844781230530794,2
2025-09-16 06:57:47+00:00,ursteulyNaveen,"His music will forever live in our hearts  Happy heavenly birthday, legend ",0,0,0,534,https://x.com/ursteulyNaveen/status/1967845353476243633,https://x.com/IndoPopBase/status/1967844781230530794,0
2025-09-16 06:55:47+00:00,sugar_6378,HAPPY BDAY LAGIIIII!!!,0,0,0,384,https://x.com/sugar_6378/status/1967844850419798473,https://x.com/IndoPopBase/status/1967844781230530794,0
2025-09-16 07:12:39+00:00,MindaXtv,Wah samaan dengan Ariel Noah berarti ya?,0,0,0,503,https://x.com/MindaXtv/status/1967849092060750207,https://x.com/IndoPopBase/status/1967844781230530794,0
2025-09-16 15:25:30+00:00,is_pelssy,Alfatihah om Chris,0,0,0,151,https://x.com/is_pelssy/status/1967973125154541769,https://x.com/IndoPopBase/status/1967844781230530794,0
2025-09-16 06:57:05+00:00,KYY_NFT_,happy birthday legend,0,0,0,442,https://x.com/KYY_NFT_/status/1967845174849204615,https://x.com/IndoPopBase/status/1967844781230530794,0
2025-09-16 07:41:51+00:00,Sugilico3,Wah Legend Indo ini. Lagu favorit kalian apa? Kl aku Kisah Kasih di Sekolah,0,0,0,474,https://x.com/Sugilico3/status/1967856443065032743,https://x.com/IndoPopBase/status/1967844781230530794,0
2025-09-16 07:56:13+00:00,0xRo3r,HBD LEGEND….,0,0,0,331,https://x.com/0xRo3r/status/1967860056508236178,https://x.com/IndoPopBase/status/1967844781230530794,0
2025-09-16 06:55:56+00:00,michh_eth,SELAMAT ULANG TAHUN MALU AKU MALU PADA SEMUT MERAH!!!,0,0,0,304,https://x.com/michh_eth/status/1967844888994775407,https://x.com/IndoPopBase/status/1967844781230530794,0
2025-09-16 15:18:16+00:00,yogishdw,"Bertumbuh dengan karya2 beliau
Paling favorit dengerin “Kala Surya Tenggelam” dan ngedengerinnya waktu maghrib

Every note of this song gives me goosebumps. It’s like the music is casting a spell 
Idk, there’s just something magical

Anw, happy birthday om ",0,0,0,80,https://x.com/yogishdw/status/1967971304298205635,https://x.com/IndoPopBase/status/1967844781230530794,0
2025-09-16 06:57:13+00:00,vermillonblue,"Happy Birthday, Legend! And Rest In Peace.. terima kasih untuk semua mahakarya yang luar biasa",1,0,0,176,https://x.com/vermillonblue/status/1967845211830358359,https://x.com/IndoPopBase/status/1967844781230530794,1
2025-09-16 10:31:38+00:00,zingwind,"The real legend.

Suara khasnya beliau sampai sekarang gak ada yg bisa meniru.",0,0,0,69,https://x.com/zingwind/status/1967899170834104478,https://x.com/IndoPopBase/status/1967844781230530794,0
2025-09-16 10:11:56+00:00,firzafp,"Lauw Peng Liang (1949-2007) - The Smokey x Lionel Richie of Chindo

Definitif penting di era musik Indo ""City Pop des Indes (1980-88)""",0,0,0,112,https://x.com/firzafp/status/1967894211493237144,https://x.com/IndoPopBase/status/1967844781230530794,0
2025-09-16 09:27:53+00:00,·,,0,0,0,57,https://x.com/nami_singkat/status/1967883125511557389,https://x.com/IndoPopBase/status/1967844781230530794,0
2025-09-16 07:37:46+00:00,roweeasley,"Hbd legend, missing your masterpiece. Lirih will my forever jam.",0,0,0,105,https://x.com/roweeasley/status/1967855416039375310,https://x.com/IndoPopBase/status/1967844781230530794,0
2025-09-16 10:59:35+00:00,yhoxcendolz,Terimakasih Eros Djarot dan James F Sundah yang sudah mempercayakan lagunya kepada mendiang sehingga mendiang akhirnya dikenal sebagai legenda musik Indonesia hingga akhir hayatnya,0,0,0,74,https://x.com/yhoxcendolz/status/1967906204711268765,https://x.com/IndoPopBase/status/1967844781230530794,0
2025-09-16 07:13:18+00:00,BYTEHEARTT,stream,0,0,0,19,https://x.com/BYTEHEARTT/status/1967849258595619135,https://x.com/IndoPopBase/status/1967844781230530794,0
2025-09-16 07:18:28+00:00,hitmealone,SERTA MULIA LEGEND!,0,0,0,96,https://x.com/hitmealone/status/1967850558070591840,https://x.com/IndoPopBase/status/1967844781230530794,0
2025-09-16 09:27:39+00:00,firman2030,Solois bertaburan hits kalo masih konser kurasa masih nambah pendengar baru dan mungkin 11 12 dng dewa,0,0,0,58,https://x.com/firman2030/status/1967883069119234369,https://x.com/IndoPopBase/status/1967844781230530794,0
2025-09-16 08:01:18+00:00,Gevra_,HBD Legend,0,0,0,60,https://x.com/Gevra_/status/1967861338254016833,https://x.com/IndoPopBase/status/1967844781230530794,0
2025-09-16 13:16:55+00:00,Selembarkrtas,Wdym Would've?,0,0,0,37,https://x.com/Selembarkrtas/status/1967940763955900713,https://x.com/IndoPopBase/status/1967844781230530794,0
2025-09-17 03:07:31+00:00,heylisya,birthday Legend,0,0,0,28,https://x.com/heylisya/status/1968149792053502248,https://x.com/IndoPopBase/status/1967844781230530794,0
2025-09-16 09:01:23+00:00,irhan_my,Sedih saat mengetahui istri Alm. Harus menjual koleksi untuk menyambung hidup,1,0,0,109,https://x.com/irhan_my/status/1967876455632867592,https://x.com/IndoPopBase/status/1967844781230530794,1
2025-09-16 08:17:44+00:00,irvxan,The greatest.,0,0,0,86,https://x.com/irvxan/status/1967865471837127144,https://x.com/IndoPopBase/status/1967844781230530794,0
2025-09-16 07:11:45+00:00,airdrop_goe,Hbd legend,0,0,0,407,https://x.com/airdrop_goe/status/1967848866314870954,https://x.com/IndoPopBase/status/1967844781230530794,0
2025-09-16 06:56:54+00:00,VHICKKYHAEYWHY,HBD  Legend,0,0,0,96,https://x.com/VHICKKYHAEYWHY/status/1967845129500364970,https://x.com/IndoPopBase/status/1967844781230530794,0
2025-09-16 06:59:28+00:00,Kryptonomanos,Selamat ulang tahun Pak De,0,0,0,301,https://x.com/Kryptonomanos/status/1967845774857052442,https://x.com/IndoPopBase/status/1967844781230530794,0
2025-09-16 07:19:24+00:00,deethemedia,"fotonya yg kiri mirip pak Mandra.
Ganteng ",0,0,0,70,https://x.com/deethemedia/status/1967850791898931593,https://x.com/IndoPopBase/status/1967844781230530794,0
2025-09-16 06:43:18+00:00,0x_PingPing,Dua diva dari negara berbeda !!,0,0,0,210,https://x.com/0x_PingPing/status/1967841706440790388,https://x.com/IndoPopBase/status/1967826950808015020,0
2025-09-16 05:47:20+00:00,widzeth,Mereka sodara ya?,1,0,0,460,https://x.com/widzeth/status/1967827624711078367,https://x.com/IndoPopBase/status/1967826950808015020,1
2025-09-16 05:50:31+00:00,Sitizen11,"Keduanya “Ratu”!!!!!

Siti Nurhaliza bersinar di panggung Pestapora ahhhhhh benar-benar elegan dan penuh talenta! ",0,11,0,2231,https://x.com/Sitizen11/status/1967828424413810857,https://x.com/IndoPopBase/status/1967826950808015020,11
2025-09-16 06:38:13+00:00,BAD_ARSILA,"Rossa was among the thousands at Genting, witnessing Siti Nurhaliza’s breathtaking performance that earned a standing ovation, and where Siti was honored with the industry’s highest recognition, the Sri Wirama Award at #AIM24 ",0,10,0,1655,https://x.com/BAD_ARSILA/status/1967840427924767129,https://x.com/IndoPopBase/status/1967826950808015020,10
2025-09-16 05:48:29+00:00,potsuyaa,"i really hate all the blue check reply, omg",1,0,0,1335,https://x.com/potsuyaa/status/1967827912813691304,https://x.com/IndoPopBase/status/1967826950808015020,1
2025-09-16 06:01:19+00:00,mintzyrinae,when a diva meets another diva to maximize their joint slayy,0,0,0,1067,https://x.com/mintzyrinae/status/1967831141362307448,https://x.com/IndoPopBase/status/1967826950808015020,0
2025-09-16 05:58:24+00:00,andreyjaya,Both queens of ASEAN,0,0,0,847,https://x.com/andreyjaya/status/1967830408575520886,https://x.com/IndoPopBase/status/1967826950808015020,0
2025-09-16 06:19:41+00:00,B4n6_H4n5,"Seperti kakak dan adik... 
Dan suaranya juga sama sama oke..",0,0,0,418,https://x.com/B4n6_H4n5/status/1967835762956902495,https://x.com/IndoPopBase/status/1967826950808015020,0
2025-09-16 05:46:45+00:00,ursteulyNaveen,Dua ratu bersinar di satu panggung benar-benar elegan dan penuh talenta! ,0,1,0,404,https://x.com/ursteulyNaveen/status/1967827476408881518,https://x.com/IndoPopBase/status/1967826950808015020,1
2025-09-16 06:01:56+00:00,bxhtivr,mereka gak menua njir,0,0,0,484,https://x.com/bxhtivr/status/1967831299223327139,https://x.com/IndoPopBase/status/1967826950808015020,0
2025-09-16 10:20:46+00:00,Alexx1992xx,Bertanya dengan nada dering! Knpa anggun dan siti nurhaliza saling unfollow di instagram?,0,0,0,338,https://x.com/Alexx1992xx/status/1967896434134618335,https://x.com/IndoPopBase/status/1967826950808015020,0
2025-09-16 07:21:36+00:00,MindaXtv,Tahniah Dato' Siti Nurhaliza from Dato' Sri Rossa,0,1,0,705,https://x.com/MindaXtv/status/1967851346503274942,https://x.com/IndoPopBase/status/1967826950808015020,1
2025-09-16 05:45:04+00:00,AnnafiBG,Lho baru tau Rossa namanya ada ‘Dato’ nya,1,0,0,510,https://x.com/AnnafiBG/status/1967827052490584161,https://x.com/IndoPopBase/status/1967826950808015020,1
2025-09-16 05:49:04+00:00,moodjianto,and Gracia?,0,0,0,527,https://x.com/moodjianto/status/1967828060436304208,https://x.com/IndoPopBase/status/1967826950808015020,0
2025-09-16 05:47:12+00:00,KYY_NFT_,"@grok
 sejak kapan Rossa memiliki title dato?",1,0,0,467,https://x.com/KYY_NFT_/status/1967827591605391368,https://x.com/IndoPopBase/status/1967826950808015020,1
2025-09-16 05:57:45+00:00,Yeni_Puu,Aw  teh oca ma kak iti ,0,0,0,372,https://x.com/Yeni_Puu/status/1967830244498579635,https://x.com/IndoPopBase/status/1967826950808015020,0
2025-09-16 05:54:59+00:00,_bbbfemoes,And nothing for Iyeth Floptami?,0,0,0,707,https://x.com/_bbbfemoes/status/1967829549691097472,https://x.com/IndoPopBase/status/1967826950808015020,0
2025-09-16 05:51:04+00:00,OynRetriever,WE BELIEVE IN THESE RATUS REIGN,0,0,0,286,https://x.com/OynRetriever/status/1967828562393829433,https://x.com/IndoPopBase/status/1967826950808015020,0
2025-09-16 07:05:07+00:00,IJBOLINI,and peoples fave mulan jameela?,0,0,0,427,https://x.com/IJBOLINI/status/1967847196688261395,https://x.com/IndoPopBase/status/1967826950808015020,0
2025-09-16 05:51:58+00:00,desinisme,siapa yg dulu mikirnya mereka adalah 1 orang yg sama? ,0,0,0,698,https://x.com/desinisme/status/1967828787816710530,https://x.com/IndoPopBase/status/1967826950808015020,0
2025-09-16 08:21:15+00:00,Sugilico3,Teh Rossa dapat gelar kehormatan kah dari Malaysia?,1,0,0,434,https://x.com/Sugilico3/status/1967866355992134068,https://x.com/IndoPopBase/status/1967826950808015020,1
2025-09-16 06:01:58+00:00,CitaStarstories,Suaranya bagus banget Teh Rossa dan Dato Siti,0,0,0,257,https://x.com/CitaStarstories/status/1967831307641397334,https://x.com/IndoPopBase/status/1967826950808015020,0
2025-09-16 06:38:19+00:00,0xRo3r,"@grok
 siapa mereka berdua ?",1,0,0,194,https://x.com/0xRo3r/status/1967840454948602132,https://x.com/IndoPopBase/status/1967826950808015020,1
2025-09-16 05:45:09+00:00,boranoona_,Loh orang malaysia emg tau Rossa?,7,0,0,1255,https://x.com/boranoona_/status/1967827073973751833,https://x.com/IndoPopBase/status/1967826950808015020,7
2025-09-16 05:48:05+00:00,michh_eth,OH BARU TAU TEH OCA DARI MALAYSIA JUGA. Bisa jadi dato,0,0,0,218,https://x.com/michh_eth/status/1967827812343333068,https://x.com/IndoPopBase/status/1967826950808015020,0
2025-09-16 05:53:51+00:00,indrarg77,datookkk,0,0,0,239,https://x.com/indrarg77/status/1967829262398054703,https://x.com/IndoPopBase/status/1967826950808015020,0
2025-09-16 05:48:02+00:00,airdrop_goe,Lah baru tau,0,0,0,233,https://x.com/airdrop_goe/status/1967827797591904398,https://x.com/IndoPopBase/status/1967826950808015020,0
2025-09-16 05:45:28+00:00,Th3Tr4vel3r,ini sih Divanya ASEAN,0,0,0,285,https://x.com/Th3Tr4vel3r/status/1967827152314994989,https://x.com/IndoPopBase/status/1967826950808015020,0
2025-09-16 06:12:14+00:00,VHICKKYHAEYWHY,Queens ,0,0,0,107,https://x.com/VHICKKYHAEYWHY/status/1967833890393035030,https://x.com/IndoPopBase/status/1967826950808015020,0
2025-09-16 05:23:35+00:00,Mr_Siomay,"@grok
 novia bachmid siapa? Ad hubungan saudara ma irfan bachdim?",5,2,0,18915,https://x.com/Mr_Siomay/status/1967821644426272790,https://x.com/IndoPopBase/status/1967820861026803887,7
2025-09-16 05:32:01+00:00,VVYND,She gotta make bangers like this,0,0,0,1789,https://x.com/VVYND/status/1967823767197061529,https://x.com/IndoPopBase/status/1967820861026803887,0
2025-09-16 05:47:33+00:00,widzeth,Mirip rihanna,0,0,0,6949,https://x.com/widzeth/status/1967827675814522956,https://x.com/IndoPopBase/status/1967820861026803887,0
2025-09-16 05:21:04+00:00,michh_eth,Novia bachmid orang indo? Gila auranya kek orang bule,5,2,0,19988,https://x.com/michh_eth/status/1967821014265631019,https://x.com/IndoPopBase/status/1967820861026803887,7
2025-09-16 07:37:14+00:00,iseeyougo_,"Been saying this since her idol’s days, that novia has the potential to be bigger artist…i mean her voice and visual quality is just world class ig???",0,2,0,3036,https://x.com/iseeyougo_/status/1967855280466825483,https://x.com/IndoPopBase/status/1967820861026803887,2
2025-09-16 05:22:52+00:00,Regiefelicia,Gokil suara sama orangnya cakep semua,0,0,0,11480,https://x.com/Regiefelicia/status/1967821467397263741,https://x.com/IndoPopBase/status/1967820861026803887,0
2025-09-16 07:39:38+00:00,dontolicious_,"Hate comment ke dia ni dipaksain banget perasaan, menurutku dia ok banget padahal",0,1,0,1159,https://x.com/dontolicious_/status/1967855882513027262,https://x.com/IndoPopBase/status/1967820861026803887,1
2025-09-16 07:31:17+00:00,subzerotea,I hate that indons paid her dust. And also we need new indon record labels and producers who can produce and promote these kind of artists properly. Or else indon music industry will always be stuck and regressive,0,2,0,3145,https://x.com/subzerotea/status/1967853783909798189,https://x.com/IndoPopBase/status/1967820861026803887,2
2025-09-16 06:13:15+00:00,PROSPERDEGREAT,Rihanna vocals with TikTok energy is a combo nobody saw coming,0,0,0,12746,https://x.com/PROSPERDEGREAT/status/1967834146316882232,https://x.com/IndoPopBase/status/1967820861026803887,0
2025-09-16 06:46:44+00:00,dudionline,"Jujur, dia laik berada di panggung internasional dan dapat atensi dari penikmat musik dari seluruh dunia.
Paket lengkap!",0,0,0,1722,https://x.com/dudionline/status/1967842572061331614,https://x.com/IndoPopBase/status/1967820861026803887,0
2025-09-16 08:03:08+00:00,esthergrldn,such a queen,0,0,0,12580,https://x.com/esthergrldn/status/1967861797840638246,https://x.com/IndoPopBase/status/1967820861026803887,0
2025-09-16 07:03:40+00:00,ngonolohyu,Such a waste talent if you are in Indo ,0,0,0,1591,https://x.com/ngonolohyu/status/1967846833700606136,https://x.com/IndoPopBase/status/1967820861026803887,0
2025-09-16 05:26:43+00:00,wetdobi,these bots on your comment pmo,0,0,0,624,https://x.com/wetdobi/status/1967822433282560493,https://x.com/IndoPopBase/status/1967820861026803887,0
2025-09-16 10:14:52+00:00,vinshen95,dia ini sering bgt di hujat karna di anggap pick me. terutama oleh fans lyodra karna di anggap mau nyaingi lyodra ,3,2,0,4681,https://x.com/vinshen95/status/1967894952068911386,https://x.com/IndoPopBase/status/1967820861026803887,5
2025-09-16 06:35:59+00:00,barblinkz,aura go internationalnya kentel banget,1,0,0,1628,https://x.com/barblinkz/status/1967839865145593990,https://x.com/IndoPopBase/status/1967820861026803887,1
2025-09-17 02:24:10+00:00,MindaXtv,"I just remember Agnez Mo 
@agnezmo",0,0,0,3433,https://x.com/MindaXtv/status/1968138882496786773,https://x.com/IndoPopBase/status/1967820861026803887,0
2025-09-16 13:38:13+00:00,sitncere,never heard,0,0,0,305,https://x.com/sitncere/status/1967946125685690825,https://x.com/IndoPopBase/status/1967820861026803887,0
2025-09-17 04:46:56+00:00,MbemLover,"Indonesian Idol yg satu ini malah kalah ama Tiara Andini menuju final. Ga sampai final malah,sayang bangat kualitas suaranya emang.",0,0,0,223,https://x.com/MbemLover/status/1968174809310957906,https://x.com/IndoPopBase/status/1967820861026803887,0
2025-09-16 15:38:58+00:00,Kedutin,"More of her tahun 2021.
youtu.be/aKtb7Y3qOck

Emang seangkatan kok dengan Lyodra. Vokalnya beda, cuma biasalah, pada seneng aja ributin.",0,0,0,3273,https://x.com/Kedutin/status/1967976512113742242,https://x.com/IndoPopBase/status/1967820861026803887,0
2025-09-16 10:53:52+00:00,setanidol,Nuguvia bachMID aka z-list artist,1,0,0,325,https://x.com/setanidol/status/1967904764823474296,https://x.com/IndoPopBase/status/1967820861026803887,1
2025-09-16 05:55:42+00:00,Leonaderune,welcome back rihanna,0,0,0,303,https://x.com/Leonaderune/status/1967829727152050297,https://x.com/IndoPopBase/status/1967820861026803887,0
2025-09-17 03:28:23+00:00,angelsky265,cakep bgt woii,0,0,0,57,https://x.com/angelsky265/status/1968155041711485228,https://x.com/IndoPopBase/status/1967820861026803887,0
2025-09-17 02:14:47+00:00,hullajunee,"Ini orang udah cakep, suara bagus, pinter MasyaAllah! ",0,0,0,286,https://x.com/hullajunee/status/1968136520646414744,https://x.com/IndoPopBase/status/1967820861026803887,0
2025-09-16 10:23:14+00:00,360BYXCX,who?,0,0,0,172,https://x.com/360BYXCX/status/1967897056674287818,https://x.com/IndoPopBase/status/1967820861026803887,0
2025-09-16 12:01:17+00:00,·,"Novvvviiiiaaaaa aku fans berat
U!!! Titik dari awal ngikutin bgt sekarang makin makin  so so georgeous",0,0,0,744,https://x.com/sweetcuros/status/1967921730187563096,https://x.com/IndoPopBase/status/1967820861026803887,0
2025-09-17 07:46:29+00:00,Kentangbiru96,Cakep bener ni orgg,0,0,0,46,https://x.com/Kentangbiru96/status/1968219997039411454,https://x.com/IndoPopBase/status/1967820861026803887,0
2025-09-16 06:12:49+00:00,PROSPERDEGREAT,Rihanna would definitely hit the like button on this one,0,0,0,12005,https://x.com/PROSPERDEGREAT/status/1967834036828836137,https://x.com/IndoPopBase/status/1967820861026803887,0
2025-09-16 10:49:42+00:00,citrusiflora,cakep bgtt gw kira sevyn streeter,0,0,0,660,https://x.com/citrusiflora/status/1967903715966509292,https://x.com/IndoPopBase/status/1967820861026803887,0
2025-09-16 15:47:58+00:00,svetlherze,Oemjiii supeerrr wow wow ,0,0,0,151,https://x.com/svetlherze/status/1967978777264394326,https://x.com/IndoPopBase/status/1967820861026803887,0
2025-09-16 06:29:09+00:00,allaboutzoooo,oh novia the beyonce you are,0,0,0,947,https://x.com/allaboutzoooo/status/1967838147406156245,https://x.com/IndoPopBase/status/1967820861026803887,0
2025-09-16 11:12:55+00:00,83fitriana,"Aku pernah ketemu langsung sampe fotbar kemarin di Lalala Fest. Cantik banget, sama kayak di internet / tv ",0,0,0,1162,https://x.com/83fitriana/status/1967909558082478348,https://x.com/IndoPopBase/status/1967820861026803887,0
2025-09-16 16:20:23+00:00,kpkris6plus1,girlie needs to make music more,0,0,0,293,https://x.com/kpkris6plus1/status/1967986936393634130,https://x.com/IndoPopBase/status/1967820861026803887,0
2025-09-17 16:10:28+00:00,arnhyunn,so stunning,0,0,0,11,https://x.com/arnhyunn/status/1968346828447121905,https://x.com/IndoPopBase/status/1967820861026803887,0
2025-09-16 16:02:06+00:00,qieeeeel,Heran novia bagus bgt suaranya,0,0,0,109,https://x.com/qieeeeel/status/1967982334285885813,https://x.com/IndoPopBase/status/1967820861026803887,0
2025-09-17 04:27:10+00:00,my_sartika,Lama2 celana dipake di paha...,0,0,0,145,https://x.com/my_sartika/status/1968169834509897739,https://x.com/IndoPopBase/status/1967820861026803887,0
2025-09-17 05:04:37+00:00,tiramissyoukek,"Suara nya bagus, tp single dia kenapa gada satupun yang melejit ya?",0,0,0,185,https://x.com/tiramissyoukek/status/1968179260834938924,https://x.com/IndoPopBase/status/1967820861026803887,0
2025-09-17 02:39:58+00:00,·,Baguusss bgtttt,0,0,0,72,https://x.com/kittypurry36/status/1968142857556144176,https://x.com/IndoPopBase/status/1967820861026803887,0
2025-09-16 15:15:39+00:00,slzhffktm_,Diva,0,0,0,199,https://x.com/slzhffktm_/status/1967970645444304990,https://x.com/IndoPopBase/status/1967820861026803887,0
2025-09-17 02:33:26+00:00,ausybun,shes’s way too goood at singing tp knp dihujat sm org2 di app sebelah ya,0,0,0,18,https://x.com/ausybun/status/1968141214286545128,https://x.com/IndoPopBase/status/1967820861026803887,0
2025-09-16 09:48:08+00:00,brooklynbrick89,Ketek lu noh abu abu,0,0,0,303,https://x.com/brooklynbrick89/status/1967888223658709476,https://x.com/IndoPopBase/status/1967820861026803887,0
2025-09-16 10:50:37+00:00,feliciaaaaa99,"ini muka² kedemenan bule bgt 
cantik bgt buset",0,0,0,482,https://x.com/feliciaaaaa99/status/1967903945382322659,https://x.com/IndoPopBase/status/1967820861026803887,0
2025-09-16 08:25:31+00:00,RobertMoltoJr,Au eh Noviaaa.. So sama deng barat2 ngana eehhh..,0,0,0,577,https://x.com/RobertMoltoJr/status/1967867433307476477,https://x.com/IndoPopBase/status/1967820861026803887,0
2025-09-16 16:23:49+00:00,radnaradno,"TBH, she's hot. I'm falling.",0,0,0,268,https://x.com/radnaradno/status/1967987797610074615,https://x.com/IndoPopBase/status/1967820861026803887,0
2025-09-16 19:47:25+00:00,·,Sibuk bener hairstylistnya ketimbang DPR.,0,0,0,256,https://x.com/Flashovre/status/1968039037836681295,https://x.com/IndoPopBase/status/1967820861026803887,0
2025-09-17 01:46:39+00:00,EdgarSandy77,Cantikk bg doi ,0,0,0,114,https://x.com/EdgarSandy77/status/1968129441705627799,https://x.com/IndoPopBase/status/1967820861026803887,0
2025-09-16 14:44:05+00:00,icacacapedehhh,tapi di tiktok malah dihujat gaes,0,0,0,854,https://x.com/icacacapedehhh/status/1967962701696733351,https://x.com/IndoPopBase/status/1967820861026803887,0
2025-09-16 17:38:41+00:00,nuraryanifitri,Aduh cakep bgttt,0,0,0,182,https://x.com/nuraryanifitri/status/1968006639493247240,https://x.com/IndoPopBase/status/1967820861026803887,0
2025-09-17 00:38:53+00:00,levoski80,"Yg ga tau novia pasti pendukung anies semua, emang setua dan setaik itu mreka, kabuuurrrr ",3,0,0,1052,https://x.com/levoski80/status/1968112388189864018,https://x.com/IndoPopBase/status/1967820861026803887,3
2025-09-16 05:53:47+00:00,itsmeabiyy,suaranya bagus banget kayak ada special effectnya gitu,0,0,0,1314,https://x.com/itsmeabiyy/status/1967829247202103318,https://x.com/IndoPopBase/status/1967820861026803887,0
2025-09-17 01:35:28+00:00,unveilsthen,"suaranya cakep, orangnya cakeppp",0,0,0,89,https://x.com/unveilsthen/status/1968126627357077916,https://x.com/IndoPopBase/status/1967820861026803887,0
2025-09-16 04:40:29+00:00,Mr_Siomay,"Penasaran 
@grok
 ariel tuh mantannya ada brapa yah? Siapa aja?",3,0,0,1007,https://x.com/Mr_Siomay/status/1967810801861030135,https://x.com/IndoPopBase/status/1967810422570127503,3
2025-09-16 06:09:07+00:00,sugar_6378,"Menurutku, lagunya lebih bagus waktu mereka masih peterpan deh, sebelom Noah.

""Ku katakan dengan indah""",0,0,0,360,https://x.com/sugar_6378/status/1967833103625515491,https://x.com/IndoPopBase/status/1967810422570127503,0
2025-09-16 05:26:42+00:00,unkenwon,kapan lagi ?,0,0,0,255,https://x.com/unkenwon/status/1967822431743307840,https://x.com/IndoPopBase/status/1967810422570127503,0
2025-09-16 05:03:38+00:00,bareda,"David NOAH and Andika Peterpan went to a same high school, same graduation year. Guess what year and what school?",2,0,0,713,https://x.com/bareda/status/1967816625220132895,https://x.com/IndoPopBase/status/1967810422570127503,2
2025-09-16 04:42:06+00:00,ursteulyNaveen,Can’t believe it’s been 13 years already - that album still feels fresh every time I listen to it.,1,0,0,538,https://x.com/ursteulyNaveen/status/1967811205122396381,https://x.com/IndoPopBase/status/1967810422570127503,1
2025-09-16 04:40:01+00:00,AnnafiBG,"Emang sebelum ‘NOAH’ nama band nya apa? 
@grok",2,0,0,636,https://x.com/AnnafiBG/status/1967810682122055942,https://x.com/IndoPopBase/status/1967810422570127503,2
2025-09-16 05:21:19+00:00,Regiefelicia,Nostaligia ini lagu paling enak sih,0,0,0,319,https://x.com/Regiefelicia/status/1967821075112501645,https://x.com/IndoPopBase/status/1967810422570127503,0
2025-09-16 05:17:05+00:00,michh_eth,"Apakah benar ariel pernah sama cut tari? 
@grok",1,0,0,798,https://x.com/michh_eth/status/1967820010329674109,https://x.com/IndoPopBase/status/1967810422570127503,1
2025-09-16 05:34:51+00:00,firzafp,"*Album ke-4, comeback PeterPan sbg NOAH
Seperti Exist rebrand Exists",0,0,0,172,https://x.com/firzafp/status/1967824481117933902,https://x.com/IndoPopBase/status/1967810422570127503,0
2025-09-16 06:19:07+00:00,WirantiZar34462,"Hbd bang bor 
@R_besar
 ",0,0,0,57,https://x.com/WirantiZar34462/status/1967835623286579293,https://x.com/IndoPopBase/status/1967810422570127503,0
2025-09-16 15:51:16+00:00,roseslike_rosie,goat album,0,0,0,61,https://x.com/roseslike_rosie/status/1967979608076337531,https://x.com/IndoPopBase/status/1967810422570127503,0
2025-09-16 09:29:10+00:00,Anti_Takhayul,"Ariel bebas Boyband tewas
benar-benar jadi kenyataan ",0,0,0,140,https://x.com/Anti_Takhayul/status/1967883448301003092,https://x.com/IndoPopBase/status/1967810422570127503,0
2025-09-16 05:04:28+00:00,MrNobody_107,Terbangun Sendiri fav underrated,0,0,0,194,https://x.com/MrNobody_107/status/1967816836902424626,https://x.com/IndoPopBase/status/1967810422570127503,0
2025-09-16 07:57:26+00:00,mochnwr,Album terbaik NOAH,0,0,0,130,https://x.com/mochnwr/status/1967860365901074669,https://x.com/IndoPopBase/status/1967810422570127503,0
2025-09-16 13:16:45+00:00,·,One of the best album ever fr,0,0,0,81,https://x.com/Seazured/status/1967940723296383081,https://x.com/IndoPopBase/status/1967810422570127503,0
2025-09-16 11:03:53+00:00,mtpradhana,"Semua album di lagu ini bagus semua, bener-bener super album!",0,0,0,121,https://x.com/mtpradhana/status/1967907286644613410,https://x.com/IndoPopBase/status/1967810422570127503,0
2025-09-16 05:09:05+00:00,yeageristis,End the boyband era.,0,0,0,192,https://x.com/yeageristis/status/1967817997495701866,https://x.com/IndoPopBase/status/1967810422570127503,0
2025-09-16 04:47:14+00:00,JavaJimmyMaukar,peak.,0,0,0,188,https://x.com/JavaJimmyMaukar/status/1967812496661811543,https://x.com/IndoPopBase/status/1967810422570127503,0
2025-09-16 04:46:46+00:00,JavaJimmyMaukar,AKU HIDUP UNTUKMU AKU MATI TANPAMU,0,0,0,197,https://x.com/JavaJimmyMaukar/status/1967812382308306995,https://x.com/IndoPopBase/status/1967810422570127503,0
2025-09-16 14:41:40+00:00,sketxhyf,Dulu pernah dapat album ini di KFC ,0,0,0,84,https://x.com/sketxhyf/status/1967962093036114031,https://x.com/IndoPopBase/status/1967810422570127503,0
2025-09-16 04:42:10+00:00,Kryptonomanos,Wah jadi serasa hidup lagi di masa lampau,0,0,0,414,https://x.com/Kryptonomanos/status/1967811223115928069,https://x.com/IndoPopBase/status/1967810422570127503,0
2025-09-16 04:50:44+00:00,airdrop_goe,Wah kesukaan ku dulu ini,0,0,0,326,https://x.com/airdrop_goe/status/1967813379797717276,https://x.com/IndoPopBase/status/1967810422570127503,0
2025-09-16 04:49:55+00:00,VHICKKYHAEYWHY,そしてそれは今日でも興味深い,0,0,0,158,https://x.com/VHICKKYHAEYWHY/status/1967813175350624549,https://x.com/IndoPopBase/status/1967810422570127503,0
2025-09-16 05:47:24+00:00,Th3Tr4vel3r,"ariel kenapa tidak ikut comeback sama peterpan / noah 
@grok
 ?",1,0,0,587,https://x.com/Th3Tr4vel3r/status/1967827639953154475,https://x.com/IndoPopBase/status/1967810422570127503,1
2025-09-16 10:41:46+00:00,robinstrathi,"Yang mau koleksi CDnya, eh tapi sudah gak jamannya ya",0,0,0,92,https://x.com/robinstrathi/status/1967901719763034601,https://x.com/IndoPopBase/status/1967810422570127503,0
2025-09-15 12:52:39+00:00,roweeasley,"Mengurangi hoax, tapi buzzer dipelihara gimana konsepnya anjir.",1,24,0,5671,https://x.com/roweeasley/status/1967572269460603298,https://x.com/IndoPopBase/status/1967569203726373335,25
2025-09-15 12:57:18+00:00,SaddamWeb3,"lol just heard about this dude
already acting like the fuckin internet boss dealing with dumb shit",0,0,0,111,https://x.com/SaddamWeb3/status/1967573438119522510,https://x.com/IndoPopBase/status/1967569203726373335,0
2025-09-15 12:42:40+00:00,dontolicious_,Flop ministers with their flop thoughts,0,0,0,2373,https://x.com/dontolicious_/status/1967569758553043170,https://x.com/IndoPopBase/status/1967569203726373335,0
2025-09-15 12:48:01+00:00,pruciaa,lu mending blokir judol dah,1,0,0,2812,https://x.com/pruciaa/status/1967571105784467516,https://x.com/IndoPopBase/status/1967569203726373335,1
2025-09-15 12:42:53+00:00,beautiaf,"apasih, mending urusin yg lain aja mending ilangin buzzer-buzzer pemerintah dh kalo kata gw",1,0,0,2381,https://x.com/beautiaf/status/1967569811426480411,https://x.com/IndoPopBase/status/1967569203726373335,1
2025-09-15 12:48:27+00:00,lostranslation5,boomer ngerti apasih anjir,1,2,0,2702,https://x.com/lostranslation5/status/1967571212743381063,https://x.com/IndoPopBase/status/1967569203726373335,3
2025-09-15 13:39:49+00:00,·,"Caranya gimana ya pak? Mengingat,
1. Create akun sosmed bisa pake email, sedangkan email itu one to many. Satu orang bisa punya banyak email.
2. Mau di-lock by NIK kah? Kalau ini bener, omg 

Gada cara lain ya dari pak wapres yg ahli AI?",1,1,0,2970,https://x.com/iceicebbyvda/status/1967584140800463220,https://x.com/IndoPopBase/status/1967569203726373335,2
2025-09-15 13:25:12+00:00,mbahkieso,....,0,3,0,2772,https://x.com/mbahkieso/status/1967580461145936073,https://x.com/IndoPopBase/status/1967569203726373335,3
2025-09-15 13:57:54+00:00,tukismind,"Satu data? Mending jadiin sekalian mobile number portability aj! Kl salah satu tujuannya ngurangin penipuan, spamming, scamming. Jd orang ga perlu punya bnyk nomer telepon.",0,0,0,1446,https://x.com/tukismind/status/1967588692522123355,https://x.com/IndoPopBase/status/1967569203726373335,0
2025-09-15 13:45:11+00:00,Kashif5955,Ini beneran gak sih?,0,0,0,2,https://x.com/Kashif5955/status/1967585491634827500,https://x.com/IndoPopBase/status/1967569203726373335,0
2025-09-16 00:25:47+00:00,addmand_,"x.com/narabahasa/sta
…",0,0,0,3,https://x.com/addmand_/status/1967746704171733053,https://x.com/IndoPopBase/status/1967569203726373335,0
2025-09-16 00:18:58+00:00,addmand_,,0,0,0,9,https://x.com/addmand_/status/1967744987384381539,https://x.com/IndoPopBase/status/1967569203726373335,0
2025-09-15 16:20:43+00:00,ShandyHarahap,Apanya yg mengurangi? Kalian saja pelihara bajer.,0,0,0,32,https://x.com/ShandyHarahap/status/1967624631906689160,https://x.com/IndoPopBase/status/1967569203726373335,0
2025-09-15 12:56:21+00:00,grumpyygirl,((kecuali untuk buzzer)),0,0,0,323,https://x.com/grumpyygirl/status/1967573200960917529,https://x.com/IndoPopBase/status/1967569203726373335,0
2025-09-15 23:37:16+00:00,PanakBebinjat,Lu pengen kayak di Nepal? Because this is how it's started,0,0,0,62,https://x.com/PanakBebinjat/status/1967734493974061553,https://x.com/IndoPopBase/status/1967569203726373335,0
2025-09-15 13:11:17+00:00,MyfavMeerkat,Judol pak judol. Jgn sibuk nangkepin rakyat doang tp mafia dilindungi.,0,0,0,278,https://x.com/MyfavMeerkat/status/1967576957660619079,https://x.com/IndoPopBase/status/1967569203726373335,0
2025-09-15 12:56:51+00:00,DatoSriRossa,Why so jobless?,0,0,0,303,https://x.com/DatoSriRossa/status/1967573328602018028,https://x.com/IndoPopBase/status/1967569203726373335,0
2025-09-15 13:28:20+00:00,AikHoki,bukan ahli data it,0,0,0,42,https://x.com/AikHoki/status/1967581250505576889,https://x.com/IndoPopBase/status/1967569203726373335,0
2025-09-15 12:41:43+00:00,gnaleflognaw,ribeettt ngentoott,1,0,0,1577,https://x.com/gnaleflognaw/status/1967569517036634518,https://x.com/IndoPopBase/status/1967569203726373335,1
2025-09-16 01:44:13+00:00,Masihbosenn,bang urus judol bang ngapain ngurusin akun sambat orang dah,0,0,0,89,https://x.com/Masihbosenn/status/1967766442218295420,https://x.com/IndoPopBase/status/1967569203726373335,0
2025-09-16 10:03:36+00:00,saenju,Bacooot,0,0,0,8,https://x.com/saenju/status/1967892115637276691,https://x.com/IndoPopBase/status/1967569203726373335,0
2025-09-15 17:23:47+00:00,yrhiraeth,"coba gimana ngelola 1 org 1 akun mau ngedatanya pake apa? pasti ujungnya dan paling gampangnya pake ktp, jebol lagi aja data ktp kayak yg udah udah",0,0,0,240,https://x.com/yrhiraeth/status/1967640501202669610,https://x.com/IndoPopBase/status/1967569203726373335,0
2025-09-17 06:34:03+00:00,Selembarkrtas,"Alah data penduduk aja masih gratis di darlweb, pake mau one account one person pula. Terlalu banyak mimpi",0,0,0,13,https://x.com/Selembarkrtas/status/1968201768447381838,https://x.com/IndoPopBase/status/1967569203726373335,0
2025-09-15 13:11:02+00:00,WahonoGusti,lah kan info hoax dari kalian njing,0,0,0,120,https://x.com/WahonoGusti/status/1967576898197959049,https://x.com/IndoPopBase/status/1967569203726373335,0
2025-09-15 12:45:03+00:00,menjegal,gak puentingggg ciokkkkk,0,0,0,391,https://x.com/menjegal/status/1967570357537419590,https://x.com/IndoPopBase/status/1967569203726373335,0
2025-09-15 15:31:05+00:00,derandaj,Mana bisa diwujudkan. Golongan2 kerah putih ini masih banyak yg butuh buzzer di medsos hehe,0,0,0,371,https://x.com/derandaj/status/1967612141466452210,https://x.com/IndoPopBase/status/1967569203726373335,0
2025-09-15 18:12:26+00:00,ferdyuno,Nepal 2.0 incoming,0,0,0,75,https://x.com/ferdyuno/status/1967652744891863335,https://x.com/IndoPopBase/status/1967569203726373335,0
2025-09-15 16:00:46+00:00,WolfeyFoxxy,Mentri2 boomer bangke ini emang meski di nepalin sih,0,0,0,96,https://x.com/WolfeyFoxxy/status/1967619611010171041,https://x.com/IndoPopBase/status/1967569203726373335,0
2025-09-15 15:05:40+00:00,thepainsofbpatH,tai...gaguna...,0,0,0,37,https://x.com/thepainsofbpatH/status/1967605745404510702,https://x.com/IndoPopBase/status/1967569203726373335,0
2025-09-16 09:16:27+00:00,ohhmyshaylaa,Urusin noh judol,0,0,0,15,https://x.com/ohhmyshaylaa/status/1967880249464828060,https://x.com/IndoPopBase/status/1967569203726373335,0
2025-09-15 22:42:42+00:00,curiousfangs_,Nezar Patria siapa lagi ini ?. Sok asik banget.,0,0,0,67,https://x.com/curiousfangs_/status/1967720759012507892,https://x.com/IndoPopBase/status/1967569203726373335,0
2025-09-15 13:54:15+00:00,hugphobic,URUSIN JUDOL DULU BGST,0,0,0,72,https://x.com/hugphobic/status/1967587772937753049,https://x.com/IndoPopBase/status/1967569203726373335,0
2025-09-16 01:58:30+00:00,halffoodd,JUDOL WHEN????,0,0,0,71,https://x.com/halffoodd/status/1967770035889529142,https://x.com/IndoPopBase/status/1967569203726373335,0
2025-09-15 13:19:20+00:00,Rynshhdj,Kayak gnian kebijakan ga penting bgt ngurusin gnian!!!!! Plis gw mao pindah negara!!!! ,0,0,0,310,https://x.com/Rynshhdj/status/1967578984612524154,https://x.com/IndoPopBase/status/1967569203726373335,0
2025-09-16 00:36:57+00:00,uptoryan,Lucu terus,0,0,0,17,https://x.com/uptoryan/status/1967749513768288303,https://x.com/IndoPopBase/status/1967569203726373335,0
2025-09-15 14:56:53+00:00,·,"ngapain anjirrr, judol nohh judol",0,0,0,42,https://x.com/seltumbuhann/status/1967603533907366105,https://x.com/IndoPopBase/status/1967569203726373335,0
2025-09-15 13:05:19+00:00,·,"dibanding ngurus ginian, mending urus noh judol, lebih banyak mudharat nya",0,0,0,442,https://x.com/kusukaseries/status/1967575457798521249,https://x.com/IndoPopBase/status/1967569203726373335,0
2025-09-16 01:30:06+00:00,forthefirstday,nezar kawan lu yang hilang dimana nezar?????,0,0,0,37,https://x.com/forthefirstday/status/1967762887625294299,https://x.com/IndoPopBase/status/1967569203726373335,0
2025-09-15 13:42:58+00:00,baber168,"judol woy judol urusin, koruptor diurusin supaya hukumannya makin berat, apa sih ngurus2in hal2 yg gak penting kayak gini, makin gak guna aja kinerja kalian",0,0,0,752,https://x.com/baber168/status/1967584933045776415,https://x.com/IndoPopBase/status/1967569203726373335,0
2025-09-15 12:47:29+00:00,fikissme,Ngomong apa sih ,1,0,0,1492,https://x.com/fikissme/status/1967570969675079870,https://x.com/IndoPopBase/status/1967569203726373335,1
2025-09-15 22:34:41+00:00,becomingism,"Makin keliatan ya pejabat kita makin kesini gak bisa kerja, RESHUFFLE!",0,0,0,22,https://x.com/becomingism/status/1967718742995112383,https://x.com/IndoPopBase/status/1967569203726373335,0
2025-09-15 12:55:43+00:00,glimpseofregals,apaandah,1,0,0,240,https://x.com/glimpseofregals/status/1967573040386204153,https://x.com/IndoPopBase/status/1967569203726373335,1
2025-09-15 12:48:37+00:00,Danarrafa,,0,0,0,94,https://x.com/Danarrafa/status/1967571253675581930,https://x.com/IndoPopBase/status/1967569203726373335,0
2025-09-15 13:58:54+00:00,moodzfix,"rakyatnya 1 orang 1 akun biar gabisa bersuara banyak, buzzernya 1 orang 100 akun biar propaganda lancar",0,0,0,19,https://x.com/moodzfix/status/1967588942787862923,https://x.com/IndoPopBase/status/1967569203726373335,0
2025-09-15 12:45:15+00:00,BowAvenue,HAHAHAHAHAHAHAHHAHA,0,0,0,246,https://x.com/BowAvenue/status/1967570408439439448,https://x.com/IndoPopBase/status/1967569203726373335,0
2025-09-15 14:11:05+00:00,apagunanyayaya,Bangun pendidikan yg bener blog,0,0,0,110,https://x.com/apagunanyayaya/status/1967592009331572831,https://x.com/IndoPopBase/status/1967569203726373335,0
2025-09-15 13:41:35+00:00,pyonnsuke000320,Me who have more than one X account and many IG fanpages:,0,0,0,122,https://x.com/pyonnsuke000320/status/1967584583484158109,https://x.com/IndoPopBase/status/1967569203726373335,0
2025-09-15 12:41:22+00:00,fuckmyexxx,minta diculik lagi kah?,0,0,0,233,https://x.com/fuckmyexxx/status/1967569431493857769,https://x.com/IndoPopBase/status/1967569203726373335,0
2025-09-15 14:41:57+00:00,rainmass96,judol kapan?,0,0,0,33,https://x.com/rainmass96/status/1967599776981238140,https://x.com/IndoPopBase/status/1967569203726373335,0
2025-09-15 13:53:28+00:00,endiiiel,Nomor lu noh lebih dari satu buat ani-ani.,0,0,0,54,https://x.com/endiiiel/status/1967587575591583966,https://x.com/IndoPopBase/status/1967569203726373335,0
2025-09-15 01:04:45+00:00,turudq,kita liat beberapa hari kedepan,57,58,0,207417,https://x.com/turudq/status/1967394122664415303,https://x.com/IndoPopBase/status/1967386151683252297,115
2025-09-15 01:38:58+00:00,nathaloraa,Org2 twitter pada bitter2 anjir kalian diapain sih dirumah ,39,158,0,80221,https://x.com/nathaloraa/status/1967402729988563218,https://x.com/IndoPopBase/status/1967386151683252297,197
2025-09-15 02:28:19+00:00,hazelnoode,bitter amat komennya wkwkw kenapa sih  masih pagi bjir,7,3,0,174970,https://x.com/hazelnoode/status/1967415150019010667,https://x.com/IndoPopBase/status/1967386151683252297,10
2025-09-15 01:17:54+00:00,Findriii1,"Kan emang dia bilang off sosmed ""dulu"" bukan mau close sosmed selamanya. Ih ya ngegas mulu warga x",14,26,0,61951,https://x.com/Findriii1/status/1967397431496356152,https://x.com/IndoPopBase/status/1967386151683252297,40
2025-09-15 00:43:22+00:00,kiokio878,So what? Bahlil Continuing the project to destroy Raja Ampat for nickel. U guys need to wake up ur government destroying ur country and ur live all of that celebrity bullshit is not important right now,5,98,0,60465,https://x.com/kiokio878/status/1967388740277690418,https://x.com/IndoPopBase/status/1967386151683252297,103
2025-09-15 03:02:32+00:00,gestunbygita,anjir orang pagi2 dah ada aja ye tenaga buat julid,2,4,0,126962,https://x.com/gestunbygita/status/1967423760476291385,https://x.com/IndoPopBase/status/1967386151683252297,6
2025-09-15 03:24:06+00:00,ev3rm0ree,"“dia ini siapasih”
“skip ga kenal”
“ga penting bgt”

yang lo ga kenal belum tentu org lain jg gakenal, yg lo kenal pun org lain belum tentu kenal jg, jd stop muncung lo komen ngatur ngatur jir bikin media sendiri sono",0,10,0,22055,https://x.com/ev3rm0ree/status/1967429188560072949,https://x.com/IndoPopBase/status/1967386151683252297,10
2025-09-15 00:48:31+00:00,Mr_Siomay,"@grok
 emang dia siapa sih? And kenapa berasa sepenting itu buat umumin mau break dulu dari sosial media?",53,19,0,172509,https://x.com/Mr_Siomay/status/1967390034258223105,https://x.com/IndoPopBase/status/1967386151683252297,72
2025-09-15 01:14:33+00:00,kusukamierebus,"Ya allah, itu dia bilang off sebentar karena lagi ada masalah.. Bukan kaya ricis yg bilang pamit seolah ga balik lagi.. Klo ga peduli skip ajaa",1,5,0,20829,https://x.com/kusukamierebus/status/1967396588021760354,https://x.com/IndoPopBase/status/1967386151683252297,6
2025-09-15 01:32:13+00:00,lanadelyeayy,"asli dah bitter bgt reply disini, pdhl tasya cuma bilang rehat dulu ga bilang mau off selamanya, ga pada paham apa gmn. justru bagus gasih dia ga ngumbar2 masalahnya, biar ga jd trending topik",1,1,0,29425,https://x.com/lanadelyeayy/status/1967401032373490024,https://x.com/IndoPopBase/status/1967386151683252297,2
2025-09-15 05:38:37+00:00,nadiafebianti_,"I'm not her fans but at this point, twitter people should get a life and touch some grass.

You probably got hurt in every aspect of your life, but that has nothing to do with throwing all your bitterness at an influencer who did nothing to you",1,22,0,15237,https://x.com/nadiafebianti_/status/1967463042377240842,https://x.com/IndoPopBase/status/1967386151683252297,23
2025-09-15 09:59:59+00:00,detikcom,"Selebgram Tasya Farasya mengajukan gugatan cerai terhadap suaminya, Ahmad Assegaf, di Pengadilan Agama Jakarta Selatan.
hot.detik.com/celeb/d-811325
…",1,12,0,61116,https://x.com/detikcom/status/1967528814768226338,https://x.com/IndoPopBase/status/1967386151683252297,13
2025-09-15 00:59:01+00:00,sanitamima,"Doa tambahan: Semoga akur ama kembarannya kaya dulu. Lupakan drama & hal ga baik, move on ke lembar baru.",3,5,0,29675,https://x.com/sanitamima/status/1967392679526039654,https://x.com/IndoPopBase/status/1967386151683252297,8
2025-09-15 14:10:05+00:00,okezonenews,"Diisukan Gugat Cerai Suami, Tasya Farasya Pilih Puasa Sosmed: Aku Butuh Waktu dan Ruang",0,0,0,28084,https://x.com/okezonenews/status/1967591754598846546,https://x.com/IndoPopBase/status/1967386151683252297,0
2025-09-15 02:36:02+00:00,yunifajriyah,"Anying komennya pada kenapa sih? Wkwk ini kan akun indopopbase yang isinya tentang celebrity, influencer, artis dll
Kalo menurut kalian gak penting dan gak kenal ya tinggal skip?
Dan kalo mau berita yang menurut kalian lebih bermanfaat ya cari akun lain?",0,2,0,14659,https://x.com/yunifajriyah/status/1967417092178870742,https://x.com/IndoPopBase/status/1967386151683252297,2
2025-09-15 01:06:04+00:00,dawbrigidaw,it’s giving,11,10,0,22279,https://x.com/dawbrigidaw/status/1967394450671575067,https://x.com/IndoPopBase/status/1967386151683252297,21
2025-09-15 02:52:05+00:00,B4n6_H4n5,"Beristirahatlah dengan Tenang, Tasya....",1,2,0,93465,https://x.com/B4n6_H4n5/status/1967421133629837612,https://x.com/IndoPopBase/status/1967386151683252297,3
2025-09-15 02:12:22+00:00,melindaazhari,"netijen kena trust issue, makanya semua disaltyin. padahal ya keputusan tasya udah benar, dia mau mencoba berdamai sama masalahnya. kalau buka sosmed, ada banyak asumsi yang ga pengen dia liat. yaudah si biarin aja dia kek gitu, kalaupun on sosmed lagi artinya dia dah better",0,3,0,10132,https://x.com/melindaazhari/status/1967411136686682323,https://x.com/IndoPopBase/status/1967386151683252297,3
2025-09-15 02:51:32+00:00,itsckecaine,"Org"" Twitter sama Org"" X  udh pada beda anjir. 

Dia sengaja bilang rehat krna biasanya emg kita yg kenal dia sering nungguin kontennya, snpgram nya dia soal rekomendasi makeup dan skincare apalagi dia running lomba padel. Justru gue bingung klo lo pada yg tb""  announce rehat",1,4,0,5449,https://x.com/itsckecaine/status/1967420994265686085,https://x.com/IndoPopBase/status/1967386151683252297,5
2025-09-15 00:43:09+00:00,scarednostalgic,does she even deserved to be tweeted here,4,0,0,20433,https://x.com/scarednostalgic/status/1967388684300460377,https://x.com/IndoPopBase/status/1967386151683252297,4
2025-09-15 03:16:22+00:00,deeptalku14,"X isinya org stres smua, iri dengki dan merasa paling palingg..berita ginian aja d julidin",0,1,0,2490,https://x.com/deeptalku14/status/1967427242029719993,https://x.com/IndoPopBase/status/1967386151683252297,1
2025-09-15 05:53:16+00:00,MainVillainn,"Twitter nih orang orangnya udah pada rapuh rapuh banget jiwanya, ngeliat berita harmless gini aja ampe menyala gitu bitternya",0,0,0,1379,https://x.com/MainVillainn/status/1967466729921196407,https://x.com/IndoPopBase/status/1967386151683252297,0
2025-09-15 01:17:36+00:00,number_dita,"""Memong"" is kinda weird to hear",3,1,0,21471,https://x.com/number_dita/status/1967397352886636960,https://x.com/IndoPopBase/status/1967386151683252297,4
2025-09-15 00:57:02+00:00,Lylisouvenir,"take your time, queen ",2,1,0,22799,https://x.com/Lylisouvenir/status/1967392178889736353,https://x.com/IndoPopBase/status/1967386151683252297,3
2025-09-15 00:50:22+00:00,Supri50_,Keluarga besarnya dia ngapa ada aja dah dramanya,2,0,0,9204,https://x.com/Supri50_/status/1967390499230359603,https://x.com/IndoPopBase/status/1967386151683252297,2
2025-09-15 02:28:20+00:00,lail_23,"Wrga X katanya kaum literasi tinggi, tp sekedar baca screenshot status aja gak bisa",0,0,0,2175,https://x.com/lail_23/status/1967415156385931282,https://x.com/IndoPopBase/status/1967386151683252297,0
2025-09-15 04:03:55+00:00,rineeth_PRK,"Good decision to be out of social media, but why??",2,0,0,86737,https://x.com/rineeth_PRK/status/1967439210195136806,https://x.com/IndoPopBase/status/1967386151683252297,2
2025-09-15 03:49:46+00:00,enroseisback,"Orang tuh apa ya kayak knowledge nya tidak SELUAS itu terus tetep pen nampak keren kah dengan sok bertanya ""dia siapa si dia siapa si?"" ADA BUANYAK AI apakah tidak bisa searching sendiri? Greget",0,0,0,2155,https://x.com/enroseisback/status/1967435646722777440,https://x.com/IndoPopBase/status/1967386151683252297,0
2025-09-15 05:43:23+00:00,Dearyofdey,ini knp dah akun akun tech gajelas pada komen bitter? ya jelas lu gatau karna emg bkn audiencenya kali. gue aja gatau akun akun tech karna emg ga tertarik. aneh,0,0,0,1151,https://x.com/Dearyofdey/status/1967464239813238996,https://x.com/IndoPopBase/status/1967386151683252297,0
2025-09-15 03:23:59+00:00,carriad_chi,"Hanya karna kalian ngga peduli bukan berarti semua orang juga ngga peduli wkwk
Lewatin aja kalo buat kalian ngga relevan, like hidup orang jg ngga muter di kalian. Kalo buat kalian ngga relevan trs orang ngga boleh post gt?",0,0,0,2779,https://x.com/carriad_chi/status/1967429159636115914,https://x.com/IndoPopBase/status/1967386151683252297,0
2025-09-15 06:33:14+00:00,ewefucksa,"ini yg pada nanya ""emg dia siapa?"" ""emang dia penting?"" buka ig klen kampung, cari nama tasya farasya itu ig nya 7 juta followers.",0,0,0,2237,https://x.com/ewefucksa/status/1967476788487237635,https://x.com/IndoPopBase/status/1967386151683252297,0
2025-09-15 01:20:32+00:00,bundarbundir,Kasian tasyi gada lawan ntar,8,0,0,38210,https://x.com/bundarbundir/status/1967398091096748220,https://x.com/IndoPopBase/status/1967386151683252297,8
2025-09-15 05:54:33+00:00,lopeloey_,X nih isinya org2 stress semua kah...,0,0,0,1619,https://x.com/lopeloey_/status/1967467053478191427,https://x.com/IndoPopBase/status/1967386151683252297,0
2025-09-15 04:27:39+00:00,konnady,"Dia bukan ricis anjir, liat deh dia mau rehat aja. Lagian dia beauty vloger pasti banyak fans dan banyak brend yg kerja sm, sama dia. Dari kasus yg udah²dia tipe orang yg silent klo punya masalah",0,1,0,2684,https://x.com/konnady/status/1967445181826990337,https://x.com/IndoPopBase/status/1967386151683252297,1
2025-09-15 01:40:49+00:00,HwamulanNgoceh,"ga ngikutin beauty reviewnya, tp kenal beliau krn ngikutin review makanan chanel yt kembarannya. be2rpa  kali liat konten barengan kluarga tsb. trmasuk kluarga sultan, ckup trkejut denger gosip kluarganya krn dr luar nampak sempurna. trnyata hidup sawang sinawang gaes.",0,0,0,6798,https://x.com/HwamulanNgoceh/status/1967403197661884914,https://x.com/IndoPopBase/status/1967386151683252297,0
2025-09-15 00:56:38+00:00,IJBOLINI,12 hours break from social media wbk,0,0,0,3599,https://x.com/IJBOLINI/status/1967392079656677557,https://x.com/IndoPopBase/status/1967386151683252297,0
2025-09-15 08:07:12+00:00,buusines,"bjirrr orang2 twitter kalian kenapa sih? salty amat lu pada. dia beauty influencer wajar announce kayak gitu. banyak brand yg nge endorse dia, dan kerja sama lain nya. emang lu pada gada kerjaan ngesalty in orang aja cih",0,0,0,1414,https://x.com/buusines/status/1967500434102448272,https://x.com/IndoPopBase/status/1967386151683252297,0
2025-09-15 05:15:37+00:00,imyumyina,"Guys..
Beliau ini bukan orang yg patut kalian bitter-in.
Dia gak drama kok.
Dan ini announcement untuk follower/fans nya.",0,0,0,654,https://x.com/imyumyina/status/1967457253663076403,https://x.com/IndoPopBase/status/1967386151683252297,0
2025-09-15 00:52:48+00:00,sotomojito,Man they're just randomly generating celebrities these days,0,0,0,3500,https://x.com/sotomojito/status/1967391111577764192,https://x.com/IndoPopBase/status/1967386151683252297,0
2025-09-15 11:33:14+00:00,mieayam_enak1,repost-an kak cepi 2 hari lalu gaiss,0,1,0,2530,https://x.com/mieayam_enak1/status/1967552283509715360,https://x.com/IndoPopBase/status/1967386151683252297,1
2025-09-15 02:47:42+00:00,bestofluckkkkk,Langkahnya udh tepat pun tetap dihujat wkwkw aya2 wae netizen,0,0,0,1694,https://x.com/bestofluckkkkk/status/1967420031115116792,https://x.com/IndoPopBase/status/1967386151683252297,0
2025-09-15 07:13:27+00:00,karmachamaeleon,"Padahal udah jelas ini akun apa. Ya memang konteksnya bahas arteessss. Kalo lu bitter nanya dia siapa, lu yang siapa kocak‍",0,0,0,745,https://x.com/karmachamaeleon/status/1967486908956918244,https://x.com/IndoPopBase/status/1967386151683252297,0
2025-09-15 03:31:37+00:00,suarahatirakjel,,0,1,0,1314,https://x.com/suarahatirakjel/status/1967431082678329466,https://x.com/IndoPopBase/status/1967386151683252297,1
2025-09-15 02:10:00+00:00,nawttyourboy,Why the hell is she proud with that memong call,1,0,0,717,https://x.com/nawttyourboy/status/1967410541619716579,https://x.com/IndoPopBase/status/1967386151683252297,1
2025-09-15 11:44:54+00:00,·,salty2 amat si komennya wkwkw dia pamit ama followers & fans nya aja. apalagi skrg dia lg banyak isu jelek ttg rumah tangga nya. kalo tbtb ngilang takutnya banyak asumsi sana sini. jelek amat si hati nya ,0,0,0,820,https://x.com/sleepiliciouss/status/1967555220441096594,https://x.com/IndoPopBase/status/1967386151683252297,0
2025-09-15 00:41:58+00:00,hardhene,zero fuck given,0,0,0,1781,https://x.com/hardhene/status/1967388385636675869,https://x.com/IndoPopBase/status/1967386151683252297,0
2025-09-15 01:22:21+00:00,extrocib,Udah gak mikirin tentang kehidupan influencer bjir,0,0,0,1854,https://x.com/extrocib/status/1967398548615684401,https://x.com/IndoPopBase/status/1967386151683252297,0
2025-09-15 01:27:19+00:00,banafcha,aktip di secc acc.,0,0,0,1020,https://x.com/banafcha/status/1967399798061023581,https://x.com/IndoPopBase/status/1967386151683252297,0
2025-09-16 05:25:32+00:00,Fengshuiwarna,"Insomn = punya anxiety etc
Divorce = nambah beban
Insom+divorce = X
detox sosmed+ke dokter, otak manusia yg gak bisa tidur ada kurang kimianya, jd hrs dbantu pake obat. Aprazolam misalnya atau diazepam. Ini tdk djual bebas hrs ketemu dokter. Ut kalian2 yg mengalami, BPJS cover!",0,1,0,110,https://x.com/Fengshuiwarna/status/1967822137944908071,https://x.com/IndoPopBase/status/1967386151683252297,1
2025-09-16 02:35:03+00:00,indibiz_borneo,Semangat Tasya,0,0,0,7425,https://x.com/indibiz_borneo/status/1967779232064684221,https://x.com/IndoPopBase/status/1967386151683252297,0
2025-09-14 10:24:28+00:00,fed_febri,Teh Ocha still Diva Pop,0,0,0,724,https://x.com/fed_febri/status/1967172589526405608,https://x.com/IndoPopBase/status/1967171402764857365,0
2025-09-14 10:20:13+00:00,0x_PingPing,"malaysia suka banget sama rossa
hebat rossa !!",0,0,0,549,https://x.com/0x_PingPing/status/1967171519798546568,https://x.com/IndoPopBase/status/1967171402764857365,0
2025-09-14 11:44:37+00:00,widzeth,Teh oca keren banget,1,0,0,629,https://x.com/widzeth/status/1967192761205133694,https://x.com/IndoPopBase/status/1967171402764857365,1
2025-09-14 10:22:40+00:00,xcyvpz,ini lama-lama rossa di claim punya malaysia,0,0,0,831,https://x.com/xcyvpz/status/1967172135685923029,https://x.com/IndoPopBase/status/1967171402764857365,0
2025-09-14 10:37:22+00:00,ramasarigadun,"masyarakat malaysia cinta rossa, masyarakat indonesia cinta siti nurhaliza.",0,0,0,459,https://x.com/ramasarigadun/status/1967175836987232577,https://x.com/IndoPopBase/status/1967171402764857365,0
2025-09-14 11:00:28+00:00,updatesjekeyti,and my fav jkt48?,1,0,0,444,https://x.com/updatesjekeyti/status/1967181650766483907,https://x.com/IndoPopBase/status/1967171402764857365,1
2025-09-14 11:37:55+00:00,DatoSriRossa,"Girl you’re Wrong. She WON 5 

- Terlalu Cinta
- Ayat-Ayat Cinta
-Ku Menunggu
- Salahkah feat. Hafiz Suip
- Bertengkar Manis feat. Barsena Bestandhi",1,1,0,378,https://x.com/DatoSriRossa/status/1967191076026098142,https://x.com/IndoPopBase/status/1967171402764857365,2
2025-09-14 10:23:19+00:00,hidupbodoamat,Kak Ros is very popular in Malaysia because of Upin and Ipin.,0,0,0,283,https://x.com/hidupbodoamat/status/1967172300744409092,https://x.com/IndoPopBase/status/1967171402764857365,0
2025-09-14 10:20:52+00:00,ursteulyNaveen,Queen of consistency!  Congrats to Rossa on adding 4 more AIM Awards to her legendary journey. ,0,0,0,484,https://x.com/ursteulyNaveen/status/1967171683753832760,https://x.com/IndoPopBase/status/1967171402764857365,0
2025-09-14 13:02:39+00:00,ekozones,5x yang benar min,0,0,0,260,https://x.com/ekozones/status/1967212397653037469,https://x.com/IndoPopBase/status/1967171402764857365,0
2025-09-14 11:55:01+00:00,B4n6_H4n5,"Orangnya boleh kecil, 
Tapi suaranya luar biasa keren...",0,0,0,685,https://x.com/B4n6_H4n5/status/1967195378413089271,https://x.com/IndoPopBase/status/1967171402764857365,0
2025-09-14 10:43:26+00:00,bareda,I attended my cousins' Konvokesyen at UUM Kedah almost two decades ago. The first song the Choir sang was Rossa's Tegar.,0,0,0,986,https://x.com/bareda/status/1967177364221354228,https://x.com/IndoPopBase/status/1967171402764857365,0
2025-09-14 12:45:18+00:00,rineeth_PRK,She looks young but she is consistent to perform,0,0,0,387,https://x.com/rineeth_PRK/status/1967208033504890958,https://x.com/IndoPopBase/status/1967171402764857365,0
2025-09-14 11:39:58+00:00,michh_eth,TEH OCA masi sama bang apgan ga si guys? Tolong info,0,0,0,366,https://x.com/michh_eth/status/1967191588637180372,https://x.com/IndoPopBase/status/1967171402764857365,0
2025-09-14 11:15:51+00:00,is_pelssy,"Rossa The best, the really Diva",0,0,0,566,https://x.com/is_pelssy/status/1967185523086340334,https://x.com/IndoPopBase/status/1967171402764857365,0
2025-09-14 10:58:21+00:00,12amgadwi,AIM Awards itu apa?,2,0,0,225,https://x.com/12amgadwi/status/1967181118802964988,https://x.com/IndoPopBase/status/1967171402764857365,2
2025-09-15 00:13:25+00:00,culturalizion,Oh GODsa,0,0,0,56,https://x.com/culturalizion/status/1967381202303918587,https://x.com/IndoPopBase/status/1967171402764857365,0
2025-09-14 12:20:27+00:00,natasha_saja,Kas Ros menang lagi - kata Upin Ipin,0,0,0,131,https://x.com/natasha_saja/status/1967201779403362587,https://x.com/IndoPopBase/status/1967171402764857365,0
2025-09-14 10:40:34+00:00,Love_3children,"With her golden voice, Rosa really deserves it all.",0,0,0,176,https://x.com/Love_3children/status/1967176644147491031,https://x.com/IndoPopBase/status/1967171402764857365,0
2025-09-14 11:28:11+00:00,rubycln,Not even 5??? Oh flopssa,1,0,0,237,https://x.com/rubycln/status/1967188626762236132,https://x.com/IndoPopBase/status/1967171402764857365,1
2025-09-15 02:42:35+00:00,JavaJimmyMaukar,"@mynameisrossa
 OUR QUEEN",0,0,0,36,https://x.com/JavaJimmyMaukar/status/1967418743497379994,https://x.com/IndoPopBase/status/1967171402764857365,0
2025-09-14 10:23:22+00:00,0xdelula,My Diva ,1,0,0,212,https://x.com/0xdelula/status/1967172314665304398,https://x.com/IndoPopBase/status/1967171402764857365,1
2025-09-14 12:51:26+00:00,airdrop_goe,Mantap,0,0,0,349,https://x.com/airdrop_goe/status/1967209576656433372,https://x.com/IndoPopBase/status/1967171402764857365,0
2025-09-14 12:14:21+00:00,Kryptonomanos,Keren cik,0,0,0,238,https://x.com/Kryptonomanos/status/1967200244300738724,https://x.com/IndoPopBase/status/1967171402764857365,0
2025-09-15 02:12:36+00:00,Th3Tr4vel3r,Congrats teh Rosa,0,0,0,263,https://x.com/Th3Tr4vel3r/status/1967411196623237391,https://x.com/IndoPopBase/status/1967171402764857365,0
2025-09-14 08:27:06+00:00,0xHarryry,"INDO Pride, no drama dramaa",0,0,0,1701,https://x.com/0xHarryry/status/1967143055842218407,https://x.com/IndoPopBase/status/1967141329005408700,0
2025-09-14 08:20:41+00:00,0x_PingPing,"crazy
PROUD INDONESIA !!!",0,0,0,1157,https://x.com/0x_PingPing/status/1967141440276099518,https://x.com/IndoPopBase/status/1967141329005408700,0
2025-09-14 08:21:41+00:00,sugar_6378,keren NIKI!,0,0,0,1456,https://x.com/sugar_6378/status/1967141690034229325,https://x.com/IndoPopBase/status/1967141329005408700,0
2025-09-14 08:34:03+00:00,nykac_,"Feby Putri has married to Adam Febrian CONGRATULATION 
@IndoPopBase
 please post",1,1,0,518,https://x.com/nykac_/status/1967144801389990123,https://x.com/IndoPopBase/status/1967141329005408700,2
2025-09-14 08:50:59+00:00,haikarrll85,"Maaf Niki, pas gue nyanyi lagu Lowkey, tiba-tiba nyambung ke lagu Sabyan yang ""Maulana Ya Maulana""",0,0,0,481,https://x.com/haikarrll85/status/1967149065508179987,https://x.com/IndoPopBase/status/1967141329005408700,0
2025-09-14 23:02:26+00:00,kangcilok,Old but gold,0,0,0,205,https://x.com/kangcilok/status/1967363338612142366,https://x.com/IndoPopBase/status/1967141329005408700,0
2025-09-14 08:24:48+00:00,uyuneee,and my fave copynadya?,0,0,0,422,https://x.com/uyuneee/status/1967142473597415468,https://x.com/IndoPopBase/status/1967141329005408700,0
2025-09-14 09:10:30+00:00,barba_dian,Oohh thanks to her pinoy fans we won,0,0,0,258,https://x.com/barba_dian/status/1967153977809875263,https://x.com/IndoPopBase/status/1967141329005408700,0
2025-09-14 10:15:46+00:00,WitheredShulker,Someone pls tell Hagnez mo to stop partying in Bali and start catching up lol,0,0,0,227,https://x.com/WitheredShulker/status/1967170401999667669,https://x.com/IndoPopBase/status/1967141329005408700,0
2025-09-14 08:31:58+00:00,littlegamboll,Single handedly carrying 2019,0,0,0,399,https://x.com/littlegamboll/status/1967144280264470803,https://x.com/IndoPopBase/status/1967141329005408700,0
2025-09-14 08:24:10+00:00,norepine__ppp,Lagu favorite ,0,0,0,341,https://x.com/norepine__ppp/status/1967142315128135738,https://x.com/IndoPopBase/status/1967141329005408700,0
2025-09-14 08:21:45+00:00,chuucanduit,something agnez mo could never do,0,0,0,425,https://x.com/chuucanduit/status/1967141706593431599,https://x.com/IndoPopBase/status/1967141329005408700,0
2025-09-14 18:11:07+00:00,vamborebomb,"Kudos fy 
@nikizefanya",0,0,0,232,https://x.com/vamborebomb/status/1967290027215605909,https://x.com/IndoPopBase/status/1967141329005408700,0
2025-09-14 23:53:08+00:00,Daaaniiisssss,Ended who??,0,0,0,113,https://x.com/Daaaniiisssss/status/1967376096284053922,https://x.com/IndoPopBase/status/1967141329005408700,0
2025-09-15 07:13:02+00:00,woojinlucuu,Mother,0,0,0,54,https://x.com/woojinlucuu/status/1967486803906293840,https://x.com/IndoPopBase/status/1967141329005408700,0
2025-09-14 09:26:07+00:00,ktlmmklovr,Masih pneasaran muka asli cowoknya,1,0,0,530,https://x.com/ktlmmklovr/status/1967157905909837914,https://x.com/IndoPopBase/status/1967141329005408700,1
2025-09-14 12:54:02+00:00,luthfibpr,my baby ,0,0,0,208,https://x.com/luthfibpr/status/1967210229004931259,https://x.com/IndoPopBase/status/1967141329005408700,0
2025-09-14 13:39:08+00:00,IntrovertBro,Congratsssss,0,0,0,177,https://x.com/IntrovertBro/status/1967221577784996141,https://x.com/IndoPopBase/status/1967141329005408700,0
2025-09-14 08:37:04+00:00,repxkomh13,SMASH HIT,0,0,0,316,https://x.com/repxkomh13/status/1967145563247542435,https://x.com/IndoPopBase/status/1967141329005408700,0
2025-09-14 08:38:33+00:00,rebelbaachi,"Stunning pictures, and congratulations ",0,0,0,272,https://x.com/rebelbaachi/status/1967145935533994396,https://x.com/IndoPopBase/status/1967141329005408700,0
2025-09-14 10:04:02+00:00,0xdelula,Nice NIKI,0,0,0,142,https://x.com/0xdelula/status/1967167449914323423,https://x.com/IndoPopBase/status/1967141329005408700,0
2025-09-14 09:50:33+00:00,jackthegon,Wow congrats nik,0,0,0,148,https://x.com/jackthegon/status/1967164053748683254,https://x.com/IndoPopBase/status/1967141329005408700,0
2025-09-14 09:14:43+00:00,Th3Tr4vel3r,awasome niki,0,0,0,986,https://x.com/Th3Tr4vel3r/status/1967155037362332070,https://x.com/IndoPopBase/status/1967141329005408700,0
2025-09-14 13:24:46+00:00,Razziizzar,Hagnezmo could never ,1,0,0,201,https://x.com/Razziizzar/status/1967217964249473299,https://x.com/IndoPopBase/status/1967141329005408700,1
2025-09-15 01:02:26+00:00,deethemedia,bukan angka yg kecil ,0,0,0,54,https://x.com/deethemedia/status/1967393537110241464,https://x.com/IndoPopBase/status/1967141329005408700,0
2025-09-14 11:49:02+00:00,widzeth,Sial sialnya kubertemu pada cinta semu,1,0,0,473,https://x.com/widzeth/status/1967193871261290500,https://x.com/IndoPopBase/status/1967134968460853368,1
2025-09-14 07:55:24+00:00,0x_PingPing,brb coba denger di spotify,0,0,0,635,https://x.com/0x_PingPing/status/1967135075067457817,https://x.com/IndoPopBase/status/1967134968460853368,0
2025-09-14 07:56:03+00:00,ursteulyNaveen,Great to see Mahalini back in the Top 10! ,0,0,0,693,https://x.com/ursteulyNaveen/status/1967135238775337248,https://x.com/IndoPopBase/status/1967134968460853368,0
2025-09-14 08:11:25+00:00,blueeyes54801,kisah sempurna ,0,0,0,466,https://x.com/blueeyes54801/status/1967139108637340030,https://x.com/IndoPopBase/status/1967134968460853368,0
2025-09-14 09:29:35+00:00,calalisaa,lagu mahalini di album yg ini bagus semua  tp emg semua lagu mahalini bagus sih,1,0,0,251,https://x.com/calalisaa/status/1967158777561674158,https://x.com/IndoPopBase/status/1967134968460853368,1
2025-09-14 08:10:15+00:00,Itzgirii,Fabula..,0,0,0,41,https://x.com/Itzgirii/status/1967138811563176274,https://x.com/IndoPopBase/status/1967134968460853368,0
2025-09-14 07:59:19+00:00,sugar_6378,"yang judulnya ""Sial"", bagus.",0,0,0,621,https://x.com/sugar_6378/status/1967136061332873571,https://x.com/IndoPopBase/status/1967134968460853368,0
2025-09-15 07:25:38+00:00,kemangfav,Salah satu album favorit..,0,0,0,58,https://x.com/kemangfav/status/1967489971495047192,https://x.com/IndoPopBase/status/1967134968460853368,0
2025-09-15 14:48:38+00:00,youlovezembud,diva ,0,0,0,28,https://x.com/youlovezembud/status/1967601456502161866,https://x.com/IndoPopBase/status/1967134968460853368,0
2025-09-14 09:46:02+00:00,stussydiexp,Fabula hati hilang cahaya iman...,0,0,0,287,https://x.com/stussydiexp/status/1967162917759090837,https://x.com/IndoPopBase/status/1967134968460853368,0
2025-09-14 13:14:57+00:00,·,ISYANA outdid,0,0,0,196,https://x.com/ganogaon/status/1967215494047715602,https://x.com/IndoPopBase/status/1967134968460853368,0
2025-09-14 09:29:08+00:00,sukaplinplan,Best album,0,0,0,257,https://x.com/sukaplinplan/status/1967158665821212797,https://x.com/IndoPopBase/status/1967134968460853368,0
2025-09-14 08:08:23+00:00,todayis_fr,since when did you change your profile picture?,0,0,0,311,https://x.com/todayis_fr/status/1967138342396707045,https://x.com/IndoPopBase/status/1967134968460853368,0
2025-09-14 07:59:24+00:00,swiftiemendess,Ended LTZ with ease,0,0,0,344,https://x.com/swiftiemendess/status/1967136084732899357,https://x.com/IndoPopBase/status/1967134968460853368,0
2025-09-14 07:56:32+00:00,jackthegon,Mahalini the goddess,0,0,0,340,https://x.com/jackthegon/status/1967135362612163061,https://x.com/IndoPopBase/status/1967134968460853368,0
2025-09-14 07:59:28+00:00,Th3Tr4vel3r,good album,0,0,0,644,https://x.com/Th3Tr4vel3r/status/1967136099828199476,https://x.com/IndoPopBase/status/1967134968460853368,0
2025-09-14 08:04:29+00:00,bluemoonikii,Flopp,0,0,0,258,https://x.com/bluemoonikii/status/1967137362628276280,https://x.com/IndoPopBase/status/1967134968460853368,0
2025-09-14 08:16:54+00:00,0xHarryry,"Hindia lagi on top sihh, lagunya enak banget",3,2,0,20859,https://x.com/0xHarryry/status/1967140487162458329,https://x.com/IndoPopBase/status/1967131233319838102,5
2025-09-14 07:40:35+00:00,0x_PingPing,sheila on 7 still on my playlist till today,0,0,0,14723,https://x.com/0x_PingPing/status/1967131346658296009,https://x.com/IndoPopBase/status/1967131233319838102,0
2025-09-14 07:43:40+00:00,Rumahdepok_,Wali mana jir????,3,0,0,17102,https://x.com/Rumahdepok_/status/1967132122868744253,https://x.com/IndoPopBase/status/1967131233319838102,3
2025-09-14 18:40:12+00:00,hotspot_barokah,"Hindia & .Feast kenapa bisa ngetop karena lagu-lagunya related sama keadaan gen Z & situation on this country

makanya gen Z pada suka, termasuk gue. padahal baskara kalo nyanyi suaranya agak fals ",1,1,0,3445,https://x.com/hotspot_barokah/status/1967297343847567614,https://x.com/IndoPopBase/status/1967131233319838102,2
2025-09-14 22:27:44+00:00,IlHamFirmannsy,the goat,0,4,0,2805,https://x.com/IlHamFirmannsy/status/1967354607379906610,https://x.com/IndoPopBase/status/1967131233319838102,4
2025-09-14 10:18:14+00:00,twinSUNSHIINE,We are living in Baskara-verse,0,0,0,2425,https://x.com/twinSUNSHIINE/status/1967171022005862506,https://x.com/IndoPopBase/status/1967131233319838102,0
2025-09-14 14:07:21+00:00,oniichan666666,kok ada orang masih pake spotify,19,4,0,16320,https://x.com/oniichan666666/status/1967228682625495508,https://x.com/IndoPopBase/status/1967131233319838102,23
2025-09-14 12:32:56+00:00,tsaniarhm,hindia feast krn nih negara demo mulu anj wkwkwkwk,0,0,0,1577,https://x.com/tsaniarhm/status/1967204921620721716,https://x.com/IndoPopBase/status/1967131233319838102,0
2025-09-14 11:12:47+00:00,yourcalmboy,"cukup besar tuk mengampuni, tuk mengasihi, tanpa memperhitungkan masa yang lalu, walau perih, bisakah kita?, tetap membasuh~",0,0,0,2533,https://x.com/yourcalmboy/status/1967184751154082065,https://x.com/IndoPopBase/status/1967131233319838102,0
2025-09-14 07:57:36+00:00,Ryu_Umarov13,Sebentar lagi lomba sihir naik ke top 10,2,0,0,5452,https://x.com/Ryu_Umarov13/status/1967135631605477691,https://x.com/IndoPopBase/status/1967131233319838102,2
2025-09-14 08:20:25+00:00,penakturua9,Band lawas cuman so7. Keknya relate sama gen z..,1,0,0,2558,https://x.com/penakturua9/status/1967141373750243375,https://x.com/IndoPopBase/status/1967131233319838102,1
2025-09-14 08:01:18+00:00,3usri,,0,0,0,3051,https://x.com/3usri/status/1967136561667121384,https://x.com/IndoPopBase/status/1967131233319838102,0
2025-09-14 10:48:47+00:00,majethic,top 5 ver ak,1,0,0,1293,https://x.com/majethic/status/1967178709066305635,https://x.com/IndoPopBase/status/1967131233319838102,1
2025-09-14 10:31:32+00:00,jaeminbeatbox,beat em tenxi ,0,0,0,648,https://x.com/jaeminbeatbox/status/1967174369849024517,https://x.com/IndoPopBase/status/1967131233319838102,0
2025-09-14 07:47:03+00:00,fojiiq,and Niki?,0,0,0,886,https://x.com/fojiiq/status/1967132975482761480,https://x.com/IndoPopBase/status/1967131233319838102,0
2025-09-14 13:57:52+00:00,MatchaDruid,Sheila On 7 ,0,0,0,280,https://x.com/MatchaDruid/status/1967226294011330704,https://x.com/IndoPopBase/status/1967131233319838102,0
2025-09-14 07:47:20+00:00,doomdevata,membasuh supremacy,0,0,0,764,https://x.com/doomdevata/status/1967133046014095595,https://x.com/IndoPopBase/status/1967131233319838102,0
2025-09-14 13:00:28+00:00,uyuuuuuuupxz,gila sih SO7 masihhhh masuk top 10,0,0,0,347,https://x.com/uyuuuuuuupxz/status/1967211848253726960,https://x.com/IndoPopBase/status/1967131233319838102,0
2025-09-14 08:06:47+00:00,crushrockwell,wheres my fav Barbie Kumalasari?!?!?,1,0,0,695,https://x.com/crushrockwell/status/1967137941521920086,https://x.com/IndoPopBase/status/1967131233319838102,1
2025-09-14 12:48:56+00:00,AminoMuhammadd,dari 10 list diatas cuma Sheila on 7 yg masuk playlist gw. sisanya tau lagunya 1-2 yg famous cuma kadang sekilas dengar aja wkk,0,0,0,793,https://x.com/AminoMuhammadd/status/1967208947573727609,https://x.com/IndoPopBase/status/1967131233319838102,0
2025-09-14 07:45:30+00:00,·,"No Afgan, Indonesian fell off",2,0,0,4950,https://x.com/Seazured/status/1967132585123082725,https://x.com/IndoPopBase/status/1967131233319838102,2
2025-09-14 17:03:15+00:00,zaaavery,so7 never old,0,0,0,210,https://x.com/zaaavery/status/1967272948357820669,https://x.com/IndoPopBase/status/1967131233319838102,0
2025-09-14 11:51:00+00:00,aukseen,Cwk kul dengerin tenxi,0,0,0,311,https://x.com/aukseen/status/1967194366839341385,https://x.com/IndoPopBase/status/1967131233319838102,0
2025-09-15 09:15:16+00:00,atonskrtk,Gokil So7 masih saja...,0,0,0,27,https://x.com/atonskrtk/status/1967517561677021271,https://x.com/IndoPopBase/status/1967131233319838102,0
2025-09-14 07:52:38+00:00,rineeth_PRK,Hoo good lets check this,0,0,0,9702,https://x.com/rineeth_PRK/status/1967134381270765568,https://x.com/IndoPopBase/status/1967131233319838102,0
2025-09-15 18:47:42+00:00,natanbintitan,for revenge tuh masuk top 10? the hell guys,0,0,0,9,https://x.com/natanbintitan/status/1967661621905592433,https://x.com/IndoPopBase/status/1967131233319838102,0
2025-09-14 12:04:04+00:00,pohonduiit,"Gapernah denger spotify, dengerinnya di yutub mulu gapapa kan",1,0,0,3178,https://x.com/pohonduiit/status/1967197656645787966,https://x.com/IndoPopBase/status/1967131233319838102,1
2025-09-15 01:39:16+00:00,mdafadm,kalo niki masuknya indonesian artist atau gak?,0,0,0,192,https://x.com/mdafadm/status/1967402805339299953,https://x.com/IndoPopBase/status/1967131233319838102,0
2025-09-14 12:34:31+00:00,w0rstinme,uninstall spotify ,0,0,0,233,https://x.com/w0rstinme/status/1967205318917816689,https://x.com/IndoPopBase/status/1967131233319838102,0
2025-09-15 02:11:12+00:00,karasuX05,"Klo band band skrg wajar d atas , ini yg band puluhan thn masih d 10 besar aja udh keren bgt",0,0,0,386,https://x.com/karasuX05/status/1967410843378946363,https://x.com/IndoPopBase/status/1967131233319838102,0
2025-09-15 08:09:47+00:00,fa_phm12,"Punten OOT, ada yang jual canva premium? Butuh cepat pliss!!! TIA!",0,0,0,14,https://x.com/fa_phm12/status/1967501083993125326,https://x.com/IndoPopBase/status/1967131233319838102,0
2025-09-15 00:01:58+00:00,gvrvhonorer,"Heran gw, koq ada yg masih dengerin hindia ma sela on 7 🫩",0,0,0,114,https://x.com/gvrvhonorer/status/1967378321337188757,https://x.com/IndoPopBase/status/1967131233319838102,0
2025-09-14 21:55:51+00:00,fluttershysanie,ANJAYY,0,0,0,105,https://x.com/fluttershysanie/status/1967346581201686783,https://x.com/IndoPopBase/status/1967131233319838102,0
2025-09-14 08:20:58+00:00,saya_yudhaa,Dapet 2 wkwk,0,0,0,1457,https://x.com/saya_yudhaa/status/1967141510421639504,https://x.com/IndoPopBase/status/1967131233319838102,0
2025-09-14 17:26:50+00:00,iciryalasa,"Iya lagi, on repeat 1, 2, 3, 8, 10",0,0,0,193,https://x.com/iciryalasa/status/1967278883335717150,https://x.com/IndoPopBase/status/1967131233319838102,0
2025-09-14 23:33:28+00:00,firdaus_ahla,SO7 ,0,0,0,104,https://x.com/firdaus_ahla/status/1967371148297183346,https://x.com/IndoPopBase/status/1967131233319838102,0
2025-09-14 11:55:05+00:00,xfielsaryn,Perunggu belum masuk nih,0,0,0,350,https://x.com/xfielsaryn/status/1967195396532560288,https://x.com/IndoPopBase/status/1967131233319838102,0
2025-09-16 06:21:31+00:00,eleanorie_,"@wordfangs
 Bang liat bang",0,0,0,23,https://x.com/eleanorie_/status/1967836225638907982,https://x.com/IndoPopBase/status/1967131233319838102,0
2025-09-15 07:01:08+00:00,meptah_MEP,"Loh. Iwan fals, slank, padi, jamrud, boomerang? Wkwkwk",1,0,0,129,https://x.com/meptah_MEP/status/1967483808397308078,https://x.com/IndoPopBase/status/1967131233319838102,1
2025-09-15 00:56:11+00:00,maucookiesoreo,@keicji,1,0,0,22,https://x.com/maucookiesoreo/status/1967391966381080603,https://x.com/IndoPopBase/status/1967131233319838102,1
2025-09-14 13:59:08+00:00,gruisthenames,omaygat oum mbaskara my beloved diatas ,0,0,0,394,https://x.com/gruisthenames/status/1967226611486585040,https://x.com/IndoPopBase/status/1967131233319838102,0
2025-09-14 14:00:45+00:00,diozzs,harum manis mana,4,0,0,3380,https://x.com/diozzs/status/1967227018711585008,https://x.com/IndoPopBase/status/1967131233319838102,4
2025-09-15 14:27:37+00:00,jeixhan,"semua tau kecuali no 5, lagunya yg mana yak",0,0,0,54,https://x.com/jeixhan/status/1967596168080408708,https://x.com/IndoPopBase/status/1967131233319838102,0
2025-09-14 14:38:03+00:00,estelersatu,"and my fav, Agnez Mo?",0,0,0,345,https://x.com/estelersatu/status/1967236408726495597,https://x.com/IndoPopBase/status/1967131233319838102,0
2025-09-14 13:11:21+00:00,XBiruuuuu,So7 ,0,0,0,19,https://x.com/XBiruuuuu/status/1967214587700510873,https://x.com/IndoPopBase/status/1967131233319838102,0
2025-09-15 16:00:19+00:00,MusuhWaktu,"@BesokBubarMusic
 karyanya layak diperdengarkan lebih banyak lagi di era sekarang, sangat relevan",0,0,0,39,https://x.com/MusuhWaktu/status/1967619497994653901,https://x.com/IndoPopBase/status/1967131233319838102,0
2025-09-15 13:38:26+00:00,xyzbcot,"P 
@wordfangs
 congrats",0,0,0,25,https://x.com/xyzbcot/status/1967583793205940308,https://x.com/IndoPopBase/status/1967131233319838102,0
2025-09-14 13:59:05+00:00,koh_faii,Film favorit sheila on 7 tetep menjadi favorit,0,0,0,447,https://x.com/koh_faii/status/1967226600665264185,https://x.com/IndoPopBase/status/1967131233319838102,0
2025-09-14 13:49:22+00:00,alifpriatna,7 dari 10 emg list wajib gw buat kerja atau di jalan sih,0,0,0,770,https://x.com/alifpriatna/status/1967224156627616094,https://x.com/IndoPopBase/status/1967131233319838102,0
2025-09-15 08:59:11+00:00,cookiesnnscream,mau nonton hindia bgttt,0,0,0,45,https://x.com/cookiesnnscream/status/1967513515402649627,https://x.com/IndoPopBase/status/1967131233319838102,0
2025-09-14 07:43:46+00:00,jackalevm,"Can anyone hurt pamungkas feelings again? 

he need drop another sad music",0,7,0,5402,https://x.com/jackalevm/status/1967132150870012023,https://x.com/IndoPopBase/status/1967131161458888835,7
2025-09-14 08:40:29+00:00,lastjulliette,"Lagu tabola bale sbnrnya enak tp gegara pas 17an jd eneg gw skrg tiap dengerin, keinget pejabrut pd joget2",0,0,0,1837,https://x.com/lastjulliette/status/1967146423549616491,https://x.com/IndoPopBase/status/1967131161458888835,0
2025-09-14 08:27:24+00:00,Cyrus_eartz,Taflopla Bale need to get off from this i'm tired hearing that song ,1,0,0,1554,https://x.com/Cyrus_eartz/status/1967143131604013474,https://x.com/IndoPopBase/status/1967131161458888835,1
2025-09-14 13:02:15+00:00,enzojfernxndez,Tabola Bale deserves Lagu Terbaik Anugerah Musik Indonesia,0,0,0,598,https://x.com/enzojfernxndez/status/1967212296239009809,https://x.com/IndoPopBase/status/1967131161458888835,0
2025-09-14 08:46:02+00:00,famichkn,ngapain repot deserve better,0,0,0,1130,https://x.com/famichkn/status/1967147819472744598,https://x.com/IndoPopBase/status/1967131161458888835,0
2025-09-14 08:01:18+00:00,devashendy,"""Serana"" masih di Top 10 Spotify Indonesia ",0,0,0,879,https://x.com/devashendy/status/1967136562980016468,https://x.com/IndoPopBase/status/1967131161458888835,0
2025-09-14 08:14:25+00:00,sunseelly,Jir monolog naik lagi?,0,0,0,523,https://x.com/sunseelly/status/1967139864278953997,https://x.com/IndoPopBase/status/1967131161458888835,0
2025-09-14 09:09:20+00:00,IbnuNasir8,Skrg sy lagi dengerin silet open up yg judulnya trauma,0,0,0,455,https://x.com/IbnuNasir8/status/1967153682648313987,https://x.com/IndoPopBase/status/1967131161458888835,0
2025-09-14 07:44:11+00:00,Dara_metaX,Pesta oleh Nina adalah favoritku,0,0,0,459,https://x.com/Dara_metaX/status/1967132254884515914,https://x.com/IndoPopBase/status/1967131161458888835,0
2025-09-14 07:40:54+00:00,ursteulyNaveen,"Indonesia’s charts are  right now! Love how it’s a perfect mix of new voices, heartfelt lyrics, and experimental sounds. Which one’s been on repeat for you this week?",1,0,0,1470,https://x.com/ursteulyNaveen/status/1967131425486070205,https://x.com/IndoPopBase/status/1967131161458888835,1
2025-09-14 08:08:07+00:00,orgility,tabola bale masih akan lama keknya,0,0,0,1326,https://x.com/orgility/status/1967138275774394595,https://x.com/IndoPopBase/status/1967131161458888835,0
2025-09-14 14:06:00+00:00,tlahberganti,monolog up lagi kah? apa emang stabil?,0,0,0,436,https://x.com/tlahberganti/status/1967228342467465545,https://x.com/IndoPopBase/status/1967131161458888835,0
2025-09-14 07:45:13+00:00,sugar_6378,"ini enak gan!
Tarian penghancur Raya, the feast!",0,0,0,615,https://x.com/sugar_6378/status/1967132515120148604,https://x.com/IndoPopBase/status/1967131161458888835,0
2025-09-14 08:13:24+00:00,zaeyanaf,tumben gaada tenxi,0,0,0,822,https://x.com/zaeyanaf/status/1967139608405463251,https://x.com/IndoPopBase/status/1967131161458888835,0
2025-09-14 08:02:46+00:00,3usri,No harum manis???,0,0,0,1076,https://x.com/3usri/status/1967136929541222604,https://x.com/IndoPopBase/status/1967131161458888835,0
2025-09-14 12:37:33+00:00,gooddave_,Barasuara?,0,0,0,256,https://x.com/gooddave_/status/1967206082373390831,https://x.com/IndoPopBase/status/1967131161458888835,0
2025-09-14 09:03:48+00:00,fckggpvsyymok_,TIMUR PRIDE ,0,0,0,604,https://x.com/fckggpvsyymok_/status/1967152289220882927,https://x.com/IndoPopBase/status/1967131161458888835,0
2025-09-14 11:05:10+00:00,chococoneee,Wanjay monolog kenapa naik lagi,0,0,0,528,https://x.com/chococoneee/status/1967182832780063027,https://x.com/IndoPopBase/status/1967131161458888835,0
2025-09-14 08:31:49+00:00,akusopansantun,monolog gokil,0,0,0,867,https://x.com/akusopansantun/status/1967144242159251792,https://x.com/IndoPopBase/status/1967131161458888835,0
2025-09-14 08:24:19+00:00,hajarban6,Nomer 1 lagu rezim,0,0,0,389,https://x.com/hajarban6/status/1967142352558137368,https://x.com/IndoPopBase/status/1967131161458888835,0
2025-09-14 07:44:29+00:00,jackthegon,Diborong pamungkas,1,0,0,496,https://x.com/jackthegon/status/1967132329815797918,https://x.com/IndoPopBase/status/1967131161458888835,1
2025-09-14 07:31:10+00:00,0x_PingPing,sampe liat 2 x buat pastiin,0,0,0,52689,https://x.com/0x_PingPing/status/1967128979338654022,https://x.com/IndoPopBase/status/1967128795904938469,0
2025-09-14 08:17:39+00:00,xxxaryadi,True sounds,5,7,0,106332,https://x.com/xxxaryadi/status/1967140676736549290,https://x.com/IndoPopBase/status/1967128795904938469,12
2025-09-14 07:34:26+00:00,rineeth_PRK,She is looking gorgeous,5,0,0,60702,https://x.com/rineeth_PRK/status/1967129801011183620,https://x.com/IndoPopBase/status/1967128795904938469,5
2025-09-14 12:18:24+00:00,varreldept,modal operasi bisa seperfect itu ya,7,1,0,48578,https://x.com/varreldept/status/1967201264271499356,https://x.com/IndoPopBase/status/1967128795904938469,8
2025-09-14 07:30:53+00:00,0x_PingPing,"wtf
seriously ??
beda bangetttt",0,0,0,20780,https://x.com/0x_PingPing/status/1967128905279828054,https://x.com/IndoPopBase/status/1967128795904938469,0
2025-09-14 11:50:04+00:00,widzeth,Dia cewe ya?,5,0,0,19568,https://x.com/widzeth/status/1967194130523869369,https://x.com/IndoPopBase/status/1967128795904938469,5
2025-09-15 07:54:54+00:00,nanovest_io,Queen ,0,0,0,3605,https://x.com/nanovest_io/status/1967497337187770581,https://x.com/IndoPopBase/status/1967128795904938469,0
2025-09-14 07:32:09+00:00,SaddamWeb3,ok idgaf,0,0,0,14071,https://x.com/SaddamWeb3/status/1967129226550931501,https://x.com/IndoPopBase/status/1967128795904938469,0
2025-09-14 08:18:53+00:00,xxxaryadi," maaf ya mbak 
@fannysoegi",7,5,0,94277,https://x.com/xxxaryadi/status/1967140987832332750,https://x.com/IndoPopBase/status/1967128795904938469,12
2025-09-14 07:42:01+00:00,kopraljonow,"Bonceng nyampingnya kenapa di sisi knalpot???
Ati ati keslomot jadi tato di kempol kak luna",0,0,0,2509,https://x.com/kopraljonow/status/1967131707859235127,https://x.com/IndoPopBase/status/1967128795904938469,0
2025-09-14 11:52:59+00:00,michh_eth,Eh kalian merasa ga si dia putih banget kayak telurrr???,2,0,0,26322,https://x.com/michh_eth/status/1967194865948856810,https://x.com/IndoPopBase/status/1967128795904938469,2
2025-09-14 07:36:37+00:00,nawttyourboy,"Gila nih cowo cakep bener, tp dia ini operasi knp berhasil terus ya??? Kan ada tuh artis oplas tp gagal",0,0,0,2574,https://x.com/nawttyourboy/status/1967130351178043418,https://x.com/IndoPopBase/status/1967128795904938469,0
2025-09-14 11:59:03+00:00,freakkyfio,"dia nih operasi total habis berapa milliar ya, soalnya berhasil banget, dan temen gue yang pernah ketemu in real life aja ngakuin dia cantik banget, kayak cewek tulen, ASAL GA BUKA MULUT AJA wkwk",1,1,0,5090,https://x.com/freakkyfio/status/1967196391115235652,https://x.com/IndoPopBase/status/1967128795904938469,2
2025-09-14 09:06:44+00:00,kuga_kamen,mas fattah gak masuk angin kah motor²an pake baju begitu..,0,1,0,1873,https://x.com/kuga_kamen/status/1967153029947507145,https://x.com/IndoPopBase/status/1967128795904938469,1
2025-09-14 23:06:15+00:00,itsufika,Stan stuns namanya juga oplas total,0,0,0,13017,https://x.com/itsufika/status/1967364297870446860,https://x.com/IndoPopBase/status/1967128795904938469,0
2025-09-14 11:59:20+00:00,·,no offense but she looks stunningly great and healthy yall pls be nice to her,0,0,0,1311,https://x.com/bambiiiblue/status/1967196466159727012,https://x.com/IndoPopBase/status/1967128795904938469,0
2025-09-14 07:34:03+00:00,sugar_6378,dia ngapain memang yah?,8,0,0,76185,https://x.com/sugar_6378/status/1967129702126285321,https://x.com/IndoPopBase/status/1967128795904938469,8
2025-09-14 07:37:38+00:00,is_pelssy,Kek manekin,0,0,0,26385,https://x.com/is_pelssy/status/1967130604711117110,https://x.com/IndoPopBase/status/1967128795904938469,0
2025-09-14 07:50:17+00:00,drafstter,"dia tuh cantik, asal ga bersuara aja",0,0,0,1272,https://x.com/drafstter/status/1967133789710414049,https://x.com/IndoPopBase/status/1967128795904938469,0
2025-09-14 15:22:32+00:00,lightdxj,Hari tanpa kendaraan tapi masih naik motor? Ironi Car Free Day yang sebenarnya.,3,0,0,9943,https://x.com/lightdxj/status/1967247599351874042,https://x.com/IndoPopBase/status/1967128795904938469,3
2025-09-14 08:36:48+00:00,dwi_wi1,Mas Fatih ngapain njrr,1,0,0,1372,https://x.com/dwi_wi1/status/1967145493307551973,https://x.com/IndoPopBase/status/1967128795904938469,1
2025-09-14 07:45:11+00:00,CihuyMustajab,"kalo ngomongin per--an mending pake bahasa indo aja, bahasa indo lebih enak soalnya nonbinary pronouns.",0,0,0,2074,https://x.com/CihuyMustajab/status/1967132506240749664,https://x.com/IndoPopBase/status/1967128795904938469,0
2025-09-14 10:21:33+00:00,nurs_fuad,Disisi lain dulu dia dikotil. ,0,0,0,479,https://x.com/nurs_fuad/status/1967171854382379044,https://x.com/IndoPopBase/status/1967128795904938469,0
2025-09-14 08:11:08+00:00,shinonerdkid,What happened to him?,0,0,0,655,https://x.com/shinonerdkid/status/1967139035509649537,https://x.com/IndoPopBase/status/1967128795904938469,0
2025-09-14 08:25:35+00:00,Lollylunox,emak guehh cantik amat bjir,0,0,0,746,https://x.com/Lollylunox/status/1967142671132356747,https://x.com/IndoPopBase/status/1967128795904938469,0
2025-09-14 08:05:57+00:00,cancershitboys,"Gojeknya bilang ""duduknya bisa nyamping ga mas'",0,0,0,908,https://x.com/cancershitboys/status/1967137730238038334,https://x.com/IndoPopBase/status/1967128795904938469,0
2025-09-14 09:18:05+00:00,·,kok cantik kali anjg,1,0,0,1805,https://x.com/vomuzan/status/1967155884813058135,https://x.com/IndoPopBase/status/1967128795904938469,1
2025-09-14 07:39:10+00:00,RakaSudi,does she?,1,0,0,34396,https://x.com/RakaSudi/status/1967130991899836730,https://x.com/IndoPopBase/status/1967128795904938469,1
2025-09-14 07:32:32+00:00,spesian23,Keinget postingan stan stun stan stun,0,0,0,26739,https://x.com/spesian23/status/1967129323737149670,https://x.com/IndoPopBase/status/1967128795904938469,0
2025-09-14 09:50:50+00:00,Ghotorita,"Katanya orang yg suntik putih resiko gagal ginjal dan sebaginya, tapi abng ini makin beniny dan sehat bugar?!",2,0,0,6795,https://x.com/Ghotorita/status/1967164128214360549,https://x.com/IndoPopBase/status/1967128795904938469,2
2025-09-14 08:20:03+00:00,honhonjihoon,"Jir cakep, asal jangan bersuara aja",0,0,0,940,https://x.com/honhonjihoon/status/1967141281043521756,https://x.com/IndoPopBase/status/1967128795904938469,0
2025-09-14 09:15:29+00:00,·,apa yang ada di pikiran abang gojeknya ya pas tau yang naik lucinta Luna? ,0,0,0,1783,https://x.com/semangatdehh/status/1967155228563870153,https://x.com/IndoPopBase/status/1967128795904938469,0
2025-09-14 13:13:26+00:00,yaudahlayadin,Ini mah street fashion week car free day bukan olahraga kek org2 ,0,0,0,313,https://x.com/yaudahlayadin/status/1967215110394716455,https://x.com/IndoPopBase/status/1967128795904938469,0
2025-09-14 07:37:15+00:00,Mercury_192,jgn prank ojol ya lun,0,0,0,1816,https://x.com/Mercury_192/status/1967130507323601330,https://x.com/IndoPopBase/status/1967128795904938469,0
2025-09-14 07:57:02+00:00,matamantra,itu kebolak duduknyaa,1,0,0,3654,https://x.com/matamantra/status/1967135486906106346,https://x.com/IndoPopBase/status/1967128795904938469,1
2025-09-14 08:09:58+00:00,thebnhd,when you bought wonyoung from tokopedia,0,0,0,325,https://x.com/thebnhd/status/1967138740851417582,https://x.com/IndoPopBase/status/1967128795904938469,0
2025-09-14 08:16:57+00:00,·,"Makin cakep aja bentukannya muh fatah, takut bgt tbtb penyakitan grgr kebanyakan suntikan",0,0,0,1454,https://x.com/strobali/status/1967140499833418046,https://x.com/IndoPopBase/status/1967128795904938469,0
2025-09-14 12:39:10+00:00,Frederike634859,Your discipline in healthy habits is impressive.,0,0,0,1,https://x.com/Frederike634859/status/1967206488218423600,https://x.com/IndoPopBase/status/1967128795904938469,0
2025-09-15 13:53:36+00:00,shaffiyyraa,it girl,0,0,0,22,https://x.com/shaffiyyraa/status/1967587609762574490,https://x.com/IndoPopBase/status/1967128795904938469,0
2025-09-14 13:00:15+00:00,thania1333729,udah gitu aja asal jgn ngomong,0,0,0,236,https://x.com/thania1333729/status/1967211796001169871,https://x.com/IndoPopBase/status/1967128795904938469,0
2025-09-14 09:34:32+00:00,OxBrodi_,paling menyala dia disitu,0,0,0,30904,https://x.com/OxBrodi_/status/1967160024754774372,https://x.com/IndoPopBase/status/1967128795904938469,0
2025-09-14 14:17:02+00:00,saltybabyyyyy,gilaaaaaa tp hasil OP bagus bgt coy dia nih,0,0,0,649,https://x.com/saltybabyyyyy/status/1967231118056546686,https://x.com/IndoPopBase/status/1967128795904938469,0
2025-09-15 00:59:42+00:00,reyhan755997,Aslinya jelek yakan kurang bervalue,0,0,0,35,https://x.com/reyhan755997/status/1967392852054601810,https://x.com/IndoPopBase/status/1967128795904938469,0
2025-09-14 21:44:09+00:00,kumalas18714470,ini bukan hanya sekedar hoki tapi memang gacor sih main di DEWIKU88,0,0,0,4,https://x.com/kumalas18714470/status/1967343638805164322,https://x.com/IndoPopBase/status/1967128795904938469,0
2025-09-14 13:58:59+00:00,honeylizious1,Bjrot tp cantik bgt ya,0,0,0,159,https://x.com/honeylizious1/status/1967226576317407418,https://x.com/IndoPopBase/status/1967128795904938469,0
2025-09-14 09:51:56+00:00,tamagotchmi,mommyyyy....,0,0,0,2,https://x.com/tamagotchmi/status/1967164402102358099,https://x.com/IndoPopBase/status/1967128795904938469,0
2025-09-15 05:13:45+00:00,callmeucuuuuu,,0,0,0,444,https://x.com/callmeucuuuuu/status/1967456781996863727,https://x.com/IndoPopBase/status/1967128795904938469,0
2025-09-15 04:57:48+00:00,lunarpisceans,Cakep bgt lu bang,0,0,0,67,https://x.com/lunarpisceans/status/1967452768031142337,https://x.com/IndoPopBase/status/1967128795904938469,0
2025-09-15 09:24:01+00:00,masborrr,Kang Lou Naa,0,0,0,6,https://x.com/masborrr/status/1967519763430838355,https://x.com/IndoPopBase/status/1967128795904938469,0
2025-09-15 05:18:59+00:00,farisxtyzz,@JekSpade,1,0,0,41,https://x.com/farisxtyzz/status/1967458101562683853,https://x.com/IndoPopBase/status/1967128795904938469,1
2025-09-10 13:14:44+00:00,TempeXBT,Apakah ada udang dibalik bakwan?? mari kita saksikan,15,59,0,166257,https://x.com/TempeXBT/status/1965765889145676187,https://x.com/IndoPopBase/status/1965763662200934863,74
2025-09-10 13:37:59+00:00,beautiaf,wow ada apakah….? tapi banyak jg yah berarti keluarga wowo di pemerintahan skrg,21,17,0,197290,https://x.com/beautiaf/status/1965771740929577334,https://x.com/IndoPopBase/status/1965763662200934863,38
2025-09-10 13:20:30+00:00,AmalaNovi,"Cari aman, karena dia blunder",16,10,0,140862,https://x.com/AmalaNovi/status/1965767340550947050,https://x.com/IndoPopBase/status/1965763662200934863,26
2025-09-10 13:18:28+00:00,officialinews_,Alasan Rahayu Saraswati Keponakan Prabowo Mundur dari DPR,11,19,0,110447,https://x.com/officialinews_/status/1965766828950757615,https://x.com/IndoPopBase/status/1965763662200934863,30
2025-09-10 16:39:17+00:00,adrmptra,otw menteri,1,1,0,32942,https://x.com/adrmptra/status/1965817366383833599,https://x.com/IndoPopBase/status/1965763662200934863,2
2025-09-10 15:13:42+00:00,I_mnonsometaX,"Dia yang blunder ngatain anak muda suruh ciptakan lapangan kerja sendiri jangan bergantung ke pemerintah sedangkan dia aja masih ngikut om nya, di ig udah banyak yg hujat sih dia apalagi masalah kemaren",1,9,0,13058,https://x.com/I_mnonsometaX/status/1965795828393804066,https://x.com/IndoPopBase/status/1965763662200934863,10
2025-09-10 15:05:52+00:00,SaddamWeb3,which ministry lobby is next on the list?,0,0,0,10395,https://x.com/SaddamWeb3/status/1965793855082831887,https://x.com/IndoPopBase/status/1965763662200934863,0
2025-09-10 13:07:38+00:00,0x_PingPing,"Wow
Surprise banget baca ini
Like seriously ??",1,0,0,23174,https://x.com/0x_PingPing/status/1965764101554270529,https://x.com/IndoPopBase/status/1965763662200934863,1
2025-09-10 13:07:56+00:00,0xHarryry,hmmm reason?,6,0,0,170359,https://x.com/0xHarryry/status/1965764176212897959,https://x.com/IndoPopBase/status/1965763662200934863,6
2025-09-10 14:57:35+00:00,I_mnonsometaX,"Respect sih gw sama Sara. At least dia ngasih contoh pejabat yang bicara ngawur dan menyakiti rakyat, tahu diri dan mundur. Bukan yang malah cari perlindungan di ketek penguasa. Kita butuh orang2 berjiwa besar. Semoga jadi contoh buat pejabat lain yang arogan.",9,6,0,28049,https://x.com/I_mnonsometaX/status/1965791770832491000,https://x.com/IndoPopBase/status/1965763662200934863,15
2025-09-11 00:33:15+00:00,wijayawilliam31,"Arahan konsultan, melihat fenomena Sri Mul yang cukup positif ketika resignation dan juga sedang ada 2 petinggi yang viral resignationnya :

1. PM Jepang : Shigeru Ishiba
2. Menlu Belanda

Kita lihat sampai akhir tahun apakah ada jabatan strategis seperti komisaris atau lainnya,",0,1,0,37135,https://x.com/wijayawilliam31/status/1965936641786437789,https://x.com/IndoPopBase/status/1965763662200934863,1
2025-09-10 14:28:24+00:00,NyaiJagat,Wow ,0,4,0,1054,https://x.com/NyaiJagat/status/1965784426845270182,https://x.com/IndoPopBase/status/1965763662200934863,4
2025-09-10 15:50:05+00:00,I_mnonsometaX,"Menurutku dia ini pinter, karir politik masih panjang, nyalon lagi bisa toh dia masih muda. Mudur dan meminta maaf karena bikin blunder lebih dihormati daripada kekeh gak mau mundur dan akhirnya masyarakat berbalik badan dan boikot dia.",0,0,0,2121,https://x.com/I_mnonsometaX/status/1965804983783469406,https://x.com/IndoPopBase/status/1965763662200934863,0
2025-09-10 14:00:15+00:00,mdkousik31,What did she give as the reason for your resignation?,1,0,0,25995,https://x.com/mdkousik31/status/1965777342896427350,https://x.com/IndoPopBase/status/1965763662200934863,1
2025-09-10 13:45:56+00:00,·,As she should. Dia bikin pernyataan yang jahat banget ke rakyat. Dia juga joget di DPR.,0,0,0,633,https://x.com/huftbosan/status/1965773740345885173,https://x.com/IndoPopBase/status/1965763662200934863,0
2025-09-10 15:02:54+00:00,I_mnonsometaX,"LMAO of course harus ada yang ""berkorban"" dari pihak pakde presiden, just to wash hands and to give the impression that ""oh masih ada orang2 yang aware di kubu dia""",1,0,0,6356,https://x.com/I_mnonsometaX/status/1965793108815475130,https://x.com/IndoPopBase/status/1965763662200934863,1
2025-09-11 05:42:54+00:00,HarryPattyRM00,"#JanganSarasPuanDascoAja 
#JanganSarasPuanDascoAja",1,2,0,147,https://x.com/HarryPattyRM00/status/1966014566254653566,https://x.com/IndoPopBase/status/1965763662200934863,3
2025-09-10 16:29:22+00:00,SUARAKRISTEN1,Situasi istana pemerintahan Nepal ,0,1,0,624,https://x.com/SUARAKRISTEN1/status/1965814870055719238,https://x.com/IndoPopBase/status/1965763662200934863,1
2025-09-11 01:27:05+00:00,AnggodoJosh,I don't care,0,1,0,28,https://x.com/AnggodoJosh/status/1965950190197916018,https://x.com/IndoPopBase/status/1965763662200934863,1
2025-09-10 13:07:20+00:00,Seung_ha_,"Why did Prabowo’s niece Rahayu Saraswati step down from the DPR? 
@grok",6,0,0,32388,https://x.com/Seung_ha_/status/1965764026786554219,https://x.com/IndoPopBase/status/1965763662200934863,6
2025-09-10 13:48:50+00:00,riyanflush,Kena mental? . Apa mau jadi wamen?,1,0,0,624,https://x.com/riyanflush/status/1965774468976111743,https://x.com/IndoPopBase/status/1965763662200934863,1
2025-09-10 22:45:33+00:00,ebbypya55,Enaknya ya jadi keluarganya ndutty,0,0,0,80,https://x.com/ebbypya55/status/1965909537346687079,https://x.com/IndoPopBase/status/1965763662200934863,0
2025-09-10 15:38:12+00:00,lovelynobody_69,Oh.. buibu ga jelas ini masih keluarga toh.. pantes ga napak tanah,0,0,0,63,https://x.com/lovelynobody_69/status/1965801991852224944,https://x.com/IndoPopBase/status/1965763662200934863,0
2025-09-10 14:02:56+00:00,TheaRizkyyy,tapi jujur dia di luar sebagai bagian dari prabowo emang kompeten kok pemahaman politiknya,1,0,0,1785,https://x.com/TheaRizkyyy/status/1965778016178733501,https://x.com/IndoPopBase/status/1965763662200934863,1
2025-09-11 04:42:00+00:00,GiarSugiarto6,"Ajak ajak anggota dewan yg lain juga. Banyak yg gak layak jadi anggota dewan tapi 'maksa', akhirnya yg dipertontonkan ke yg diwakili hanya kebodohan demi kebodohan..",0,0,0,70,https://x.com/GiarSugiarto6/status/1965999241484185991,https://x.com/IndoPopBase/status/1965763662200934863,0
2025-09-10 13:47:43+00:00,ajeng_ol,Bagus dah blunder siapa tau mau bikin usaha ye kan,1,0,0,318,https://x.com/ajeng_ol/status/1965774190348546104,https://x.com/IndoPopBase/status/1965763662200934863,1
2025-09-10 13:59:23+00:00,Ratriindahsukma,"My positive think said “oh mau nyontohin temen-temennya”
My honest and maybe this is true : “naik jd menteri ini mah”",0,0,0,145,https://x.com/Ratriindahsukma/status/1965777123240722857,https://x.com/IndoPopBase/status/1965763662200934863,0
2025-09-10 13:26:52+00:00,yudoyudo10,Calon menpora ?,0,0,0,550,https://x.com/yudoyudo10/status/1965768941277786348,https://x.com/IndoPopBase/status/1965763662200934863,0
2025-09-10 13:19:22+00:00,dudionline,Dia ini ikut-ikutan joget juga kalau nggak salah. ,1,0,0,2563,https://x.com/dudionline/status/1965767054574878905,https://x.com/IndoPopBase/status/1965763662200934863,1
2025-09-10 18:39:18+00:00,bluenavyblue19,"Yang kayak gini pasti udah ada itung itungannya. Dia ngelepas apa, nanti diganti apa",0,0,0,69,https://x.com/bluenavyblue19/status/1965847568526807104,https://x.com/IndoPopBase/status/1965763662200934863,0
2025-09-10 14:12:21+00:00,mana_buktinya,"Good move. Sbg keponakan presiden yg punya info intel/analisis sospol, mungkn dia memprediksi bakal ada gelombang PHK yg menggulung Indonesia, berujung demo besar²an yg menggerebek pejabat² asbun yg menyepelekan rakyat kecil, miskin, atau pengangguran, spt di Nepal. Ini asbunnya:  x.com/IndoPopBase/st…",0,0,0,274,https://x.com/mana_buktinya/status/1965780388808438085,https://x.com/IndoPopBase/status/1965763662200934863,0
2025-09-10 13:14:42+00:00,afdhalm_,taktik utk otw jd menteri or wamen kah?,1,0,0,1877,https://x.com/afdhalm_/status/1965765881184813287,https://x.com/IndoPopBase/status/1965763662200934863,1
2025-09-10 17:18:31+00:00,Dodoaldodoz,Tumben,0,0,0,43,https://x.com/Dodoaldodoz/status/1965827237762240654,https://x.com/IndoPopBase/status/1965763662200934863,0
2025-09-10 13:39:59+00:00,godoesntsleep,oh anjrit nepo baby ternyta. makanya statementnya dongo,0,0,0,154,https://x.com/godoesntsleep/status/1965772241444225226,https://x.com/IndoPopBase/status/1965763662200934863,0
2025-09-10 15:35:47+00:00,mandegani,Mau jadi mentri?,0,0,0,17,https://x.com/mandegani/status/1965801383678128475,https://x.com/IndoPopBase/status/1965763662200934863,0
2025-09-10 13:47:28+00:00,razkaws,"idola bang 
@und_cuckoosnest
 
mundur 

masa iya cuma urus tidar doang sih #eh...",1,0,0,108,https://x.com/razkaws/status/1965774126087602301,https://x.com/IndoPopBase/status/1965763662200934863,1
2025-09-11 14:07:00+00:00,·,As she should,0,0,0,1,https://x.com/makanmango/status/1966141430608572901,https://x.com/IndoPopBase/status/1965763662200934863,0
2025-09-12 02:49:32+00:00,Matcha_Litee,Aku kira ayu dewi weh,0,0,0,3,https://x.com/Matcha_Litee/status/1966333326349971843,https://x.com/IndoPopBase/status/1965763662200934863,0
2025-09-10 21:45:44+00:00,riszkull22762,jangan gembira dulu. kursi menterikan masih ada kosong kan.,0,0,0,9,https://x.com/riszkull22762/status/1965894486304903311,https://x.com/IndoPopBase/status/1965763662200934863,0
2025-09-11 04:00:40+00:00,SRantonika,"Pinter..  Masih muda, duit banyak.. Nikmati aja.. Biarin yg ngurus rakyat itu yg emang bener2 kompeten dan ikhlas.",0,0,0,18,https://x.com/SRantonika/status/1965988839014731854,https://x.com/IndoPopBase/status/1965763662200934863,0
2025-09-11 11:13:15+00:00,HafisIbrah26561,Bubarkan saja DPR RI hanya menyengsarakan rakyat saja,0,0,0,17,https://x.com/HafisIbrah26561/status/1966097702762197020,https://x.com/IndoPopBase/status/1965763662200934863,0
2025-09-10 23:03:23+00:00,varreldept,lah beneran ponakannya prabowo nih,0,0,0,3917,https://x.com/varreldept/status/1965914026086748402,https://x.com/IndoPopBase/status/1965763662200934863,0
2025-09-10 13:51:17+00:00,jidantuiter,"19 juta lapangan pekerjaan is riilll

ini pasti lapangan pekerjaan nomor 1",1,0,0,29,https://x.com/jidantuiter/status/1965775085396217876,https://x.com/IndoPopBase/status/1965763662200934863,1
2025-09-10 16:49:14+00:00,holayinn,otw jadi apa hayoo,0,0,0,2,https://x.com/holayinn/status/1965819867497640402,https://x.com/IndoPopBase/status/1965763662200934863,0
2025-09-10 16:11:36+00:00,I_mnonsometaX,"Di pemerintahan Wowo, banyak dari partai Wowo, dari ormas Islam Muhammadiyah jg banyak, trus ada dari NU juga.",0,0,0,884,https://x.com/I_mnonsometaX/status/1965810396234994068,https://x.com/IndoPopBase/status/1965763662200934863,0
2025-09-10 13:43:13+00:00,is_pelssy,"And so who's the next again 
@DPR_RI",1,0,0,11980,https://x.com/is_pelssy/status/1965773055554384205,https://x.com/IndoPopBase/status/1965763662200934863,1
2025-09-11 02:26:16+00:00,·,"@fajojo1008
 ??",1,0,0,26,https://x.com/15j_cap/status/1965965082736865366,https://x.com/IndoPopBase/status/1965763662200934863,1
2025-09-12 16:15:36+00:00,ernaumar1954,Kmarin yg joget jg ee,0,0,0,3,https://x.com/ernaumar1954/status/1966536179261772275,https://x.com/IndoPopBase/status/1965763662200934863,0
2025-09-10 23:37:59+00:00,tuti_arif,"Masih ingat pernyataan kontroversial dia dulu ""Jangan hanya bersandar pada pemerintah untuk menyediakan pekerjaan, kita masih di jaman kolonial berarti,""  Dia aja masih minta pekerjaan ke pemerintah.",0,0,0,203,https://x.com/tuti_arif/status/1965922735173042375,https://x.com/IndoPopBase/status/1965763662200934863,0
2025-09-11 19:54:35+00:00,mercurial_world,AS SHE SHOULD with her nepobaby ahh,0,0,0,3,https://x.com/mercurial_world/status/1966228900545179958,https://x.com/IndoPopBase/status/1965763662200934863,0
2025-09-09 09:42:11+00:00,jojopetwit,"Kalian org2 kemenkeu nangis2 perpisahan sama ibu ini, ada juga loh ibu2 yg bund*r krn dipaksa berpisah sama anak2nya krn keadaan ekonominya.",20,382,0,82337,https://x.com/jojopetwit/status/1965350008544526524,https://x.com/IndoPopBase/status/1965301726548033855,402
2025-09-09 06:52:50+00:00,dodowiru,Heran menteri yg nir empati kepada rakyat spt ini kok masih dielukan?,80,160,0,113375,https://x.com/dodowiru/status/1965307390515155285,https://x.com/IndoPopBase/status/1965301726548033855,240
2025-09-09 06:44:12+00:00,I_mnonsometaX,"Kasihan sih sebenernya, rumahnya sudah dijarah & sekarang direshuffle.
Keinget peforma mantep dia pas pandemi kemarin, walaupun berat tapi dia bisa bawa ekonomi ga krisis & pemulihan cukup oke.
Semoga mendapat yang lebih baik ya bu",53,78,0,97370,https://x.com/I_mnonsometaX/status/1965305218796761393,https://x.com/IndoPopBase/status/1965301726548033855,131
2025-09-10 01:18:42+00:00,0xsubekti,pejabat diganti dan kalian ikut sedih. menangisi pejabat. MENANGISI PEJABAT. astaga kurang goblok apa coba ini wkwkwkwkwkwk,11,116,0,30405,https://x.com/0xsubekti/status/1965585690961608791,https://x.com/IndoPopBase/status/1965301726548033855,127
2025-09-09 06:33:03+00:00,0x_PingPing,"sorry ya bu mul
enjoy life sbg warga negara biasa bu, gak usa pusing dihujat masalah pajak lagi bu",6,27,0,69877,https://x.com/0x_PingPing/status/1965302414992703808,https://x.com/IndoPopBase/status/1965301726548033855,33
2025-09-09 06:34:52+00:00,amkathu18,Feel so sad for her .....15 yr in office that's not joke,3,8,0,33244,https://x.com/amkathu18/status/1965302869852361002,https://x.com/IndoPopBase/status/1965301726548033855,11
2025-09-09 06:38:20+00:00,SaddamWeb3,nangisnya mewakili semua rakyat atau cuma rekening pribadinya ya,1,2,0,22602,https://x.com/SaddamWeb3/status/1965303743035121746,https://x.com/IndoPopBase/status/1965301726548033855,3
2025-09-09 07:02:39+00:00,hazelnoode,beliau tuh sebetulnya kompeten bgt tapi ya gitu deeeeeh...,17,10,0,77889,https://x.com/hazelnoode/status/1965309864135328153,https://x.com/IndoPopBase/status/1965301726548033855,27
2025-09-09 07:08:13+00:00,varreldept,"semangat terus bu gkpp setidaknya dirimu sudah lepas dari bayang bayang atasan yg gak beres selama beberap tahun, dan tidak dimaki maki lagi sama warga negara, semoga setelah ini jadi lebih baik lagi bu, jasamu sudah begitu banyak untuk negara ini sejak 2005 ",12,16,0,59592,https://x.com/varreldept/status/1965311262189027426,https://x.com/IndoPopBase/status/1965301726548033855,28
2025-09-09 11:07:06+00:00,okezonenews,Sri Mulyani Menangis Saat Perpisahan dengan Pegawai Kemenkeu,4,3,0,19016,https://x.com/okezonenews/status/1965371379018248412,https://x.com/IndoPopBase/status/1965301726548033855,7
2025-09-09 08:22:50+00:00,0xHarryry,Terimakasih bu  respect,1,2,0,15423,https://x.com/0xHarryry/status/1965330041057017894,https://x.com/IndoPopBase/status/1965301726548033855,3
2025-09-09 09:36:50+00:00,detikinet,"Sri Mulyani pamit dari kabinet, netizen sampaikan ucapan terima kasih.",1,1,0,768,https://x.com/detikinet/status/1965348664307843580,https://x.com/IndoPopBase/status/1965301726548033855,2
2025-09-09 07:08:10+00:00,I_mnonsometaX,"Gendut omon2 sampah, baru ngeh negara ribut jumat pagi, kalau lu sadar lebih awal, bisa lu cegah tu usaha penjarahan2 itu, dia pun jadi gk harus resign, parjo mah, senang2 aja rusuh biar darurat militer. Makanya ndut, main hp, buka laptop, bukan baca memoar orde baru doang.",5,17,0,39822,https://x.com/I_mnonsometaX/status/1965311249761136702,https://x.com/IndoPopBase/status/1965301726548033855,22
2025-09-09 07:19:29+00:00,mdkousik31,"We know you did it because of work demands. Our message is, even if there’s another project, don’t let the people get squeezed.",1,3,0,28361,https://x.com/mdkousik31/status/1965314099472204226,https://x.com/IndoPopBase/status/1965301726548033855,4
2025-09-09 08:19:10+00:00,GalluZD,Akun² centang biru ini jujur komennya kaya bot anjir,0,0,0,630,https://x.com/GalluZD/status/1965329117790044639,https://x.com/IndoPopBase/status/1965301726548033855,0
2025-09-10 14:05:57+00:00,maverick_zaq,She marks people's blood on her hands,1,0,0,3738,https://x.com/maverick_zaq/status/1965778777017086237,https://x.com/IndoPopBase/status/1965301726548033855,1
2025-09-09 06:36:37+00:00,whatchamacallee,Sad but none of them can sing ijbol ,0,1,0,1941,https://x.com/whatchamacallee/status/1965303312422764958,https://x.com/IndoPopBase/status/1965301726548033855,1
2025-09-09 07:16:01+00:00,irsanpratama,"""kayanya saya kurang beli jco ini""

semoga sukses ditempat baru ya Bu.",1,5,0,31272,https://x.com/irsanpratama/status/1965313225832178111,https://x.com/IndoPopBase/status/1965301726548033855,6
2025-09-09 08:57:36+00:00,pernah_berharap,"Bu SMI jadi korban dari lingkaran setan kebodohan. Pemerintah gagal mencerdaskan bangsa→rakyat salah pilih pemimpin→lahir kebijakan absurd→rakyat protes. Siklus terus berulang, rakyat ingin semuanya ditanggung negara tapi tdk mau berusaha keluar dari lingkaran setan kebodohan.",0,4,0,10331,https://x.com/pernah_berharap/status/1965338791985775028,https://x.com/IndoPopBase/status/1965301726548033855,4
2025-09-09 06:41:46+00:00,lapisgenit,"despite gue kesel juga ama ni oma oma, gue tetep mengakui kalo doi ya kompeten dibidangnya. yaudah bu nikmatin aja nanti bayar pajak seperti warga negara biasa ",1,0,0,2129,https://x.com/lapisgenit/status/1965304608684999085,https://x.com/IndoPopBase/status/1965301726548033855,1
2025-09-09 08:26:46+00:00,ZainalKaimuddin,Salah sendiri... Selama 2025 banyak sekali pidato Menkeu ini tentang pajak dan pajak lagi seakan rakyat ditindas dan dikejar2 dgn pajak..padahal keadaan rakyat lagi susah pengangguran dimana2..yg bikin rakyat murka.Ternyata para pejabat dan anggota DPR tdk pernah bayar pajak.,4,6,0,3792,https://x.com/ZainalKaimuddin/status/1965331030279422463,https://x.com/IndoPopBase/status/1965301726548033855,10
2025-09-09 17:30:17+00:00,Faraz_kepri,"Sadarlah,Hutang yg di ciptakan nya slm berkuasa bersama Mulyono ditanggung Ampe anak Cucu kelak.

Tinggal KPK n kejaksaan aja lagi yg berani bekerja apa gak menangkap Maling2 berdasi di circle Mulyono",1,2,0,731,https://x.com/Faraz_kepri/status/1965467812278976673,https://x.com/IndoPopBase/status/1965301726548033855,3
2025-09-11 23:44:18+00:00,SenorJapones,"Dia bagus di awal2 doank, udah mendekati periode 2 di jokowi dan periode 1 pak wowo. Udah mulai mentingin Ego dan DPR sendiri. 

Dan lemahnya masyarakat indo, sngt forgiving dan NAIF. Demen di injek ",2,2,0,3483,https://x.com/SenorJapones/status/1966286713359409286,https://x.com/IndoPopBase/status/1965301726548033855,4
2025-09-09 06:43:16+00:00,fckngshibal,"Harusnya berhenti aja pas waktu itu, malah diakhir masa kerjanya bikin rakyat murka, kek aneh bgt perasaan dulu kerjanya “mungkin bener” tp kok tiba2 makin kesini makin ngalor ngidul, baguslah drpd makin terjerumus, tp masalahnya penggantinya kok kliatannya makin gk genah",4,0,0,6178,https://x.com/fckngshibal/status/1965304985161507004,https://x.com/IndoPopBase/status/1965301726548033855,4
2025-09-09 12:51:27+00:00,Abeeghl,"ga usah diromantisasi, pegawai kemenkeu jg tunjangan termasuk besar diantara K/L lain..paling tinggi ngisep pajak rakyat jg mereka, apalagi bea cukai idiihhh",0,0,0,288,https://x.com/Abeeghl/status/1965397640323235946,https://x.com/IndoPopBase/status/1965301726548033855,0
2025-09-10 05:14:16+00:00,ikhwantemanmain,"Pemuja SMI ini mirip pemuja mulyono...mau misahin kebijakan pemerintah slama ini dri SMI seakan2 SMI itu ga ada andil didlm kerusakan skrg

Emang ga ada positifnya memuja berlebihan",0,0,0,364,https://x.com/ikhwantemanmain/status/1965644976056131888,https://x.com/IndoPopBase/status/1965301726548033855,0
2025-09-09 12:52:14+00:00,allandbagus,"Kebijakan2 Neoliberal dia yg lolosin,
Deindustrialisasi & naiknya lapangan pekerjaan sektor informal terjadi di masa dia menjabat,
Indonesia is so doomed even Neolib praised as ""the best ministry"".",1,0,0,870,https://x.com/allandbagus/status/1965397839728837043,https://x.com/IndoPopBase/status/1965301726548033855,1
2025-09-09 07:53:05+00:00,Galois_Gen,Iya dong gaji klean gila2an dan tunjangannya bgmn ga terima kasih,0,0,0,182,https://x.com/Galois_Gen/status/1965322553473597563,https://x.com/IndoPopBase/status/1965301726548033855,0
2025-09-09 08:08:53+00:00,QueishaWijaya,Segera bertobat Sri atas kebijakan mu yg sudah menyusahkan raknyat kecil.,1,2,0,582,https://x.com/QueishaWijaya/status/1965326531024355731,https://x.com/IndoPopBase/status/1965301726548033855,3
2025-09-09 07:01:56+00:00,waystar2mirror,"Tau ga sih kenapa dia nangis? Alasan sesungguhnya?

""You're most likely become the next prey if you're out from the circle.""",0,0,0,558,https://x.com/waystar2mirror/status/1965309682450665741,https://x.com/IndoPopBase/status/1965301726548033855,0
2025-09-09 22:19:35+00:00,mamexis75,"Kalau ini orang bener, dia bakal ngundurin diri dari dulu... Dia tetep bertahan di pemerintahan yang nggak bener, dan ikut mencekik rakyat adalah bukti bahwa dia juga bagian dari kebobrokan... Gerombolan srigala menangisi srigala lainnya Hahaha",0,2,0,546,https://x.com/mamexis75/status/1965540616169029719,https://x.com/IndoPopBase/status/1965301726548033855,2
2025-09-09 13:43:04+00:00,lahsiapaaku_,"Setelah baca2 komen disini jd paham knp temen2 gua yg kerja di pajak pada sedih ampe bikin story titik2 isinya mpok sri semua, ternyata royal jg si mpok soal tunjangan sama bonus. Ealah ",1,2,0,250,https://x.com/lahsiapaaku_/status/1965410629516427632,https://x.com/IndoPopBase/status/1965301726548033855,3
2025-09-09 10:33:52+00:00,harmonisme,"Klo bandingin dia sama beliau. Cukup 1,5 taun dolar 17.000 jadi 7000. Si Sri mana bisa.",0,1,0,323,https://x.com/harmonisme/status/1965363015576064042,https://x.com/IndoPopBase/status/1965301726548033855,1
2025-09-12 02:55:33+00:00,MamangReborn,"Tolong 
@ditjen_imigrasi
 @KPK_RI
 @KejaksaanRI
 pantau terus ini menteri, jangan sampai kabur tanpa ada pertanggung jawaban setelah 10 tahun lebih ngutang sama meresin rakyat.",1,2,0,79,https://x.com/MamangReborn/status/1966334841286512660,https://x.com/IndoPopBase/status/1965301726548033855,3
2025-09-09 13:21:09+00:00,JubirKonoha,"Ekonomi 2026 jare iki 
@deniar9a
 hancur tur 
@gunturvans
 we Kon nandu emas Karo dollar jarene",2,1,0,991,https://x.com/JubirKonoha/status/1965405116401647650,https://x.com/IndoPopBase/status/1965301726548033855,3
2025-09-09 06:53:07+00:00,apagunanyayaya,"Dikasih nangis langsung melow. Lsg bersimpati. Ntar wowo nangis, melow lagi. Indog indog",2,0,0,3232,https://x.com/apagunanyayaya/status/1965307463911309541,https://x.com/IndoPopBase/status/1965301726548033855,2
2025-09-09 12:19:38+00:00,vvvong8,Shes too good for this country,6,1,0,7834,https://x.com/vvvong8/status/1965389631735955533,https://x.com/IndoPopBase/status/1965301726548033855,7
2025-09-09 07:29:50+00:00,ecilox,"Makanya jd pejabat itu candu.. dah mah duit sana sini.. giliran cabut dah kek pahlawan.. 

Orang kere lapar gegara salah kebijakan ga ada yg peduli..",1,0,0,878,https://x.com/ecilox/status/1965316702276931969,https://x.com/IndoPopBase/status/1965301726548033855,1
2025-09-10 01:56:47+00:00,HendiPermana96,"Ekonomi Indon gini² aja, ngapain sih nangisin Menteri?  yang telah menjabat lama tapi hasil tetep amburadul. Galak pajakin menengah ke bawah, lunak menjilat melayani kaum Oligarki.",0,1,0,120,https://x.com/HendiPermana96/status/1965595277991223775,https://x.com/IndoPopBase/status/1965301726548033855,1
2025-09-09 08:29:07+00:00,ifanahlaziraf,"dia itu kompeten, tapi terlalu lama di kekuasaan memang tidak baik. jangan lupa kita pernah berkeluh kesah soal coretax di awal tahun, diginiin aja kalian mewek ",0,0,0,767,https://x.com/ifanahlaziraf/status/1965331622015959456,https://x.com/IndoPopBase/status/1965301726548033855,0
2025-09-09 12:21:51+00:00,jankerzone,"Yg belakamg jg nangis dalam hati ""napa bukan gw yg gantiin""",1,0,0,13161,https://x.com/jankerzone/status/1965390191197389265,https://x.com/IndoPopBase/status/1965301726548033855,1
2025-09-09 07:26:59+00:00,yudiwibowo976,"... turut terharu & speachless, terima kasih atas segala kerja keras, loyalitas, dedikasi tanpa batas bagi negeri... Terima kasih ibu",1,1,0,337,https://x.com/yudiwibowo976/status/1965315984715334131,https://x.com/IndoPopBase/status/1965301726548033855,2
2025-09-11 06:30:27+00:00,RamboKombo,Dih,0,1,0,174,https://x.com/RamboKombo/status/1966026533740667202,https://x.com/IndoPopBase/status/1965301726548033855,1
2025-09-09 07:22:14+00:00,MDPMecca2000,,0,3,0,1354,https://x.com/MDPMecca2000/status/1965314792434139637,https://x.com/IndoPopBase/status/1965301726548033855,3
2025-09-09 07:15:12+00:00,I_mnonsometaX,"Sedih tapi gak ada satupun yang bisa nyanyi ijbol 

Yuk unfollow menteri keuangan yang baru ",1,0,0,12012,https://x.com/I_mnonsometaX/status/1965313021116580267,https://x.com/IndoPopBase/status/1965301726548033855,1
2025-09-09 15:36:04+00:00,lobaKaheureui,Dimana mana klo bos beri ke anak buah tunjangan besar maka akan membela bos bahkan sampai menangis pun rela.,0,0,0,99,https://x.com/lobaKaheureui/status/1965439067778416697,https://x.com/IndoPopBase/status/1965301726548033855,0
2025-09-09 14:41:08+00:00,dahlahseraaaah,"Stop MBG Pak 
@prabowo
 lebih baik dananya untuk pemerataan yg lain. MBG ini gak efektif. Mending bapak minta maaf karna program MBG tidak diteruskan daripada ekonomi negara ancur karna mendanai program yg gajelas.",0,0,0,285,https://x.com/dahlahseraaaah/status/1965425243180449909,https://x.com/IndoPopBase/status/1965301726548033855,0
2025-09-09 07:14:05+00:00,rubycln,Jelek bgt suaranya,0,0,0,266,https://x.com/rubycln/status/1965312738303123837,https://x.com/IndoPopBase/status/1965301726548033855,0
2025-09-09 08:19:37+00:00,GieMegumi,"Yang menyayangkan SM dicopot, skrg udh telat, kemane aje kalian waktu kemarin2.
Yg setuju SM dicopot, sudah dipenuhi. Skrg nikmati kerjanya menkeu yg baru dan berharaplah padanya.",1,0,0,770,https://x.com/GieMegumi/status/1965329232634200255,https://x.com/IndoPopBase/status/1965301726548033855,1
2025-09-09 06:34:53+00:00,bexthoven,dibikin drama dan dibuat tangisan trus rakyat bersimpati gitu?,0,0,0,1256,https://x.com/bexthoven/status/1965302875502030945,https://x.com/IndoPopBase/status/1965301726548033855,0
2025-09-09 06:08:40+00:00,0x_PingPing,"Teaser keliatan keren
Lets go 

Semoga gak ada yg comment 
BlackPink from indonesia",1,0,0,506,https://x.com/0x_PingPing/status/1965296278281257449,https://x.com/IndoPopBase/status/1965295220490469620,1
2025-09-09 23:49:19+00:00,RezaFahdini,Why this post is flopping..,0,0,0,91,https://x.com/RezaFahdini/status/1965563199413256230,https://x.com/IndoPopBase/status/1965295220490469620,0
2025-09-09 06:59:48+00:00,Itzgirii,So be ready for sad face ,0,0,0,29,https://x.com/Itzgirii/status/1965309145529364659,https://x.com/IndoPopBase/status/1965295220490469620,0
2025-09-09 06:05:23+00:00,achiever958,"Sad face 
On sept 10",0,0,0,329,https://x.com/achiever958/status/1965295451424592139,https://x.com/IndoPopBase/status/1965295220490469620,0
2025-09-09 07:10:13+00:00,Sugilico3,ini girlband dari Indo kah?,1,0,0,346,https://x.com/Sugilico3/status/1965311766336065896,https://x.com/IndoPopBase/status/1965295220490469620,1
2025-09-09 06:05:04+00:00,its_me_2sai56,"@grok
 explain",1,0,0,34,https://x.com/its_me_2sai56/status/1965295371682509113,https://x.com/IndoPopBase/status/1965295220490469620,1
2025-09-09 06:05:31+00:00,its_me_2sai56,Looks like beautiful music,0,0,0,26,https://x.com/its_me_2sai56/status/1965295483934679335,https://x.com/IndoPopBase/status/1965295220490469620,0
2025-09-09 07:08:20+00:00,hanicunz,"Netizen memang babikk kemarin lu hina hina skrg tbtb isi komennya ""keliatan ibu ini kerja tuntutan atasan, keliatan ibu ini lega nya lepas""

MEMANG NEGARA INI ISINYA ORG TOLOL ANYING GA KUATTT",35,169,0,30366,https://x.com/hanicunz/status/1965311291477950810,https://x.com/IndoPopBase/status/1965291354155827388,204
2025-09-09 06:07:56+00:00,orchiodea,"yaudah bu, sekarang anda nikmatin masa tua aja sekarang ya. jangan mau lagi jadi tameng dpr, kita tau kok anda begitu karna tuntutan kerja. pesan kami kalaupun ada projek lain jangan bikin rakyat yang kena cekek, anda cekek aja atasan anda itu.",3,46,0,23149,https://x.com/orchiodea/status/1965296093631316436,https://x.com/IndoPopBase/status/1965291354155827388,49
2025-09-09 06:13:37+00:00,4noblepursuit,how she felt like probably,0,23,0,16514,https://x.com/4noblepursuit/status/1965297522064380399,https://x.com/IndoPopBase/status/1965291354155827388,23
2025-09-09 08:23:24+00:00,mukaikhlas,bacot lu tolol,3,2,0,6760,https://x.com/mukaikhlas/status/1965330184221196661,https://x.com/IndoPopBase/status/1965291354155827388,5
2025-09-09 07:16:35+00:00,WOILAHN,komennya kenapa pada simpati dah? padahal kemaren disuruh turun gara2 kebijakannya mencekek rakyat BE FR.,3,9,0,8168,https://x.com/WOILAHN/status/1965313367117295874,https://x.com/IndoPopBase/status/1965291354155827388,12
2025-09-09 06:05:03+00:00,SaddamWeb3,ada yg masih mau nanya pajak? coba sini maju,1,0,0,2900,https://x.com/SaddamWeb3/status/1965295367131631779,https://x.com/IndoPopBase/status/1965291354155827388,1
2025-09-09 06:07:50+00:00,Ikuzoo23,"Yang nyalahin ibu nya mah ga ngerti apa2, dia naikin pajak juga ya karena perintah dari presiden bukan karena kemauan dia. Emg masyarakat indo pantes buat dapat presiden sekarang karena mau dibodoh2in. Terima kasih bu buat baktinya selama itu buat indonesia",15,14,0,22902,https://x.com/Ikuzoo23/status/1965296066590638273,https://x.com/IndoPopBase/status/1965291354155827388,29
2025-09-09 07:31:03+00:00,Sunyisejati,TERUS HUTANG NEGARA SIAPA YG BAYAR INI???,0,1,0,631,https://x.com/Sunyisejati/status/1965317010570821895,https://x.com/IndoPopBase/status/1965291354155827388,1
2025-09-09 05:52:59+00:00,RintSo,Speak up aja bu,0,0,0,2744,https://x.com/RintSo/status/1965292330048782489,https://x.com/IndoPopBase/status/1965291354155827388,0
2025-09-09 09:10:55+00:00,justbeyonced,She rn,0,0,0,195,https://x.com/justbeyonced/status/1965342142932680842,https://x.com/IndoPopBase/status/1965291354155827388,0
2025-09-09 10:38:42+00:00,riantogi_,"Beliau ini kompeten dan hebat. Hanya saja lingkarannya yg membuat dia terlihat buruk. Satu pemikirannya yg masih kuingat dan kudawamkan sampai hari ini, “Jangan kita kerja keras, tapi aset kita tidur. Harusnya aset kita yg kerja keras, kita kerja cerdas.”",1,0,0,1104,https://x.com/riantogi_/status/1965364233794920645,https://x.com/IndoPopBase/status/1965291354155827388,1
2025-09-09 10:55:58+00:00,Om_HME,"Enak saja mau lepas tangan, sdh jerumuskan negara ke jurang utang.

Pertanggungjawaban tetap diminta nantinya, meski tdk lg menjabat.",1,0,0,333,https://x.com/Om_HME/status/1965368577718190148,https://x.com/IndoPopBase/status/1965291354155827388,1
2025-09-09 07:11:38+00:00,pawliticss,"Terimakasih banyak bu, untuk dedikasinya untuk Indonesia, ibu sudah tidak perlu pusing lagi, dan sudah bisa menikmati masa tua bersama keluarga, kita tau sepak terjang ibu selama ini meskipun ada beberapa yang kontra tapi itu merupakan tuntutan kerja, Terimakasih Sri Mulyani",1,0,0,1931,https://x.com/pawliticss/status/1965312122340172162,https://x.com/IndoPopBase/status/1965291354155827388,1
2025-09-09 05:54:17+00:00,AmalaNovi,"Terimakasih atas dedikasinya, terlepas dari banyak pro-kontra dengan kebijakannya.",0,1,0,1837,https://x.com/AmalaNovi/status/1965292657737171024,https://x.com/IndoPopBase/status/1965291354155827388,1
2025-09-09 05:54:15+00:00,mmmmmmotz,"Happy retirement, Ibu Sri Mulyani",0,0,0,3844,https://x.com/mmmmmmotz/status/1965292647565984038,https://x.com/IndoPopBase/status/1965291354155827388,0
2025-09-09 09:23:56+00:00,Abdoeljegger202,"Tapi soal utang 8rb trilyun yang diwariskan tentu bukan wilayah privatmu toh jeng ?
Negara masih membutuhkan pertanggungjawabanmu !",1,0,0,223,https://x.com/Abdoeljegger202/status/1965345416591077448,https://x.com/IndoPopBase/status/1965291354155827388,1
2025-09-09 05:52:49+00:00,kekpe1er,Gmw bakal gw ttep bully online wleee,1,0,0,2392,https://x.com/kekpe1er/status/1965292289980600803,https://x.com/IndoPopBase/status/1965291354155827388,1
2025-09-11 18:28:21+00:00,wingkyp,Buat yang mo mikir ..,0,1,0,36,https://x.com/wingkyp/status/1966207200038367565,https://x.com/IndoPopBase/status/1965291354155827388,1
2025-09-09 08:18:11+00:00,Uva_msy,"kalau dilihat dari pembangunan ugal2an periode lalu, wajar sih kalau pajak naik. yg kemaren pengen ibu mundur, mnurut kalian siapa sih yg paling pantes untuk menjabat di menkeu?",6,0,0,3470,https://x.com/Uva_msy/status/1965328872729444662,https://x.com/IndoPopBase/status/1965291354155827388,6
2025-09-09 06:54:49+00:00,ohlalababy0606,"Kok gak ada hand over kerjaan dulu ke yg baru trus perpisahan beli jco seperti resign di perusahaan, ntar uang jasanya ditahan hrd lho wkwkwk",1,0,0,1772,https://x.com/ohlalababy0606/status/1965307890920812994,https://x.com/IndoPopBase/status/1965291354155827388,1
2025-09-09 12:36:27+00:00,jonmamau,Orang ini baru saja nerbitkan sun dan menambah utang negara yg akan sulit dibayar.,1,0,0,170,https://x.com/jonmamau/status/1965393865336389922,https://x.com/IndoPopBase/status/1965291354155827388,1
2025-09-09 07:37:21+00:00,akunbudakkucing,"Padahal di antara yg lain. Dia ini yg lumayan waras. Apesnya dia jadi bumper terus, jadi tameng, pernyataannya  sering dipelintir.",1,0,0,1194,https://x.com/akunbudakkucing/status/1965318596088995960,https://x.com/IndoPopBase/status/1965291354155827388,1
2025-09-09 05:56:43+00:00,HeyOm_Oky,"Selamat menikmati hari² pensiun bu sri
x.com/IndoPopBase/st
…",0,0,0,1350,https://x.com/HeyOm_Oky/status/1965293269207974274,https://x.com/IndoPopBase/status/1965291354155827388,0
2025-09-09 09:40:36+00:00,·,"U will be missed, queen ",2,0,0,153,https://x.com/memekcita/status/1965349613222986020,https://x.com/IndoPopBase/status/1965291354155827388,2
2025-09-09 06:47:34+00:00,takutkesuspendd,Selamat menikmati kebebasan Bu,1,0,0,700,https://x.com/takutkesuspendd/status/1965306064368517185,https://x.com/IndoPopBase/status/1965291354155827388,1
2025-09-09 06:12:42+00:00,SejahteraT1234,BU SRIMUL TETEP MASIH YANG TERBAIK ,1,0,0,1048,https://x.com/SejahteraT1234/status/1965297293269373138,https://x.com/IndoPopBase/status/1965291354155827388,1
2025-09-09 08:00:50+00:00,gussman4,Kita lihat nanti dengan gaya Menkeu baru yang asli ABS mau dibikin apa negara ini?,1,0,0,891,https://x.com/gussman4/status/1965324506454782330,https://x.com/IndoPopBase/status/1965291354155827388,1
2025-09-09 08:03:15+00:00,AliSafi_i,"Sri mulyani ingin digantikan alias minta mengundurkan diri karena rumahnya jadi korban permainan politik demo kerusuhan agustus kemarin, benarkan demikian",1,0,0,1128,https://x.com/AliSafi_i/status/1965325114528219194,https://x.com/IndoPopBase/status/1965291354155827388,1
2025-09-09 06:25:49+00:00,akmal_ardi78,"Terimakasih buat Sri mulyani, atas dedikasi serta kinerja nya untuk negara bobrok ini",0,0,0,1852,https://x.com/akmal_ardi78/status/1965300593901404372,https://x.com/IndoPopBase/status/1965291354155827388,0
2025-09-09 06:15:27+00:00,ZeroPnumbra,Duit utangan negara yg ribuan triliun pada kemana Mul ,4,0,0,8228,https://x.com/ZeroPnumbra/status/1965297983303680034,https://x.com/IndoPopBase/status/1965291354155827388,4
2025-09-09 09:18:22+00:00,CahyoMahanani,"Hi 
@grok
 , pada saat serah terima jabatan, berapa total hutang Indonesia, dan berapa beban bunga serta total hutang jatuh tempo tahun ini ?",1,0,0,497,https://x.com/CahyoMahanani/status/1965344016326922676,https://x.com/IndoPopBase/status/1965291354155827388,1
2025-09-09 06:06:16+00:00,txtdriAnatolia,Berarti mungkin diresuffle atas permintaan sendiri karena insiden penjarahan kemarin,1,0,0,1015,https://x.com/txtdriAnatolia/status/1965295671696920692,https://x.com/IndoPopBase/status/1965291354155827388,1
2025-09-09 11:35:29+00:00,luvyyisss,"Gak pernah ikut nyuruh dia mundur,cuma kesel aja sama dia pas bilang guru adalah beban negara",4,0,0,1021,https://x.com/luvyyisss/status/1965378524971471169,https://x.com/IndoPopBase/status/1965291354155827388,4
2025-09-09 09:14:15+00:00,ady018776342248,Akhirnya 'merdeka' juga Ibu ini,1,0,0,127,https://x.com/ady018776342248/status/1965342979914338542,https://x.com/IndoPopBase/status/1965291354155827388,1
2025-09-09 06:00:51+00:00,0xgasm,bang banyak buzzer nyalahin sri mul di komen,0,0,0,602,https://x.com/0xgasm/status/1965294310456524986,https://x.com/IndoPopBase/status/1965291354155827388,0
2025-09-09 06:54:21+00:00,Sugilico3,Terima kasih atas jasa jasanya ibu. Saya merasa menteri pengganti ibu koq tidak sepengalaman ibu ya,1,0,0,405,https://x.com/Sugilico3/status/1965307772788244879,https://x.com/IndoPopBase/status/1965291354155827388,1
2025-09-10 05:28:57+00:00,ufftania,Makasii ya buk untuk selama inii.. ,0,0,0,26,https://x.com/ufftania/status/1965648668369060219,https://x.com/IndoPopBase/status/1965291354155827388,0
2025-09-10 04:51:59+00:00,bellyahhhh,"Bisa cek di video ini juga 
go.paid4link.com/2nT9h9",0,0,0,15,https://x.com/bellyahhhh/status/1965639366027727058,https://x.com/IndoPopBase/status/1965291354155827388,0
2025-09-09 16:13:02+00:00,CreatorsZa10300,makasih bu atas jasa2nya,0,0,0,2,https://x.com/CreatorsZa10300/status/1965448368920166457,https://x.com/IndoPopBase/status/1965291354155827388,0
2025-09-11 12:05:29+00:00,ichapkt,"Keluar, jangan ada kita liat muka mu yg corrupsi",0,0,0,12,https://x.com/ichapkt/status/1966110850353345022,https://x.com/IndoPopBase/status/1965291354155827388,0
2025-09-09 15:01:15+00:00,catstellarr,Kok kaya sedih ya :(,0,0,0,4,https://x.com/catstellarr/status/1965430304103117171,https://x.com/IndoPopBase/status/1965291354155827388,0
2025-09-09 07:11:19+00:00,Lembonganpenida,"Salah satu wanita tercerdas yg di miliki Indonesia, dgn nama yg Indonesia bgt “Bu Sri. Sangat Wajar beliau kecewa dgn keamanan negara yg tdk bs melindungi pejabat selevel menteri senior aktif. Liat acara live pelepasan nya di tv bikin mewek  staff kemenekeu pd mewek jg. Thx bu",0,0,0,17,https://x.com/Lembonganpenida/status/1965312045022322881,https://x.com/IndoPopBase/status/1965291354155827388,0
2025-09-10 17:01:57+00:00,Sinculi84,Bosnya Rafael Alun nih,0,0,0,10,https://x.com/Sinculi84/status/1965823068045226191,https://x.com/IndoPopBase/status/1965291354155827388,0
2025-09-09 17:35:09+00:00,ininick_,"Semoga ini keputusan yang bijak, sulit sekali bisa percaya posisi tersebut diisi selain beliau ",1,0,0,163,https://x.com/ininick_/status/1965469035849810091,https://x.com/IndoPopBase/status/1965291354155827388,1
2025-09-09 07:39:37+00:00,BregasJiwaraga,Postinganmu kopet.   Seharusnya tangkap SriMul.   Usut tuntas kasusnya,0,0,0,182,https://x.com/BregasJiwaraga/status/1965319166925431162,https://x.com/IndoPopBase/status/1965291354155827388,0
2025-09-09 07:16:58+00:00,y_alharitsi,Yaudah Bu jadi WNI pajak yg mahal itu,0,0,0,481,https://x.com/y_alharitsi/status/1965313464878219760,https://x.com/IndoPopBase/status/1965291354155827388,0
2025-09-09 07:32:11+00:00,ramaaldi_,Mau balik ke pringsewu ya bu,1,0,0,306,https://x.com/ramaaldi_/status/1965317292545507672,https://x.com/IndoPopBase/status/1965291354155827388,1
2025-09-09 06:17:58+00:00,gevanforreal,y,0,0,0,551,https://x.com/gevanforreal/status/1965298616115048544,https://x.com/IndoPopBase/status/1965291354155827388,0
2025-09-09 10:51:32+00:00,QieTiny,"Semangat cinta indonesia. btw mainan ini lucu banget 
s.shopee.co.id/2qL2gdDKf2 mau ?",0,0,0,35,https://x.com/QieTiny/status/1965367464470135217,https://x.com/IndoPopBase/status/1965291354155827388,0
2025-09-09 15:02:17+00:00,Tyusproject,Real merdeka finansial,1,0,0,78,https://x.com/Tyusproject/status/1965430567752913219,https://x.com/IndoPopBase/status/1965291354155827388,1
2025-09-09 05:41:32+00:00,Indomielovers,55 tahun jadi seleramu and still counting ... ,40,77,0,31782,https://x.com/Indomielovers/status/1965289447525941643,https://x.com/IndoPopBase/status/1965274277688869246,117
2025-09-09 05:44:24+00:00,SaddamWeb3,which flavor carried your childhood?,1,2,0,11741,https://x.com/SaddamWeb3/status/1965290170594591006,https://x.com/IndoPopBase/status/1965274277688869246,3
2025-09-09 09:12:04+00:00,boyhendryko,hepi birtday indomi,6,2,0,18632,https://x.com/boyhendryko/status/1965342429533667692,https://x.com/IndoPopBase/status/1965274277688869246,8
2025-09-09 09:24:45+00:00,mukaikhlas,andalan,0,0,0,10348,https://x.com/mukaikhlas/status/1965345622615282025,https://x.com/IndoPopBase/status/1965274277688869246,0
2025-09-09 04:47:43+00:00,0x_PingPing,"And still the best until today 
Lets debate kalian pecinta mie laen ",1,0,0,6823,https://x.com/0x_PingPing/status/1965275905158512875,https://x.com/IndoPopBase/status/1965274277688869246,1
2025-09-09 04:49:53+00:00,Goboovi,Indomie still hits every time,0,0,0,4640,https://x.com/Goboovi/status/1965276449688186934,https://x.com/IndoPopBase/status/1965274277688869246,0
2025-09-09 18:05:09+00:00,widzeth,Kesukaan aku indomie goreng lho,0,0,0,4879,https://x.com/widzeth/status/1965476585139740848,https://x.com/IndoPopBase/status/1965274277688869246,0
2025-09-09 04:41:57+00:00,Mr_Siomay,"@grok
 kenapa rasa indomie sekarang berbeda jauh dengan 55 tahun lalu?",1,0,0,8479,https://x.com/Mr_Siomay/status/1965274455648993541,https://x.com/IndoPopBase/status/1965274277688869246,1
2025-09-10 12:04:25+00:00,afilmhead,Indomie is more Nigerian than Indonesian,4,4,0,10709,https://x.com/afilmhead/status/1965748193377009752,https://x.com/IndoPopBase/status/1965274277688869246,8
2025-09-10 17:37:25+00:00,moe_xyzzz,"Just realised Indo in Indomie stands for Indonesia, and mie means noodles in Indonesian

So literally, Indomie = Indonesian noodles ",2,7,0,6244,https://x.com/moe_xyzzz/status/1965831996086829163,https://x.com/IndoPopBase/status/1965274277688869246,9
2025-09-10 15:10:44+00:00,angel__okey,Thank you for all you do for the common man of Nigeria  we love eating you,0,0,0,533,https://x.com/angel__okey/status/1965795079765049377,https://x.com/IndoPopBase/status/1965274277688869246,0
2025-09-09 12:35:54+00:00,bedazzleddreams,"Happy birthday to life saving innovation, main dish and backup food, fulfilling midday and midnight snack, recipe testing media, discourse stimulus, business staple, national treasure, export commodity, and last but not least a friend in our hearts.",0,1,0,1944,https://x.com/bedazzleddreams/status/1965393725720609012,https://x.com/IndoPopBase/status/1965274277688869246,1
2025-09-09 04:46:16+00:00,Sagar_tarak18,indonesia  food ,0,0,0,6621,https://x.com/Sagar_tarak18/status/1965275541252309298,https://x.com/IndoPopBase/status/1965274277688869246,0
2025-09-09 07:13:48+00:00,varreldept,sehat sehat yg punya resep indomie ,2,0,0,13494,https://x.com/varreldept/status/1965312666232394154,https://x.com/IndoPopBase/status/1965274277688869246,2
2025-09-10 12:43:48+00:00,Dedy44169434,and it change the history cos it was seenak ituuuh,0,1,0,387,https://x.com/Dedy44169434/status/1965758102051164527,https://x.com/IndoPopBase/status/1965274277688869246,1
2025-09-11 13:19:04+00:00,lPosumA0209,"Bukannya Indomie itu diluncurkannya Tahun 1972? Harusnya sekarang masih 53 Tahun. Kalau 55 Tahun, berarti Tahun 2027 nanti.",0,0,0,153,https://x.com/lPosumA0209/status/1966129367219847345,https://x.com/IndoPopBase/status/1965274277688869246,0
2025-09-10 10:22:43+00:00,dwirsmile,"Min 
@Indomielovers
 , kok varian ini sulit ditemui di Pulau Jawa ya?",1,0,0,1691,https://x.com/dwirsmile/status/1965722597271933107,https://x.com/IndoPopBase/status/1965274277688869246,1
2025-09-09 04:45:33+00:00,0xgasm,rasanya asin sekarang,0,0,0,4360,https://x.com/0xgasm/status/1965275360507072738,https://x.com/IndoPopBase/status/1965274277688869246,0
2025-09-11 07:59:03+00:00,OPLeye_,One of the greatest Nigerian imports.,0,0,0,1787,https://x.com/OPLeye_/status/1966048830152995319,https://x.com/IndoPopBase/status/1965274277688869246,0
2025-09-09 04:42:17+00:00,achiever958,55 yrs ago,0,0,0,4762,https://x.com/achiever958/status/1965274536242499895,https://x.com/IndoPopBase/status/1965274277688869246,0
2025-09-11 03:08:52+00:00,Anegbe_,So it's called INDOmie cus it's INDONESIA-Meal,1,0,0,3044,https://x.com/Anegbe_/status/1965975805189828891,https://x.com/IndoPopBase/status/1965274277688869246,1
2025-09-09 17:19:24+00:00,supperince,Best thing to ever happen in this country,0,0,0,432,https://x.com/supperince/status/1965465073465585766,https://x.com/IndoPopBase/status/1965274277688869246,0
2025-09-09 13:36:38+00:00,bjorde,omg how did anak kostan manage to survive 56 years ago ,0,0,0,1008,https://x.com/bjorde/status/1965409010255036841,https://x.com/IndoPopBase/status/1965274277688869246,0
2025-09-10 19:57:30+00:00,o_koli,Why didn’t Tinubu coordinate direct flights between Nigeria and Indonesia just for this?,0,0,0,188,https://x.com/o_koli/status/1965867246326358357,https://x.com/IndoPopBase/status/1965274277688869246,0
2025-09-10 12:29:44+00:00,Kale_eh,There is supposed indomie cooking competition- Nigeria(mai shayi) vs Indonesia,0,0,0,792,https://x.com/Kale_eh/status/1965754561911738426,https://x.com/IndoPopBase/status/1965274277688869246,0
2025-09-11 18:59:05+00:00,BeansCFR,"75% market share (if am not mistaken), maintaining the same taste, same craving, same target market for 55years... The fact that Dangote came, saw shege and left them alone says alot about their brand and marketing",0,0,0,104,https://x.com/BeansCFR/status/1966214934171209987,https://x.com/IndoPopBase/status/1965274277688869246,0
2025-09-10 19:25:45+00:00,pleasewelcum,"jd inget pas lagi traveling ke Taipe, krn jalan2 pake sepatu ga nyaman bkn kaki lecet,pake lotion ga mempan,nyari baby oil gak nemu, pas di 711 nemu indomie, akhirnya gua beli dan minyaknya olesin ke kaki biar ga lecet lagi, dan beneran dong ampuh kayak pake minyak sayur hahaha",0,0,0,692,https://x.com/pleasewelcum/status/1965859257548714167,https://x.com/IndoPopBase/status/1965274277688869246,0
2025-09-10 17:15:43+00:00,Afefe4live,The Indomie we ate growing up was better than what we have now,0,0,0,548,https://x.com/Afefe4live/status/1965826531282083971,https://x.com/IndoPopBase/status/1965274277688869246,0
2025-09-10 17:15:03+00:00,Afefe4live,"The Indomie we are growing up is different from the one we are eating now why, it has different taste",1,0,0,935,https://x.com/Afefe4live/status/1965826367632847004,https://x.com/IndoPopBase/status/1965274277688869246,1
2025-09-09 05:17:19+00:00,me_mekha,thankyou indonesia for this amazing creation ,0,0,0,441,https://x.com/me_mekha/status/1965283353604825114,https://x.com/IndoPopBase/status/1965274277688869246,0
2025-09-11 18:27:26+00:00,mengetiknama,"Makan 1 kurang, makan 18 kebanyakan",0,0,0,68,https://x.com/mengetiknama/status/1966206970500895072,https://x.com/IndoPopBase/status/1965274277688869246,0
2025-09-10 14:30:24+00:00,TheUnibenBlog,"Indomie was launched 55 years ago today

Here are some interesting facts",0,0,0,45,https://x.com/TheUnibenBlog/status/1965784931508064331,https://x.com/IndoPopBase/status/1965274277688869246,0
2025-09-09 04:48:13+00:00,mdkousik31,"But what is Indomie? 
@grok",1,0,0,10834,https://x.com/mdkousik31/status/1965276032870875587,https://x.com/IndoPopBase/status/1965274277688869246,1
2025-09-09 05:06:10+00:00,MindaXtv,This is Legend ...,0,0,0,135,https://x.com/MindaXtv/status/1965280549276471602,https://x.com/IndoPopBase/status/1965274277688869246,0
2025-09-10 15:31:26+00:00,obzerf,Thank you indomie,0,0,0,373,https://x.com/obzerf/status/1965800289111511431,https://x.com/IndoPopBase/status/1965274277688869246,0
2025-09-09 11:23:26+00:00,rizkihadirahmat,Indomie goreng & ayam bawang engga ada lawan ,0,0,0,633,https://x.com/rizkihadirahmat/status/1965375490996535407,https://x.com/IndoPopBase/status/1965274277688869246,0
2025-09-11 07:54:37+00:00,Hpriyna,"Mau itu sedap, sakura, sarimi. Tetap ""Belieee buk, beli indomie atuu.. """,0,0,0,193,https://x.com/Hpriyna/status/1966047714380337604,https://x.com/IndoPopBase/status/1965274277688869246,0
2025-09-09 05:42:50+00:00,VartbroSeafarer,"Indomie, the wallet's best friend when times get tough!  No matter the crisis, a bowl of Indomie always hits the spot. Happy 55th birthday, noodle legend!  #Indomie""",0,0,0,373,https://x.com/VartbroSeafarer/status/1965289774769643941,https://x.com/IndoPopBase/status/1965274277688869246,0
2025-09-10 03:36:21+00:00,rdnms16,Can't imagine what live was like before Indomie.,0,0,0,1085,https://x.com/rdnms16/status/1965620334687895945,https://x.com/IndoPopBase/status/1965274277688869246,0
2025-09-10 16:06:10+00:00,Milabobette1,Mon repas flemme ,0,0,0,277,https://x.com/Milabobette1/status/1965809028715704385,https://x.com/IndoPopBase/status/1965274277688869246,0
2025-09-09 05:30:50+00:00,412Y00,Life Saver,0,0,0,222,https://x.com/412Y00/status/1965286757110546858,https://x.com/IndoPopBase/status/1965274277688869246,0
2025-09-10 00:40:06+00:00,ATHARS_YAPP,Old af noodle,0,0,0,203,https://x.com/ATHARS_YAPP/status/1965575977121263912,https://x.com/IndoPopBase/status/1965274277688869246,0
2025-09-11 06:13:29+00:00,Fake__IDs,Just ate 1 today ,0,0,0,329,https://x.com/Fake__IDs/status/1966022265042252078,https://x.com/IndoPopBase/status/1965274277688869246,0
2025-09-09 15:15:02+00:00,looonalovegood,Selamat ulang tahun Indomiiii ,0,0,0,594,https://x.com/looonalovegood/status/1965433773434269862,https://x.com/IndoPopBase/status/1965274277688869246,0
2025-09-10 21:09:47+00:00,Goodman_Raay,The same way I thought Chivita was owned by a Igbo Nigerian because it had Chi in front of it ,0,0,0,429,https://x.com/Goodman_Raay/status/1965885439887520208,https://x.com/IndoPopBase/status/1965274277688869246,0
2025-09-10 14:32:59+00:00,4pfHoncho,Greatness,0,0,0,350,https://x.com/4pfHoncho/status/1965785580517957923,https://x.com/IndoPopBase/status/1965274277688869246,0
2025-09-09 14:59:34+00:00,BIGFATOOMPALOO2,Legit most amazing mie brand ever,0,0,0,761,https://x.com/BIGFATOOMPALOO2/status/1965429880696496140,https://x.com/IndoPopBase/status/1965274277688869246,0
2025-09-09 04:57:48+00:00,arimayha,Indomie bahasa inggris sama bahasa indonesia itu beda rasa kah?,0,0,0,550,https://x.com/arimayha/status/1965278440736915736,https://x.com/IndoPopBase/status/1965274277688869246,0
2025-09-09 10:48:42+00:00,neirarz,55 tahun hadir menemani anak kost,0,0,0,624,https://x.com/neirarz/status/1965366749303607626,https://x.com/IndoPopBase/status/1965274277688869246,0
2025-09-09 10:44:37+00:00,iamhans_wg,Indomie rasa ayam bawang is my top tier,0,0,0,596,https://x.com/iamhans_wg/status/1965365722860978648,https://x.com/IndoPopBase/status/1965274277688869246,0
2025-09-09 04:23:55+00:00,pawliticss,Kek bocil kalo ga diajak main unfollow wkwkwk,5,254,0,141550,https://x.com/pawliticss/status/1965269915755315599,https://x.com/IndoPopBase/status/1965267941785829723,259
2025-09-09 05:57:56+00:00,I_mnonsometaX,"malesnya dan toxic nya politik di Indonesia gitu, politik balas budi, sekali di ganti karena emang kinerjanya gebene, lgs jadi musuhan.. terbukti semua hanya demi jabatan, gada tujuan sama sekali untuk bangun negara bersama2",15,231,0,97163,https://x.com/I_mnonsometaX/status/1965293573831831616,https://x.com/IndoPopBase/status/1965267941785829723,246
2025-09-09 14:42:59+00:00,cursedkidd,taurus emg gitu,182,274,0,86752,https://x.com/cursedkidd/status/1965425710874648639,https://x.com/IndoPopBase/status/1965267941785829723,456
2025-09-09 04:40:21+00:00,coffebit,lagi bete gamau liat postingannya ndan wowo,3,77,0,84890,https://x.com/coffebit/status/1965274053264199834,https://x.com/IndoPopBase/status/1965267941785829723,80
2025-09-09 04:48:04+00:00,CallMeeRif21,"Yok bisa yok 
@KPK_RI
  periksai si budie arie ini geram soalnya ngerasa gak kesentuh dr kasus judol dulu",4,63,0,42556,https://x.com/CallMeeRif21/status/1965275992018317785,https://x.com/IndoPopBase/status/1965267941785829723,67
2025-09-09 04:29:39+00:00,KampusUpdate,Udah kek dispatch,2,26,0,108364,https://x.com/KampusUpdate/status/1965271357039796540,https://x.com/IndoPopBase/status/1965267941785829723,28
2025-09-09 07:48:39+00:00,tang__kira,Day 1 diputusin,0,34,0,35509,https://x.com/tang__kira/status/1965321439512592549,https://x.com/IndoPopBase/status/1965267941785829723,34
2025-09-09 08:08:32+00:00,plisitin,"wowo:

""unfoll? block!""",3,33,0,7941,https://x.com/plisitin/status/1965326440574181629,https://x.com/IndoPopBase/status/1965267941785829723,36
2025-09-09 04:43:17+00:00,bareda,Kapan dipenjara? Ingetin terus,2,81,0,92491,https://x.com/bareda/status/1965274787791655373,https://x.com/IndoPopBase/status/1965267941785829723,83
2025-09-09 04:21:42+00:00,admiralkizaruuu,Ciee ngambekk,1,4,0,45361,https://x.com/admiralkizaruuu/status/1965269356352602335,https://x.com/IndoPopBase/status/1965267941785829723,5
2025-09-09 04:28:48+00:00,SaddamWeb3,bro went from cabinet reshuffle to instagram reshuffle real quick lmao,0,26,0,50432,https://x.com/SaddamWeb3/status/1965271144677999076,https://x.com/IndoPopBase/status/1965267941785829723,26
2025-09-09 04:19:50+00:00,RezaFahdini,,1,2,0,2376,https://x.com/RezaFahdini/status/1965268888549257228,https://x.com/IndoPopBase/status/1965267941785829723,3
2025-09-09 04:32:29+00:00,glowinbeautyy,Uhuy ada yg pundung,1,0,0,12087,https://x.com/glowinbeautyy/status/1965272070788649424,https://x.com/IndoPopBase/status/1965267941785829723,1
2025-09-09 05:34:57+00:00,DS_yantie,Budi Arie ngambek ,2,0,0,7320,https://x.com/DS_yantie/status/1965287792185147585,https://x.com/IndoPopBase/status/1965267941785829723,2
2025-09-09 04:34:25+00:00,FeaKreuzz,Ditunggu janjinya Pak. Kita pengen liat,0,7,0,1115,https://x.com/FeaKreuzz/status/1965272556010963259,https://x.com/IndoPopBase/status/1965267941785829723,7
2025-09-09 04:26:30+00:00,pamankecilke6,Majikan yang sesungguhnya,1,0,0,1980,https://x.com/pamankecilke6/status/1965270565180375440,https://x.com/IndoPopBase/status/1965267941785829723,1
2025-09-09 05:58:15+00:00,I_mnonsometaX,"Ciri manusia oportunis adalah, ketika urusannya selesai dengan suatu hal, dia langsung unfollow sosmed yg berhubungan dengan dia sebelumnya.

Anak anjing emang.",4,0,0,16714,https://x.com/I_mnonsometaX/status/1965293653603352727,https://x.com/IndoPopBase/status/1965267941785829723,4
2025-09-09 04:26:36+00:00,vicko_twitt,Udah tua baperan pulak,0,4,0,1583,https://x.com/vicko_twitt/status/1965270591918985363,https://x.com/IndoPopBase/status/1965267941785829723,4
2025-09-09 04:57:07+00:00,SUNSETW1TCH,"Apa ngga sekalian abis unfollowan langsung kirim menfess ke base, ""saranin kegiatan life after break up""",0,2,0,497,https://x.com/SUNSETW1TCH/status/1965278270800400723,https://x.com/IndoPopBase/status/1965267941785829723,2
2025-09-09 06:05:03+00:00,derarang,Keliatan kan mental penjilatnya ,0,0,0,2709,https://x.com/derarang/status/1965295368058581366,https://x.com/IndoPopBase/status/1965267941785829723,0
2025-09-09 04:32:39+00:00,babimangkal,kylie jenner and jordyn woods tease,1,0,0,1333,https://x.com/babimangkal/status/1965272112404611372,https://x.com/IndoPopBase/status/1965267941785829723,1
2025-09-09 04:24:32+00:00,alvarezrock1,"Ciri manusia oportunis adalah, ketika urusannya selesai dengan suatu hal, dia langsung unfollow sosmed yg berhubungan dengan dia sebelumnya.

Anak anjing emang.",1,0,0,1656,https://x.com/alvarezrock1/status/1965270072227983619,https://x.com/IndoPopBase/status/1965267941785829723,1
2025-09-09 05:23:29+00:00,0xfrsmln,awikwok tumben kelakuan kocaknya bisa diketawain nih,0,0,0,8316,https://x.com/0xfrsmln/status/1965284904029286702,https://x.com/IndoPopBase/status/1965267941785829723,0
2025-09-09 04:17:33+00:00,tastysuryapro,"betenya jelek, seleketep",0,0,0,960,https://x.com/tastysuryapro/status/1965268312235073606,https://x.com/IndoPopBase/status/1965267941785829723,0
2025-09-09 06:14:47+00:00,I_mnonsometaX,"Dia ini termasuk salah satu anggota ""Geng Solo"", kan? 
Menarik, semoga kasus judi online akan semakin terbuka untuk diselidiki.",1,2,0,14341,https://x.com/I_mnonsometaX/status/1965297814139011423,https://x.com/IndoPopBase/status/1965267941785829723,3
2025-09-09 07:18:04+00:00,I_mnonsometaX,"Kasihan sih sebenernya, rumahnya sudah dijarah & sekarang direshuffle.
Keinget peforma mantep dia pas pandemi kemarin, walaupun berat tapi dia bisa bawa ekonomi ga krisis & pemulihan cukup oke.
Semoga mendapat yang lebih baik ya bu

Saya ingin Sri Mulyani Tapi dia sudah",22,0,0,26846,https://x.com/I_mnonsometaX/status/1965313740405956715,https://x.com/IndoPopBase/status/1965267941785829723,22
2025-09-09 04:28:23+00:00,sysm07,Pak prabowo ke budi : ,0,0,0,43898,https://x.com/sysm07/status/1965271038184599726,https://x.com/IndoPopBase/status/1965267941785829723,0
2025-09-09 04:24:23+00:00,thebadkidroman,"malesnya dan toxic nya politik di Indonesia gitu, politik balas budi, sekali di ganti karena emang kinerjanya gebene, lgs jadi musuhan.. terbukti semua hanya demi jabatan, gada tujuan sama sekali untuk bangun negara bersama2",0,2,0,1155,https://x.com/thebadkidroman/status/1965270031543275901,https://x.com/IndoPopBase/status/1965267941785829723,2
2025-09-09 10:47:25+00:00,NyaiJagat,Waduh ,0,3,0,213,https://x.com/NyaiJagat/status/1965366425188794862,https://x.com/IndoPopBase/status/1965267941785829723,3
2025-09-09 04:39:12+00:00,Agakgini,"Its funny to think the first think he kepikiran to do after being reshuffled is ""bajingan, w unfol aja""",2,1,0,537,https://x.com/Agakgini/status/1965273760917004535,https://x.com/IndoPopBase/status/1965267941785829723,3
2025-09-09 05:44:24+00:00,AmalaNovi,"Baru juga di unfoll, blm di blok. 
Paling 1jam sekali suka stalking.",2,2,0,21001,https://x.com/AmalaNovi/status/1965290171949298092,https://x.com/IndoPopBase/status/1965267941785829723,4
2025-09-09 04:27:34+00:00,motherlander,,0,0,0,7420,https://x.com/motherlander/status/1965270834786042336,https://x.com/IndoPopBase/status/1965267941785829723,0
2025-09-09 04:18:04+00:00,ScarySony,Langsung ciduk lah si Budi Arie ini,0,1,0,745,https://x.com/ScarySony/status/1965268441788723322,https://x.com/IndoPopBase/status/1965267941785829723,1
2025-09-09 04:18:55+00:00,stvnsmbrng,This khia beef  know ur worth,2,0,0,2219,https://x.com/stvnsmbrng/status/1965268656751059060,https://x.com/IndoPopBase/status/1965267941785829723,2
2025-09-09 04:29:44+00:00,dudionline,"Dia ini termasuk salah satu anggota ""Geng Solo"", kan? 
Menarik, semoga kasus judi online akan semakin terbuka untuk diselidiki.",0,0,0,518,https://x.com/dudionline/status/1965271378854285460,https://x.com/IndoPopBase/status/1965267941785829723,0
2025-09-09 04:52:25+00:00,Not_Ur_Bro,Boomer baperan,0,0,0,2947,https://x.com/Not_Ur_Bro/status/1965277089042751602,https://x.com/IndoPopBase/status/1965267941785829723,0
2025-09-09 04:47:38+00:00,zuhdeee,sempet2nya lu pake acara unfoll. BTW selamat deg2an. Tinggal tunggu panggilan cinta aja nih pak bud,0,0,0,460,https://x.com/zuhdeee/status/1965275884296065155,https://x.com/IndoPopBase/status/1965267941785829723,0
2025-09-09 04:18:00+00:00,huikrisna913,Gak penting,1,0,0,10639,https://x.com/huikrisna913/status/1965268424755740674,https://x.com/IndoPopBase/status/1965267941785829723,1
2025-09-09 04:47:02+00:00,yeebacot_,baper anj,0,1,0,256,https://x.com/yeebacot_/status/1965275731996692615,https://x.com/IndoPopBase/status/1965267941785829723,1
2025-09-09 14:27:28+00:00,·,,0,0,0,99,https://x.com/membuahimu/status/1965421802165051884,https://x.com/IndoPopBase/status/1965267941785829723,0
2025-09-09 05:51:50+00:00,ndahmutty,babssss ngakak,0,0,0,76,https://x.com/ndahmutty/status/1965292041417752766,https://x.com/IndoPopBase/status/1965267941785829723,0
2025-09-09 05:10:39+00:00,abihaha,"Had 
@KPK_RI
 followed him?",1,0,0,68,https://x.com/abihaha/status/1965281676235604386,https://x.com/IndoPopBase/status/1965267941785829723,1
2025-09-09 04:41:38+00:00,ddafid_,we dont care,0,0,0,214,https://x.com/ddafid_/status/1965274372354310281,https://x.com/IndoPopBase/status/1965267941785829723,0
2025-09-09 04:29:20+00:00,switieess,dah tuir ngambek,0,0,0,258,https://x.com/switieess/status/1965271279222800653,https://x.com/IndoPopBase/status/1965267941785829723,0
2025-09-09 14:19:30+00:00,drdevandi," He is a fan of Jokowi, not Prabowo.",0,0,0,1392,https://x.com/drdevandi/status/1965419799489773761,https://x.com/IndoPopBase/status/1965267941785829723,0
2025-09-09 04:18:29+00:00,TheRexBurner,Harus dicekal secepatnya nih orang biar ga kabur ke luar negeri,0,0,0,818,https://x.com/TheRexBurner/status/1965268547107770647,https://x.com/IndoPopBase/status/1965267941785829723,0
2025-09-09 05:01:31+00:00,jaesxc,So petty ,0,0,0,4289,https://x.com/jaesxc/status/1965279378256109912,https://x.com/IndoPopBase/status/1965267941785829723,0
2025-09-09 04:25:01+00:00,0xgasm,"he have found another one, sad ",0,0,0,5986,https://x.com/0xgasm/status/1965270192948478121,https://x.com/IndoPopBase/status/1965267941785829723,0
2025-09-09 05:08:42+00:00,Bite_edu,Like a child,0,0,0,1301,https://x.com/Bite_edu/status/1965281186403725437,https://x.com/IndoPopBase/status/1965267941785829723,0
2025-09-09 06:15:54+00:00,I_mnonsometaX,Masuk juga tu barang ,1,0,0,4379,https://x.com/I_mnonsometaX/status/1965298096285646878,https://x.com/IndoPopBase/status/1965267941785829723,1
2025-09-08 13:37:35+00:00,IndoPopBase,Purbaya Yudhi says he learned he’d be Finance Minister just 3.5 hours before the inauguration.,413,2510,0,828120,https://x.com/IndoPopBase/status/1965046861838102998,https://x.com/IndoPopBase/status/1965046865344577705,2923
2025-09-08 21:47:36+00:00,sebisanya_aja,"Anjenggg gak ada persiapan cik, harusnya sejak jauh hari dipersiapkan biar maksimal.

Akhirnya jadi kocak deh.",0,0,0,774,https://x.com/sebisanya_aja/status/1965170177617862937,https://x.com/IndoPopBase/status/1965046865344577705,0
2025-09-08 17:35:17+00:00,Juliakango,Haha.. Orang kmrn sabtu aja ada di Hambalang kok. Ngobrol berdua jg mlh sama Pak Pres.,1,0,0,972,https://x.com/Juliakango/status/1965106682729824716,https://x.com/IndoPopBase/status/1965046865344577705,1
2025-09-08 16:45:55+00:00,C3170crypto,Wahh..... Indonesia,0,0,0,314,https://x.com/C3170crypto/status/1965094259197182273,https://x.com/IndoPopBase/status/1965046865344577705,0
2025-09-08 13:37:36+00:00,IndoPopBase,:,5,16,0,72692,https://x.com/IndoPopBase/status/1965046865344577705,https://x.com/IndoPopBase/status/1965046861838102998,21
2025-09-08 13:52:44+00:00,pawliticss,"Jangankan anda yang kaget, kita sebagai masyrakat pun bingung, sesuatu yang tergesa-gesa biasanya tidak memberikan hasil yang baik, kenapa masa depan rakyat harus di jadikan percobaan gini",0,56,0,28895,https://x.com/pawliticss/status/1965050675123171512,https://x.com/IndoPopBase/status/1965046861838102998,56
2025-09-08 14:02:39+00:00,RamaAdamfaathir,,8,83,0,52327,https://x.com/RamaAdamfaathir/status/1965053170599784853,https://x.com/IndoPopBase/status/1965046861838102998,91
2025-09-08 15:14:59+00:00,dvsirenco,"Should have said ""No, thank you for the kind offer""",7,100,0,50619,https://x.com/dvsirenco/status/1965071374676070462,https://x.com/IndoPopBase/status/1965046861838102998,107
2025-09-08 13:38:12+00:00,SaddamWeb3,horeeeee,5,11,0,33702,https://x.com/SaddamWeb3/status/1965047018902155435,https://x.com/IndoPopBase/status/1965046861838102998,16
2025-09-08 15:06:39+00:00,boyhendryko,sehat sehat orang Indonesia,2,17,0,33036,https://x.com/boyhendryko/status/1965069278367138076,https://x.com/IndoPopBase/status/1965046861838102998,19
2025-09-08 13:39:22+00:00,hemanthkohli149,Congratulations?,0,0,0,7627,https://x.com/hemanthkohli149/status/1965047309974327615,https://x.com/IndoPopBase/status/1965046861838102998,0
2025-09-08 13:54:06+00:00,mdkousik31,Why are they being seated in chairs amidst so much commotion?,0,0,0,7635,https://x.com/mdkousik31/status/1965051017395098053,https://x.com/IndoPopBase/status/1965046861838102998,0
2025-09-09 11:22:36+00:00,leyschmidts,Emg definisi gercep sih ini,0,0,0,18,https://x.com/leyschmidts/status/1965375282174677088,https://x.com/IndoPopBase/status/1965046861838102998,0
2025-09-08 13:52:57+00:00,rineeth_PRK,Seriously ,0,0,0,131,https://x.com/rineeth_PRK/status/1965050727686136310,https://x.com/IndoPopBase/status/1965046861838102998,0
2025-09-08 23:42:11+00:00,heyyandstuff,,0,0,0,97,https://x.com/heyyandstuff/status/1965199014070288688,https://x.com/IndoPopBase/status/1965046861838102998,0
2025-09-09 00:11:42+00:00,oneofthatpeople,,0,0,0,473,https://x.com/oneofthatpeople/status/1965206441305981423,https://x.com/IndoPopBase/status/1965046861838102998,0
2025-09-08 22:42:24+00:00,rubikriuk,"Doi masih ada hubungannya sama jokowi. Jadi siapa yg ""tiba²"" milih purbaya buat ngegantiin sri mulyani? Lol",0,0,0,393,https://x.com/rubikriuk/status/1965183970708177114,https://x.com/IndoPopBase/status/1965046861838102998,0
2025-09-08 22:47:04+00:00,taejellys,"emang sih itb suka pake sistem sks, tp ya ga gitu juga pak",0,0,0,203,https://x.com/taejellys/status/1965185143389425675,https://x.com/IndoPopBase/status/1965046861838102998,0
2025-09-08 14:43:01+00:00,DevaLT_,Ampas berganti dengan ampas,1,0,0,603,https://x.com/DevaLT_/status/1965063330844102681,https://x.com/IndoPopBase/status/1965046861838102998,1
2025-09-08 14:50:36+00:00,hilmiism,Sistem Kebut Semalem (SKS) aja masih dari semalem lho ga 3.5 jam doang :),0,0,0,380,https://x.com/hilmiism/status/1965065236169605215,https://x.com/IndoPopBase/status/1965046861838102998,0
2025-09-08 19:29:24+00:00,midazolammmmm,"APA GABISA CARI ORANG YG BENER??? JABATAN YG DIEMBAN MENTERI LO, BUKAN TU KOPERASI",0,0,0,183,https://x.com/midazolammmmm/status/1965135401418629407,https://x.com/IndoPopBase/status/1965046861838102998,0
2025-09-08 17:43:40+00:00,Timenew45,Wallahi this country is fckup,0,0,0,66,https://x.com/Timenew45/status/1965108793404260461,https://x.com/IndoPopBase/status/1965046861838102998,0
2025-09-08 14:22:02+00:00,cockroachtalks,mana popnya min,0,0,0,144,https://x.com/cockroachtalks/status/1965058050152333375,https://x.com/IndoPopBase/status/1965046861838102998,0
2025-09-08 14:55:54+00:00,aaronsavic,"pantesan ada dua kursi menterinya yang kosong, karena masih di luar Kota, ternyata emang se mendadak ini kah, ngurus negara gini amat",1,0,0,1436,https://x.com/aaronsavic/status/1965066572856528947,https://x.com/IndoPopBase/status/1965046861838102998,1
2025-09-08 23:21:45+00:00,obocha10,"Dia bisa begini krn ngerasa dia & keluarganya aman. Kita harus mulai membiasakan gangguin keluarganya jika pejabat asbun, jika pejabat tidak becus kerjanya, itu akan jd shock terapi.
Jika dijagain aparat, keluarga aparatnya kita kerjain, dijamin ga ada yg berani aneh aneh lagi",0,0,0,281,https://x.com/obocha10/status/1965193872675656112,https://x.com/IndoPopBase/status/1965046861838102998,0
2025-09-08 14:14:17+00:00,Razelius_,him finding out,0,0,0,181,https://x.com/Razelius_/status/1965056100140761228,https://x.com/IndoPopBase/status/1965046861838102998,0
2025-09-08 14:05:14+00:00,kvppll016,Aduh takut korupsi semoga engga ya,0,0,0,437,https://x.com/kvppll016/status/1965053818871468484,https://x.com/IndoPopBase/status/1965046861838102998,0
2025-09-08 23:40:50+00:00,morisgarage,"Beware guys, no more miracle for Indonesia's economic and financial. Stop your BIG MOUTH Mr.P !!",0,0,0,18,https://x.com/morisgarage/status/1965198676680421416,https://x.com/IndoPopBase/status/1965046861838102998,0
2025-09-08 17:03:51+00:00,triplechocobar,"itb soalnya singkatan dari institut tahu bulat sebenernya

digoreng dadakan~ lima ratusan~",0,0,0,340,https://x.com/triplechocobar/status/1965098770062057624,https://x.com/IndoPopBase/status/1965046861838102998,0
2025-09-08 13:40:45+00:00,Bloody_Romeo_,Talk about last minute surprises! Must have been the fastest crash course in national budgeting ever ,1,0,0,758,https://x.com/Bloody_Romeo_/status/1965047661058576805,https://x.com/IndoPopBase/status/1965046861838102998,1
2025-09-08 13:39:32+00:00,hemanthkohli149,Why sudden change ?,0,0,0,5810,https://x.com/hemanthkohli149/status/1965047354425524729,https://x.com/IndoPopBase/status/1965046861838102998,0
2025-09-09 03:36:33+00:00,hoogieeantkc,"3.5 hours before the finance chair? Purbaya's sprint mode activated
policy on the fly, liquidity in real time",0,0,0,79,https://x.com/hoogieeantkc/status/1965257995425906793,https://x.com/IndoPopBase/status/1965046861838102998,0
2025-09-09 05:32:07+00:00,xhilir,Hah?,0,0,0,1,https://x.com/xhilir/status/1965287077286920689,https://x.com/IndoPopBase/status/1965046861838102998,0
2025-09-08 15:59:48+00:00,casa2b1,,0,0,0,400,https://x.com/casa2b1/status/1965082653142790593,https://x.com/IndoPopBase/status/1965046861838102998,0
2025-09-09 01:42:11+00:00,zwatermel0nz,sehat sehat deh,0,0,0,16,https://x.com/zwatermel0nz/status/1965229215852425262,https://x.com/IndoPopBase/status/1965046861838102998,0
2025-09-09 03:26:53+00:00,mughniarsalan,We cooked ,0,0,0,51,https://x.com/mughniarsalan/status/1965255561517350984,https://x.com/IndoPopBase/status/1965046861838102998,0
2025-09-08 17:31:49+00:00,93OO2,"BRO YG BENER AJAA, WE'RE DOOMEDDDD",0,0,0,46,https://x.com/93OO2/status/1965105807420514634,https://x.com/IndoPopBase/status/1965046861838102998,0
2025-09-08 13:47:15+00:00,ravennokaze,hah? ,0,0,0,218,https://x.com/ravennokaze/status/1965049295096385559,https://x.com/IndoPopBase/status/1965046861838102998,0
2025-09-09 10:47:14+00:00,heyyystobbit,hah?!,0,0,0,7,https://x.com/heyyystobbit/status/1965366379546304953,https://x.com/IndoPopBase/status/1965046861838102998,0
2025-09-09 05:21:22+00:00,falisa_,ckckck,0,0,0,10,https://x.com/falisa_/status/1965284371788955957,https://x.com/IndoPopBase/status/1965046861838102998,0
2025-09-08 17:43:05+00:00,bani78gblk,SKS sytem….investor scream and george soros team on counting Times….history will repeat again.. Watch and prepare,0,0,0,85,https://x.com/bani78gblk/status/1965108645643125182,https://x.com/IndoPopBase/status/1965046861838102998,0
2025-09-08 17:45:48+00:00,beautiaf,udah yappingnya???,0,0,0,15321,https://x.com/beautiaf/status/1965109330044424577,https://x.com/IndoPopBase/status/1965046861838102998,0
2025-09-08 14:23:56+00:00,amkathu18,He is a joke,0,0,0,3272,https://x.com/amkathu18/status/1965058525920682451,https://x.com/IndoPopBase/status/1965046861838102998,0
2025-09-08 18:53:12+00:00,CosmicWolfRonin,Crazy purbaya yudhhi is a jew,0,0,0,23,https://x.com/CosmicWolfRonin/status/1965126289205174762,https://x.com/IndoPopBase/status/1965046861838102998,0
2025-09-09 01:08:37+00:00,peaudepaw,kocak emang lu wo,0,0,0,2455,https://x.com/peaudepaw/status/1965220768662593664,https://x.com/IndoPopBase/status/1965046861838102998,0
2025-09-08 14:37:11+00:00,RIGAM07,"Hanya 3,5 jam sebelum luar biasa mendadak.",0,0,0,3532,https://x.com/RIGAM07/status/1965061860593692971,https://x.com/IndoPopBase/status/1965046861838102998,0
2025-09-09 00:44:02+00:00,tonitan240564,Cap cip cup kembang kuncup... No need for the house interview and all that shit,0,0,0,19,https://x.com/tonitan240564/status/1965214581850341695,https://x.com/IndoPopBase/status/1965046861838102998,0
2025-09-08 17:18:00+00:00,remembermirr,not funny. be for real.,0,0,0,117,https://x.com/remembermirr/status/1965102333383291077,https://x.com/IndoPopBase/status/1965046861838102998,0
2025-09-08 22:58:59+00:00,kthygvbwi,makanya public speaking nya acak acakan wkwk,0,0,0,122,https://x.com/kthygvbwi/status/1965188142744698910,https://x.com/IndoPopBase/status/1965046861838102998,0
2025-09-09 00:03:32+00:00,Okok1234tyu,"Siapa si bapa ini 
@grok",1,0,0,253,https://x.com/Okok1234tyu/status/1965204388747821439,https://x.com/IndoPopBase/status/1965046861838102998,1
2025-09-09 03:12:54+00:00,rayanefendi,Ketahuan bukan pilihan utama,0,0,0,10,https://x.com/rayanefendi/status/1965252041959514211,https://x.com/IndoPopBase/status/1965046861838102998,0
2025-09-09 10:55:35+00:00,luivienne,Sdm sampah apa ini plonga plongo nya frsh banget,0,0,0,17,https://x.com/luivienne/status/1965368482234777698,https://x.com/IndoPopBase/status/1965046861838102998,0
2025-09-08 23:55:55+00:00,jaemysunshine,"Should have said ""skip dulu pak, makasih"" And move on bjirt",0,0,0,9,https://x.com/jaemysunshine/status/1965202469811810442,https://x.com/IndoPopBase/status/1965046861838102998,0
2025-09-08 18:35:38+00:00,lotacancri,"mantap, ngebut papssss",0,0,0,35,https://x.com/lotacancri/status/1965121868991791596,https://x.com/IndoPopBase/status/1965046861838102998,0
2025-09-08 16:21:38+00:00,cursedkidd,minimal cukur rambut,152,904,0,151416,https://x.com/cursedkidd/status/1965088149182500984,https://x.com/IndoPopBase/status/1965042266029924402,1056
2025-09-08 13:45:09+00:00,changgoroo,we're not only cooked we are terkonsrang-kansreng,18,907,0,66180,https://x.com/changgoroo/status/1965048768686076286,https://x.com/IndoPopBase/status/1965042266029924402,925
2025-09-08 13:23:47+00:00,Mfthq,Day 1 udah yapping ga jelas ngtd,5,395,0,61906,https://x.com/Mfthq/status/1965043391563280603,https://x.com/IndoPopBase/status/1965042266029924402,400
2025-09-08 15:23:49+00:00,Dantyonna,"Udah overconfident + Delusional + Minim empati + gak napak tanah.

Pantesan kepilih jadi menteri, 11/12 sama wowok sifatnya.

belum sehari jadi menteri udah yapping begini.

moga kelingking kakinya kepentok pinggiran meja terus.",2,321,0,45710,https://x.com/Dantyonna/status/1965073596138897860,https://x.com/IndoPopBase/status/1965042266029924402,323
2025-09-08 13:36:34+00:00,txtdaritaxpayer,Saat yang tepat untuk kembali mengingatkan warga twitter sekitar ada yang namanya Dunning-Kruger Effect,3,167,0,51640,https://x.com/txtdaritaxpayer/status/1965046607176761346,https://x.com/IndoPopBase/status/1965042266029924402,170
2025-09-08 13:25:20+00:00,fojiiq,"Kalo kata orang sih “The empty vessel makes the loudest sound”. Belum 1 hari jadi menteri udah yapping begini, mari kita lihat kinerja nya ntar",3,94,0,34020,https://x.com/fojiiq/status/1965043780656169334,https://x.com/IndoPopBase/status/1965042266029924402,97
2025-09-08 13:52:48+00:00,elfardeyhaq,Dari bilang demo ini adalah suara sebagian kecil rakyat aja udah menunjukkan kegagalannya melihat perekonomian akhir-akhir ini,0,51,0,17345,https://x.com/elfardeyhaq/status/1965050690235220376,https://x.com/IndoPopBase/status/1965042266029924402,51
2025-09-08 13:26:11+00:00,lioveforme,"baru hari pertama udh ngentengin kerjaan aja lu, kayak anak magang pas hari-hari awal masuk",2,20,0,21546,https://x.com/lioveforme/status/1965043994100195383,https://x.com/IndoPopBase/status/1965042266029924402,22
2025-09-08 13:34:42+00:00,idextratime,,0,1,0,16260,https://x.com/idextratime/status/1965046135518830949,https://x.com/IndoPopBase/status/1965042266029924402,1
2025-09-08 13:28:41+00:00,keustruckpdf,,0,4,0,10973,https://x.com/keustruckpdf/status/1965044623929418199,https://x.com/IndoPopBase/status/1965042266029924402,4
2025-09-08 13:23:42+00:00,·,nyisir yang bener gasi,4,6,0,17341,https://x.com/helfut/status/1965043369190838585,https://x.com/IndoPopBase/status/1965042266029924402,10
2025-09-08 13:59:38+00:00,Namahelos,"GUA UDAJ CURIGA KALO SM DIGANTI, YANG GANTI AWIKWOK JUGA... TOH ORANG YANG MILIHNYA AWIKWOK",0,1,0,4446,https://x.com/Namahelos/status/1965052409673396618,https://x.com/IndoPopBase/status/1965042266029924402,1
2025-09-08 16:05:07+00:00,Mail_binmailnih,"Bahkan kita  tidak usah nunggu 24 jam, untuk melihat dia melontarkan pernyataan tolol ini.",0,5,0,3964,https://x.com/Mail_binmailnih/status/1965083989179515175,https://x.com/IndoPopBase/status/1965042266029924402,5
2025-09-08 13:38:58+00:00,jvkejams,someone tell him even people with privileges are speaking out about this too…. like its not clocking to you WE ARE DOOMED,1,4,0,6268,https://x.com/jvkejams/status/1965047211148054812,https://x.com/IndoPopBase/status/1965042266029924402,5
2025-09-08 13:41:29+00:00,yoongkillinme,1st day at the job and im already waiting for his impending fall,0,2,0,4922,https://x.com/yoongkillinme/status/1965047843972174192,https://x.com/IndoPopBase/status/1965042266029924402,2
2025-09-08 13:21:29+00:00,arddhe,"walah, naga-naganya sih bapuk ni mah",1,0,0,4652,https://x.com/arddhe/status/1965042809163149367,https://x.com/IndoPopBase/status/1965042266029924402,1
2025-09-08 13:31:52+00:00,jagadiriTih,"Bapak sama anak kelakuannya, ya Allah",1,2,0,15026,https://x.com/jagadiriTih/status/1965045424215224627,https://x.com/IndoPopBase/status/1965042266029924402,3
2025-09-08 13:21:49+00:00,Rumahdepok_,Kenapa wajahnya ga meyakinkan bgt ya warga Bogor satu ini,3,1,0,7682,https://x.com/Rumahdepok_/status/1965042894227832871,https://x.com/IndoPopBase/status/1965042266029924402,4
2025-09-08 13:45:00+00:00,samuelchrstnn,Baru beberapa jam udah yapping gini euy,0,0,0,2154,https://x.com/samuelchrstnn/status/1965048726990524888,https://x.com/IndoPopBase/status/1965042266029924402,0
2025-09-08 13:31:00+00:00,mubarock____,,0,0,0,4016,https://x.com/mubarock____/status/1965045205465460977,https://x.com/IndoPopBase/status/1965042266029924402,0
2025-09-08 14:41:32+00:00,sebebasaku,day 1 udah jadi musuh rakyat,0,4,0,1516,https://x.com/sebebasaku/status/1965062955407643048,https://x.com/IndoPopBase/status/1965042266029924402,4
2025-09-08 13:48:24+00:00,pawliticss,"Belum 24 jam menjabat sudah menganggap sepele pekerjaan, gatau dah nanti kedepannya apakah kebijakan nya bakal penuh Yapping dan nol aksi?",0,0,0,1573,https://x.com/pawliticss/status/1965049586101506455,https://x.com/IndoPopBase/status/1965042266029924402,0
2025-09-08 13:26:26+00:00,12amgadwi,Belum kerja udah yapping ,0,1,0,2061,https://x.com/12amgadwi/status/1965044058193334693,https://x.com/IndoPopBase/status/1965042266029924402,1
2025-09-08 13:29:54+00:00,Tokopaediii,"Waduuh, perasaan buk Sri gk pernah blak-blakan gini deh.",1,0,0,7968,https://x.com/Tokopaediii/status/1965044929413189647,https://x.com/IndoPopBase/status/1965042266029924402,1
2025-09-08 15:19:58+00:00,panoramaindomie,"PHK dimana mana perputaran duit ga ada ekonomi lesu
Bisa makan aja udah alhamdulillah anjir gaji sejuta kek finished gitu di :')",0,1,0,998,https://x.com/panoramaindomie/status/1965072630098411884,https://x.com/IndoPopBase/status/1965042266029924402,1
2025-09-08 13:21:49+00:00,ChameliaBlooms,Anaknya cryptobro jir,1,0,0,878,https://x.com/ChameliaBlooms/status/1965042896182374489,https://x.com/IndoPopBase/status/1965042266029924402,1
2025-09-08 15:49:10+00:00,ratiod243,Bacotanya udah 11 12 kaya luhut,1,1,0,619,https://x.com/ratiod243/status/1965079975859757175,https://x.com/IndoPopBase/status/1965042266029924402,2
2025-09-08 14:20:29+00:00,calatheatisue,,0,0,0,2221,https://x.com/calatheatisue/status/1965057660358971777,https://x.com/IndoPopBase/status/1965042266029924402,0
2025-09-09 15:51:04+00:00,hida23journey__,Kakean mangan duit harom emang marakke pekok.,0,0,0,139,https://x.com/hida23journey__/status/1965442843968999898,https://x.com/IndoPopBase/status/1965042266029924402,0
2025-09-08 13:29:35+00:00,vacasavy,Background lo bagus lho pak. Kok jadi begini aduh. RIP Indo,2,2,0,12919,https://x.com/vacasavy/status/1965044849796944294,https://x.com/IndoPopBase/status/1965042266029924402,4
2025-09-08 16:07:11+00:00,utomoendra7,"Belum kerja sdh berulah, langsung pecat aja nih orang",0,0,0,303,https://x.com/utomoendra7/status/1965084509080346805,https://x.com/IndoPopBase/status/1965042266029924402,0
2025-09-08 16:00:49+00:00,angelljicpearl,day 1 kerja aja udh yapping begini… wallahi we’re finished,1,1,0,784,https://x.com/angelljicpearl/status/1965082906969448904,https://x.com/IndoPopBase/status/1965042266029924402,2
2025-09-08 13:35:18+00:00,SATRIA37899288,"""SEBAGIAN KECIL"" rakyat",1,0,0,1054,https://x.com/SATRIA37899288/status/1965046289101623367,https://x.com/IndoPopBase/status/1965042266029924402,1
2025-09-09 06:13:53+00:00,whateevur,sibigiin rikyit kicil kiti….nyenyenye,0,0,0,312,https://x.com/whateevur/status/1965297590486122715,https://x.com/IndoPopBase/status/1965042266029924402,0
2025-09-08 13:31:31+00:00,jaepriss,Baru aja di sumpah udh aja dilanggarnya wkwkwkkwk hanya ada dimana? Di INDONESIAAA NO ENGLAND NO NO,2,0,0,7826,https://x.com/jaepriss/status/1965045335266664671,https://x.com/IndoPopBase/status/1965042266029924402,2
2025-09-08 13:32:01+00:00,PHN316,"Yep, getting my australian citizenship asap idc how",0,1,0,668,https://x.com/PHN316/status/1965045462895124586,https://x.com/IndoPopBase/status/1965042266029924402,1
2025-09-08 23:16:09+00:00,aldilaides,Ngomong naon ai maneh...,0,1,0,643,https://x.com/aldilaides/status/1965192463351775680,https://x.com/IndoPopBase/status/1965042266029924402,1
2025-09-08 13:42:59+00:00,arekgerak,Day 1 full yapping,0,0,0,275,https://x.com/arekgerak/status/1965048220024979764,https://x.com/IndoPopBase/status/1965042266029924402,0
2025-09-08 14:17:53+00:00,roveschant,Orang kyk begini lagi.,0,0,0,1445,https://x.com/roveschant/status/1965057005242208354,https://x.com/IndoPopBase/status/1965042266029924402,0
2025-09-08 14:28:23+00:00,friesdaynite,udah yappingnya ngentot?,0,0,0,127,https://x.com/friesdaynite/status/1965059647171383668,https://x.com/IndoPopBase/status/1965042266029924402,0
2025-09-09 13:54:26+00:00,melbqurne,temen wowo ga ada yg bener anjg,0,0,0,25,https://x.com/melbqurne/status/1965413492296745003,https://x.com/IndoPopBase/status/1965042266029924402,0
2025-09-08 15:15:11+00:00,marvinarvins,We miss u srimul ,0,0,0,118,https://x.com/marvinarvins/status/1965071422960922693,https://x.com/IndoPopBase/status/1965042266029924402,0
2025-09-08 14:18:22+00:00,significcunt,Shit... we're in the dead end,0,0,0,125,https://x.com/significcunt/status/1965057127967506536,https://x.com/IndoPopBase/status/1965042266029924402,0
2025-09-09 02:58:26+00:00,bimasinung,"Hati-hati pak, anda bisa saja memiliki kompetensi teknis, tetapi kalau kurang empati dan public speaking buruk, sulit rasanya bertahan lama sebagai pejabat publik yang amat disorot seperti Menteri Keuangan",0,0,0,624,https://x.com/bimasinung/status/1965248402285101177,https://x.com/IndoPopBase/status/1965042266029924402,0
2025-09-08 15:07:29+00:00,ambivertgirlcns,belum sehari kerja udah blunder aja ni orang,0,0,0,193,https://x.com/ambivertgirlcns/status/1965069486966591846,https://x.com/IndoPopBase/status/1965042266029924402,0
2025-09-08 14:26:44+00:00,_nightmalice_,,0,0,0,33,https://x.com/_nightmalice_/status/1965059230551117990,https://x.com/IndoPopBase/status/1965042266029924402,0
2025-09-08 13:41:03+00:00,kawrinbear,BARU HARI PERTAMA JADI MENTERI WOI ,1,0,0,2111,https://x.com/kawrinbear/status/1965047736597975304,https://x.com/IndoPopBase/status/1965042266029924402,1
2025-09-08 16:09:51+00:00,·,Reshuffle lagi nggak sih? Wkwkwk.,1,0,0,942,https://x.com/VictoriaLonita/status/1965085182723342523,https://x.com/IndoPopBase/status/1965042266029924402,1
2025-09-08 20:11:22+00:00,ndhogdadar,Apa bedanya dia sama yg sebelumnya ,0,0,0,1,https://x.com/ndhogdadar/status/1965145961044541884,https://x.com/IndoPopBase/status/1965042266029924402,0
2025-09-08 13:23:10+00:00,prasetya2233,Anjayyy baru juga dilantik,1,0,0,1705,https://x.com/prasetya2233/status/1965043232833982496,https://x.com/IndoPopBase/status/1965042266029924402,1
2025-09-08 10:27:36+00:00,sakenzfi,"walaupun ada beberapa kekurangan, ekonomi Indonesia dimasa beliau menjabat relatif stabil, nggak ada krisis parah

thanks Sri Mulyani",27,36,0,48636,https://x.com/sakenzfi/status/1964999050257985734,https://x.com/IndoPopBase/status/1964997901605834885,63
2025-09-08 11:03:09+00:00,petalice_id,Finance di kantor aja jutek jutek dan galak. Ini beliau jadi org finance negara isi kepalanya gimana ya,8,19,0,32206,https://x.com/petalice_id/status/1965007998973366368,https://x.com/IndoPopBase/status/1964997901605834885,27
2025-09-08 10:30:01+00:00,varreldept,semalem sama bro bahas tentang reshuffle,1,14,0,25807,https://x.com/varreldept/status/1964999657928696312,https://x.com/IndoPopBase/status/1964997901605834885,15
2025-09-08 10:51:42+00:00,yudhabjnugroho,"Beliau ini termasuk menteri yang terlama menjabat. Dimulai pada 5 Desember 2005, ketika Presiden Susilo Bambang Yudhoyono mengumumkan perombakan kabinet, Sri Mulyani dipindahkan menjadi Menteri Keuangan menggantikan Jusuf Anwar.

Posisi dan kedudukannya yg sangat strategis dan",6,17,0,35060,https://x.com/yudhabjnugroho/status/1965005118274937293,https://x.com/IndoPopBase/status/1964997901605834885,23
2025-09-08 10:58:54+00:00,fed_febri,hmmmm disappointed that Mrs. Sri Mulyani is no longer the Minister of Finance!,0,0,0,8662,https://x.com/fed_febri/status/1965006929199243427,https://x.com/IndoPopBase/status/1964997901605834885,0
2025-09-08 10:36:18+00:00,SaddamWeb3,"13 years and finally leaving 

wonder if the next one can survive this long",0,0,0,7856,https://x.com/SaddamWeb3/status/1965001240624214508,https://x.com/IndoPopBase/status/1964997901605834885,0
2025-09-08 10:36:18+00:00,0xHarryry,"gg, thankyou for 13 year",0,0,0,10526,https://x.com/0xHarryry/status/1965001240104087582,https://x.com/IndoPopBase/status/1964997901605834885,0
2025-09-08 13:56:06+00:00,0x_PingPing,Dari tadi siang masi berpikir cuma sekedar issue,2,0,0,7630,https://x.com/0x_PingPing/status/1965051523559456840,https://x.com/IndoPopBase/status/1964997901605834885,2
2025-09-08 13:39:10+00:00,negativisme,Semoga penggantinya lebih baik,1,0,0,5057,https://x.com/negativisme/status/1965047262859628820,https://x.com/IndoPopBase/status/1964997901605834885,1
2025-09-08 12:00:15+00:00,keponakannnn,"Lebih dari 286 juta penduduk Indonesia menggantungkan nasibnya pada anggota DPR yg tidak kompeten, menteri yg dipilih karena kompensasi dukungan partai, komisaris BUMN yg ditunjuk karena referensi orang dalam.

Kalau kita masih waras aja sudah ALHAMDULILLAH banget.",1,2,0,2474,https://x.com/keponakannnn/status/1965022368616812609,https://x.com/IndoPopBase/status/1964997901605834885,3
2025-09-08 11:25:59+00:00,bsatrio96,"Bebaskan dirimu dari lingkaran setan istana Bu....pernah merasakan di posisi saat hati nurani terbentur perintah atasan. Menteri hanya pelaksana dari titah presiden. Apes aja dapet presiden macam j.k.w, coba kalo presidennya bener. Ibu ini pasti berprestasi",1,0,0,1998,https://x.com/bsatrio96/status/1965013744658043324,https://x.com/IndoPopBase/status/1964997901605834885,1
2025-09-08 15:27:08+00:00,mitsau,"DIDUGA bukan dipecat, tapi memang sudah 2 kali minta berhenti. Terlebih-lebih saat rumahnya dijarah, dia minta backup keamanan tapi tidak ada backup dari pihak keamanan. KALAU benar, bisa dipahami rasanya, sudah mati-matian dukung program pemerintah tapi seperti ""ditumbalin.""",0,1,0,447,https://x.com/mitsau/status/1965074432025903521,https://x.com/IndoPopBase/status/1964997901605834885,1
2025-09-08 15:08:14+00:00,kang_baksoborax,Coba mundur sebelum anti klimaks bu. Dulu ibu dipuji2 karena sangat diharapkan dan mumpuni. Tp skrg malah meninggalkan nama buruk di akhir jabatan,0,2,0,606,https://x.com/kang_baksoborax/status/1965069674041028987,https://x.com/IndoPopBase/status/1964997901605834885,2
2025-09-08 10:32:18+00:00,fojiiq,Bagi bagi Jco apa Krispy Kreme bu?,2,0,0,2770,https://x.com/fojiiq/status/1965000233999556814,https://x.com/IndoPopBase/status/1964997901605834885,2
2025-09-08 13:59:44+00:00,Alhamdulillahm7,Padahal digadang gadang SBY yg kelak akan menggantikan nya di tampuk kekuasaan semua ambyar dikasus century.... Ketemu Mulyono di suruh cari dwitt bagaimanapun caranya akhirnya orang jadi muak.... Mulyono pembawa sial,0,0,0,596,https://x.com/Alhamdulillahm7/status/1965052436604973117,https://x.com/IndoPopBase/status/1964997901605834885,0
2025-09-08 10:58:04+00:00,·,Belum lihat video viral 30 detik Sri Mulyani bersetubuh dengan pajak.,0,1,0,1458,https://x.com/Flashovre/status/1965006720033542518,https://x.com/IndoPopBase/status/1964997901605834885,1
2025-09-08 11:52:54+00:00,·,,0,1,0,598,https://x.com/memekcita/status/1965020516240228834,https://x.com/IndoPopBase/status/1964997901605834885,1
2025-09-08 12:15:53+00:00,littlezombiekun,"Bruh, prepare for the worst. Prabowo is gambling with indonesia economic right now",0,0,0,367,https://x.com/littlezombiekun/status/1965026303666753992,https://x.com/IndoPopBase/status/1964997901605834885,0
2025-09-09 05:56:47+00:00,Tan_Mar3M,,0,1,0,114,https://x.com/Tan_Mar3M/status/1965293288166207797,https://x.com/IndoPopBase/status/1964997901605834885,1
2025-09-08 12:23:07+00:00,xiayuejiu,Thank you for the 13 years. Much appreciated. ,0,0,0,900,https://x.com/xiayuejiu/status/1965028123990512096,https://x.com/IndoPopBase/status/1964997901605834885,0
2025-09-08 20:29:24+00:00,mdkousik31,i think Sri Mulyani Indrawati is 100% Better than Purbaya Yudhi Sadewa,0,0,0,1999,https://x.com/mdkousik31/status/1965150501269635400,https://x.com/IndoPopBase/status/1964997901605834885,0
2025-09-08 11:04:02+00:00,Sugilico3,ini seriusan kan? bukan hoax>\?,4,0,0,18771,https://x.com/Sugilico3/status/1965008218528362727,https://x.com/IndoPopBase/status/1964997901605834885,4
2025-09-08 14:40:58+00:00,aquagalonman,"Walaupun saya ga suka pajak naik bu, tapi terimakasih sudah membersamai indonesia selama 13 tahun ke belakang.

Semoga sehat selalu bu sri mulyani",0,1,0,484,https://x.com/aquagalonman/status/1965062811446587681,https://x.com/IndoPopBase/status/1964997901605834885,1
2025-09-08 14:36:14+00:00,hematbukanpelit,"Terimakasih Bu, bangga rasanya pernah punya mentei keuangan sekaliber Ibu, semoga kami generasi muda bisa mencontoh Ibu ",0,0,0,403,https://x.com/hematbukanpelit/status/1965061620834697258,https://x.com/IndoPopBase/status/1964997901605834885,0
2025-09-08 13:11:22+00:00,Je_Ry1,"Iyalah gw juga sakit hati, udah cover anggaran selama perang dengan covid, gara gara potongan video ai manusia manusia tolol rumah terjarah. Terkadang harga diri lebih penting daripada jabatan",0,0,0,646,https://x.com/Je_Ry1/status/1965040264604692686,https://x.com/IndoPopBase/status/1964997901605834885,0
2025-09-08 11:56:55+00:00,pondra74,Yang salah progam Prabowo yang jadi korban menteri keuangan.,1,0,0,712,https://x.com/pondra74/status/1965021530401939500,https://x.com/IndoPopBase/status/1964997901605834885,1
2025-09-08 13:56:18+00:00,mdkousik31,Was he involved in any financial scam?,0,1,0,5202,https://x.com/mdkousik31/status/1965051571882049616,https://x.com/IndoPopBase/status/1964997901605834885,1
2025-09-08 14:36:02+00:00,DhewaKhan,kebijakan sri mulyani yg melukai rakyat adl institusi Kejaksaan dijadikan dep colectornya Bank.,0,0,0,123,https://x.com/DhewaKhan/status/1965061573044736037,https://x.com/IndoPopBase/status/1964997901605834885,0
2025-09-08 22:50:19+00:00,northernblufox,"Mixed feeling sih. She’s been so unpopular lately, but gotta admit she’s been good in tough times. And knowing how poor Prabski’s choices are in selecting his helpers… it’s just scary to think about. Her position is just too crucial. Anyway, now sashay away.",0,0,0,141,https://x.com/northernblufox/status/1965185962599973191,https://x.com/IndoPopBase/status/1964997901605834885,0
2025-09-08 10:33:10+00:00,·,"Jaman SBY dia ngapain ya?
Kayaknya udah menjamur dia di kementerian keuangan tuh",4,0,0,5204,https://x.com/nami_singkat/status/1965000453915381819,https://x.com/IndoPopBase/status/1964997901605834885,4
2025-09-08 12:08:36+00:00,mmmmmmotz,Bakal lebih baik dari Sri Mulyani gak nih?,0,1,0,847,https://x.com/mmmmmmotz/status/1965024470135103910,https://x.com/IndoPopBase/status/1964997901605834885,1
2025-09-08 14:02:23+00:00,vienbast,"Bs dibilang ini salah satu posisi paling sakit kepala kayaknya
Uda fix badmood 24/7 doi selama 13 tahun 
Mgkn penjarahan kmaren jadi titik didih maksimal doi ",0,0,0,559,https://x.com/vienbast/status/1965053103037923718,https://x.com/IndoPopBase/status/1964997901605834885,0
2025-09-08 16:20:13+00:00,Oliviaarien,"bisa fokus ngemong cucu kek bu retno, bestienya. skalian jdwalin ngmpul lgi sama bu retno ke acaranya mbak nana kek wktu itu, seru sih",0,0,0,278,https://x.com/Oliviaarien/status/1965087792280772948,https://x.com/IndoPopBase/status/1964997901605834885,0
2025-09-08 13:10:50+00:00,Queenbehaves,"Tapi kalo jd beliao males jg si ud belabelain pulang dari luar negri ngerelain jabatan di bank dunia, taunya di negri sendiri diginiin .. hmm anyway it is what it is",0,0,0,273,https://x.com/Queenbehaves/status/1965040132341502453,https://x.com/IndoPopBase/status/1964997901605834885,0
2025-09-08 23:14:50+00:00,Abdoeljegger202,Alhamdulillah,0,0,0,22,https://x.com/Abdoeljegger202/status/1965192130617643401,https://x.com/IndoPopBase/status/1964997901605834885,0
2025-09-09 00:40:49+00:00,FernaRondonuwu,"One of the best Minister that hold our Economic for years, hopefully it will not crash the market",0,0,0,23,https://x.com/FernaRondonuwu/status/1965213768688042461,https://x.com/IndoPopBase/status/1964997901605834885,0
2025-09-08 12:48:03+00:00,andrewbudi,"Istirahat, nikmati hidup bebas stress. Momong cucu.",1,0,0,535,https://x.com/andrewbudi/status/1965034398123954672,https://x.com/IndoPopBase/status/1964997901605834885,1
2025-09-08 14:26:09+00:00,·,u mean ruin?,1,0,0,678,https://x.com/missterzas/status/1965059084274778479,https://x.com/IndoPopBase/status/1964997901605834885,1
2025-09-08 19:49:27+00:00,Marvinzakev,"dia bikin statement dihujat abis2an, skg dia berenti dipuji2, gw mah gak paham lagi dah, gw mau mentri nya shikamaru aja",0,0,0,80,https://x.com/Marvinzakev/status/1965140445199204408,https://x.com/IndoPopBase/status/1964997901605834885,0
2025-09-08 19:51:41+00:00,nassu_art,"IMF loan merchant ,,, dan utanganya dibuat Bancakan korupsi,
dianya sih ngak peduli, soalnya emang misinya naikin utang Indonesia,,, ",1,0,0,189,https://x.com/nassu_art/status/1965141009698038060,https://x.com/IndoPopBase/status/1964997901605834885,1
2025-09-08 11:35:17+00:00,satrianugrrr,Open to work di linkedin. Nambah lagi saingan nyari kerja gua,0,0,0,606,https://x.com/satrianugrrr/status/1965016085658525723,https://x.com/IndoPopBase/status/1964997901605834885,0
2025-09-08 11:52:07+00:00,rorasbf,"sebenernya dari banyaknya pejabat yang busuk ibu ini masih dibilang gak busuk busuk amat, cuma kurang bagus aja. gak kreatif, gaada gebrakan.",1,1,0,2314,https://x.com/rorasbf/status/1965020322371084336,https://x.com/IndoPopBase/status/1964997901605834885,2
2025-09-08 10:53:39+00:00,ADBKitty6800H,13 YEARS?,0,0,0,396,https://x.com/ADBKitty6800H/status/1965005609251774485,https://x.com/IndoPopBase/status/1964997901605834885,0
2025-09-08 11:09:37+00:00,DonutRanger_,@agiruu_,0,0,0,50,https://x.com/DonutRanger_/status/1965009624949743983,https://x.com/IndoPopBase/status/1964997901605834885,0
2025-09-08 10:55:26+00:00,JavaJimmyMaukar,alhamdulillah untuk hilangnya kebijakan dari dia,0,0,0,352,https://x.com/JavaJimmyMaukar/status/1965006056423346617,https://x.com/IndoPopBase/status/1964997901605834885,0
2025-09-09 01:53:47+00:00,CilRay21158,ini yg real,0,0,0,90,https://x.com/CilRay21158/status/1965232133418746172,https://x.com/IndoPopBase/status/1964997901605834885,0
2025-09-08 11:41:06+00:00,croxkodile,"A brilliant woman, thank you Bu",0,0,0,162,https://x.com/croxkodile/status/1965017548271051013,https://x.com/IndoPopBase/status/1964997901605834885,0
2025-09-08 19:05:40+00:00,rthrslyp,nice abis ini tinggal mati trs masuk neraka,0,0,0,71,https://x.com/rthrslyp/status/1965129426838098242,https://x.com/IndoPopBase/status/1964997901605834885,0
2025-09-08 15:06:29+00:00,amkathu18,"@grok
 why she resigned her position",1,0,0,5271,https://x.com/amkathu18/status/1965069235102851370,https://x.com/IndoPopBase/status/1964997901605834885,1
2025-09-08 14:35:41+00:00,Almondtofuuu3,"Kek dia emang dah muak dari lama jd menkeu, bayangin dia ngatur anggaran sedemikian rupa tapi.. tikusnya kebanyakan",0,0,0,22,https://x.com/Almondtofuuu3/status/1965061484117209126,https://x.com/IndoPopBase/status/1964997901605834885,0
2025-09-08 10:22:18+00:00,boyhendryko,wonder beliau beli jco buat se-kementerian apa ngga,15,46,0,44746,https://x.com/boyhendryko/status/1964997718293762543,https://x.com/IndoPopBase/status/1964988848422916185,61
2025-09-08 10:02:04+00:00,pawliticss,"Dia mundur karena merasa kinerjanya sudah dinilai tidak baik, namun mentri HAM dan Kapolri tidak memiliki inisiatif yang sama seperti Sri Mulyani?",6,22,0,28445,https://x.com/pawliticss/status/1964992625452478779,https://x.com/IndoPopBase/status/1964988848422916185,28
2025-09-08 09:55:24+00:00,0x_PingPing,Sampe masuk reuters loh beritanya,5,12,0,27667,https://x.com/0x_PingPing/status/1964990948410310774,https://x.com/IndoPopBase/status/1964988848422916185,17
2025-09-08 09:50:46+00:00,bluesunkiss_,"Capek, ya, Bu? Tekanan kerja mantap, sampe harus kehilangan hati nurani buat nyukup-nyukupin anggaran negara, eh ternyata dikorbanin juga sama mereka.",6,27,0,11017,https://x.com/bluesunkiss_/status/1964989783987671307,https://x.com/IndoPopBase/status/1964988848422916185,33
2025-09-08 09:53:29+00:00,0xHarryry,banyak di suruh2 ya?,1,0,0,19870,https://x.com/0xHarryry/status/1964990466279280838,https://x.com/IndoPopBase/status/1964988848422916185,1
2025-09-08 17:04:37+00:00,I_mnonsometaX,"Kasihan sih sebenernya, rumahnya sudah dijarah & sekarang direshuffle.
Keinget peforma mantep dia pas pandemi kemarin, walaupun berat tapi dia bisa bawa ekonomi ga krisis & pemulihan cukup oke.
Semoga mendapat yang lebih baik ya bu",1,6,0,11611,https://x.com/I_mnonsometaX/status/1965098962408669585,https://x.com/IndoPopBase/status/1964988848422916185,7
2025-09-08 10:02:37+00:00,zingwind,"Mungkin drama jarah2an kemarin adalah titik didihnya beliau.

Terlepas dari apakah penjarahan nya beneran atau cuma sinetron, pasti gak nyaman bgt.

Permainannya udah terlalu kotor dan berbahaya. Gw kalau jadi dia mending pensiun di luar negeri.",2,4,0,4654,https://x.com/zingwind/status/1964992763268907049,https://x.com/IndoPopBase/status/1964988848422916185,6
2025-09-08 09:50:02+00:00,mengunyahlangit,No it was actually by tempo first,2,13,0,13471,https://x.com/mengunyahlangit/status/1964989597353738309,https://x.com/IndoPopBase/status/1964988848422916185,15
2025-09-08 10:37:43+00:00,astrodiaal,Ibarat lu bendahara ngerangkap kang danus ditekan bos dan peer lu buat nyari duit yg banyak. Ya cape lah awowkwk,4,5,0,5843,https://x.com/astrodiaal/status/1965001598251540484,https://x.com/IndoPopBase/status/1964988848422916185,9
2025-09-08 12:08:23+00:00,gebigabut,"Capeklah ngadepin presiden kek toddler halu! Disuruh nyari duit di negara mandul, smntra anggaran MBG, Polri, & TNI 2026 naik bombastis. Pusing kan gmn lg caranya ngakal2in, naikin pajak makin dihujat rakyat. Blm lg kena jarah (settingan) sampek lukisan (kesayangannya) hilang",0,4,0,2115,https://x.com/gebigabut/status/1965024415831511162,https://x.com/IndoPopBase/status/1964988848422916185,4
2025-09-08 11:49:40+00:00,admiralkizaruuu,"Nah bener kan. 
Pasti mau mundur.",1,0,0,20264,https://x.com/admiralkizaruuu/status/1965019702939517306,https://x.com/IndoPopBase/status/1964988848422916185,1
2025-09-08 09:56:51+00:00,varreldept,kok kesian yak jadinya SM mana rumahnya abis dijarah lagi,4,0,0,10365,https://x.com/varreldept/status/1964991315290239446,https://x.com/IndoPopBase/status/1964988848422916185,4
2025-09-08 10:27:38+00:00,hwahwp,"Ini kayanya dia yg mengundurkan diri kali, cuma gimmicknya reshuffle biar pada ga huru hara wkwk",1,0,0,1629,https://x.com/hwahwp/status/1964999059544097033,https://x.com/IndoPopBase/status/1964988848422916185,1
2025-09-08 09:55:50+00:00,su6brokean9el,dari prabs awal menjabat tempo udh ngebocorin jg srimul mau mundur tp ditahan-tahan,1,0,0,2319,https://x.com/su6brokean9el/status/1964991057143427086,https://x.com/IndoPopBase/status/1964988848422916185,1
2025-09-08 13:13:42+00:00,theholysobriety,"Kayaknya brp hari yg lalu banyak bgt yg ngehujat ibu ini, trus skrg tiba2 people soften a little bit. Org2 kita gampang bgt ya berubahnya.",0,2,0,382,https://x.com/theholysobriety/status/1965040850997760245,https://x.com/IndoPopBase/status/1964988848422916185,2
2025-09-08 13:02:18+00:00,keponakannnn,Mudah-mudahan pengganti beliau gak langsung minta mundur setelah melihat beban keuangan negara.,0,0,0,404,https://x.com/keponakannnn/status/1965037981821272085,https://x.com/IndoPopBase/status/1964988848422916185,0
2025-09-08 14:05:10+00:00,blankon21,"Udah di bunuh karakternya lwt deepfake, dijarah juga kemaren harusnya kukuh ga mau menjabat lagi pas si mul udahan. Udah cukup Kali bu ngebela rampok  pusing iya nyelametin negara bangsa belum tentu",0,0,0,466,https://x.com/blankon21/status/1965053802769535056,https://x.com/IndoPopBase/status/1964988848422916185,0
2025-09-08 14:35:47+00:00,thingsxlock,"gua kalo jadi dia juga mundur sih, bayangin periode sebelumnya ditinggal IKN. Periode sekarang dibebanin sama MBG dan ketika dia ""diserang"" sama sipil, negara ga ngebackup dia",0,0,0,344,https://x.com/thingsxlock/status/1965061510532895045,https://x.com/IndoPopBase/status/1964988848422916185,0
2025-09-08 13:54:40+00:00,Aldo_regi15,"Sudah bagus lah. Bu SM juga udah achieve so much. Sekarang bisa bebas main sama cucu dan jalan2. Walau kemarin mainan cucunya diambil warga ya, musti beli lagi ke toyz kingdom bu",0,0,0,798,https://x.com/Aldo_regi15/status/1965051160257253722,https://x.com/IndoPopBase/status/1964988848422916185,0
2025-09-08 16:44:03+00:00,Sugilico3,"menurut temen2 ini penggeseran geng Solo, ataukah gimana?",0,0,0,4118,https://x.com/Sugilico3/status/1965093787753218451,https://x.com/IndoPopBase/status/1964988848422916185,0
2025-09-09 00:21:37+00:00,nevertiten,"Heboh banget netizen pada belain dia, terima kasih dll.

Eh, dia tuh yg ngebolehin project² mubazir macam IKN, whoosh, bandara² dll pake duit APBN & ninggalin utang gede buat warisan anak cucu kita.

Eh giliran rumah dijarah langsung resign & merasa paling tersakiti",0,1,0,201,https://x.com/nevertiten/status/1965208937323790506,https://x.com/IndoPopBase/status/1964988848422916185,1
2025-09-08 10:17:16+00:00,RIGAM07,Wow ada apa ini?,0,2,0,9182,https://x.com/RIGAM07/status/1964996450615718082,https://x.com/IndoPopBase/status/1964988848422916185,2
2025-09-08 10:50:53+00:00,gaitsan,Buset ini bu sri mulyani leganya kaya apaan tau kali ya,1,0,0,1493,https://x.com/gaitsan/status/1965004910254338410,https://x.com/IndoPopBase/status/1964988848422916185,1
2025-09-08 16:29:30+00:00,R_HoedasingaIII,Setuju mundur...orang pintar diperas otaknya dan dibenturkan dg rakyat demi ambisi program omon2 yg nggak jelas,0,0,0,124,https://x.com/R_HoedasingaIII/status/1965090125362438509,https://x.com/IndoPopBase/status/1964988848422916185,0
2025-09-08 10:50:35+00:00,for_humanityIND,Happy Retirement mam ,0,0,0,385,https://x.com/for_humanityIND/status/1965004836400926725,https://x.com/IndoPopBase/status/1964988848422916185,0
2025-09-08 12:52:05+00:00,oak_math_lee_91,"Kalau gak salah dari awal dia udah gak mau lanjut sebenarnya, apalagi dengan program gila2 yang direncanakan. Saya juga heran kenapa dia ganti haluan.",0,0,0,338,https://x.com/oak_math_lee_91/status/1965035412084404498,https://x.com/IndoPopBase/status/1964988848422916185,0
2025-09-08 11:28:27+00:00,·,sri mulyani right now:,1,0,0,1027,https://x.com/xibobeb/status/1965014363213025426,https://x.com/IndoPopBase/status/1964988848422916185,1
2025-09-08 09:48:07+00:00,TFI_BUZZZ,Why any personal reasons,1,0,0,14166,https://x.com/TFI_BUZZZ/status/1964989117084950551,https://x.com/IndoPopBase/status/1964988848422916185,1
2025-09-08 09:53:19+00:00,amkathu18,Good for her,1,0,0,5469,https://x.com/amkathu18/status/1964990422469804072,https://x.com/IndoPopBase/status/1964988848422916185,1
2025-09-08 11:07:07+00:00,mdkousik31,Was he involved in any corruption?,2,0,0,21219,https://x.com/mdkousik31/status/1965008994675954060,https://x.com/IndoPopBase/status/1964988848422916185,2
2025-09-08 09:58:42+00:00,mdkousik31,What is Liputan6?,5,0,0,18039,https://x.com/mdkousik31/status/1964991778781901072,https://x.com/IndoPopBase/status/1964988848422916185,5
2025-09-08 13:39:29+00:00,bimperks,"""Akhirnya gw bisa resign """,0,0,0,179,https://x.com/bimperks/status/1965047341247017276,https://x.com/IndoPopBase/status/1964988848422916185,0
2025-09-08 12:55:40+00:00,Noisenoise58188,"Orang Neolib disuruh ngurus negara, ya nggak lah, orang dia mah pengennya negara ngutang ",0,0,0,514,https://x.com/Noisenoise58188/status/1965036313100640581,https://x.com/IndoPopBase/status/1964988848422916185,0
2025-09-08 12:57:31+00:00,Ikhwanazis89,Perlu Pizza limo berapa banyak buat bagi-bagi ke cowoker?,0,0,0,297,https://x.com/Ikhwanazis89/status/1965036780568412283,https://x.com/IndoPopBase/status/1964988848422916185,0
2025-09-08 11:15:53+00:00,zenstrive,Her Coretax crime needs to be tried for justice,1,0,0,685,https://x.com/zenstrive/status/1965011203555779049,https://x.com/IndoPopBase/status/1964988848422916185,1
2025-09-08 14:15:38+00:00,yuraya302182,"Watch how the new minister become ur new  nightmare that attacks the people by any means to seek funds. BY ALL MEANS, and see how we will miss the former minister. Well you only need the light when it's burning low .",0,0,0,240,https://x.com/yuraya302182/status/1965056438918844448,https://x.com/IndoPopBase/status/1964988848422916185,0
2025-09-08 09:54:38+00:00,ScarySony,"Kenapa ga batalin segala kebijakan2 mencekik yg dia buat dulu, br dia mundur?
Dah terlanjur ""namanya jelek dan sumpahan orang2"" kan?",0,0,0,318,https://x.com/ScarySony/status/1964990756457976266,https://x.com/IndoPopBase/status/1964988848422916185,0
2025-09-08 09:51:16+00:00,hitrewindd,What's the tea?!,1,0,0,2104,https://x.com/hitrewindd/status/1964989909250531468,https://x.com/IndoPopBase/status/1964988848422916185,1
2025-09-08 13:29:30+00:00,JeloveNoah,Dia sudah merasa akan diganti ,0,0,0,130,https://x.com/JeloveNoah/status/1965044829395771791,https://x.com/IndoPopBase/status/1964988848422916185,0
2025-09-09 02:03:32+00:00,AndiHua25555496,"Banyak yg ga suka sama dia, tapi dia hanya menteri, banyak yg bilang dia acc gaji dpr, tapi nyatanya dia tidak bisa atur masalah itu. pemerintah mau duit cari dia, makanya dia perlu bikin kebijakan sana sini yg terkesan ""malak"" rakyat, tapi sesunguhnya bukan kemauan dia",1,0,0,133,https://x.com/AndiHua25555496/status/1965234585694044264,https://x.com/IndoPopBase/status/1964988848422916185,1
2025-09-08 09:53:49+00:00,AlanDeosmund,Siapa yang akan menggantikan kursi panas menteri keuangan?,0,0,0,829,https://x.com/AlanDeosmund/status/1964990550765162589,https://x.com/IndoPopBase/status/1964988848422916185,0
2025-09-08 10:56:57+00:00,pedal_so_heavy,"TANGGAPAN 
@bukanbahlil",1,0,0,460,https://x.com/pedal_so_heavy/status/1965006439891734819,https://x.com/IndoPopBase/status/1964988848422916185,1
2025-09-08 09:47:29+00:00,sugar_6378,Waduhh,1,0,0,17528,https://x.com/sugar_6378/status/1964988955688046791,https://x.com/IndoPopBase/status/1964988848422916185,1
2025-09-08 10:22:51+00:00,Sagar_tarak18,any particular reason behind?,1,0,0,8503,https://x.com/Sagar_tarak18/status/1964997855300726918,https://x.com/IndoPopBase/status/1964988848422916185,1
2025-09-08 16:46:55+00:00,C3170crypto,Berita nyaa....,0,0,0,6,https://x.com/C3170crypto/status/1965094511090278549,https://x.com/IndoPopBase/status/1964988848422916185,0
2025-09-08 23:12:13+00:00,achmaddimasn,Kapolri kapan mundurnya?,0,0,0,9,https://x.com/achmaddimasn/status/1965191475190530468,https://x.com/IndoPopBase/status/1964988848422916185,0
2025-09-08 13:10:24+00:00,Je_Ry1,Damn,0,0,0,147,https://x.com/Je_Ry1/status/1965040021096042890,https://x.com/IndoPopBase/status/1964988848422916185,0
2025-09-08 12:18:34+00:00,noturexsorry,Thank god,0,0,0,221,https://x.com/noturexsorry/status/1965026976529555721,https://x.com/IndoPopBase/status/1964988848422916185,0
2025-09-10 06:37:23+00:00,Ryomen_Yuujii,"President tolol wowo cuma nyusahin orang, sok jadi pahlawan kesiangan , narcissistic qkut, punya daddy issue. Pikiranya cuma makan, maknya programnya cuma makan.",0,0,0,4,https://x.com/Ryomen_Yuujii/status/1965665893285069060,https://x.com/IndoPopBase/status/1964988848422916185,0
2025-09-08 09:57:12+00:00,rwicaks_,Bro sudah stress,0,0,0,168,https://x.com/rwicaks_/status/1964991402947051953,https://x.com/IndoPopBase/status/1964988848422916185,0
2025-09-05 14:09:11+00:00,dnamadara,,0,852,0,94916,https://x.com/dnamadara/status/1963967652717826451,https://x.com/IndoPopBase/status/1963966176729678066,852
2025-09-05 14:22:11+00:00,admiralkizaruuu,"Ada yg percaya THP mereka 65 juta aja udah aneh. 
Buat apa habis puluhan miliar biar kepilih, tapi cuma dapat THP segitu wkwkwk
Dan anehnya gak ada anggota DPR yg makin miskin setelah menjabat ",11,299,0,84655,https://x.com/admiralkizaruuu/status/1963970922152677606,https://x.com/IndoPopBase/status/1963966176729678066,310
2025-09-05 15:19:53+00:00,irajule13,"Masih kegedean lah??! Jadiin max banget 3-5x UMR jakarta! Tanpa tunjangan beras dll lho ya!

 Kalo mereka pengen gajinya naik, ya UMRnya dinaikkan!",13,281,0,73993,https://x.com/irajule13/status/1963985445701947715,https://x.com/IndoPopBase/status/1963966176729678066,294
2025-09-05 14:13:43+00:00,RizkiChrn,Make it 15mil a month then we gucci,2,44,0,68008,https://x.com/RizkiChrn/status/1963968793967042718,https://x.com/IndoPopBase/status/1963966176729678066,46
2025-09-05 22:23:02+00:00,semangkukuji,"Ini biaya komunikasi gamau dikecilin kah? kayak pernah komunikasi sama masyarakat aja~ sekalinya komunikasi jg rakyat dikatain tolol, nyombongin diri sebagai artis, dan ngeluh rumah jauh ya anying",17,148,0,29049,https://x.com/semangkukuji/status/1964091932122005765,https://x.com/IndoPopBase/status/1963966176729678066,165
2025-09-05 14:08:07+00:00,MIKESrePLAY,Not low enough,0,11,0,32552,https://x.com/MIKESrePLAY/status/1963967382155882864,https://x.com/IndoPopBase/status/1963966176729678066,11
2025-09-05 14:19:42+00:00,aptisk10,They'll find other means to supplement their incomes.,1,3,0,33094,https://x.com/aptisk10/status/1963970299709604263,https://x.com/IndoPopBase/status/1963966176729678066,4
2025-09-05 14:14:14+00:00,0xHarryry,From?,0,0,0,19672,https://x.com/0xHarryry/status/1963968924044955773,https://x.com/IndoPopBase/status/1963966176729678066,0
2025-09-05 14:36:17+00:00,mitokondriyuh,Masih ketutup sama reses wkwk,0,0,0,1825,https://x.com/mitokondriyuh/status/1963974470844244335,https://x.com/IndoPopBase/status/1963966176729678066,0
2025-09-05 14:07:26+00:00,shiholoveacc,"Masih banyak banget, kurangin lagi lah bngst",0,0,0,1062,https://x.com/shiholoveacc/status/1963967209644122313,https://x.com/IndoPopBase/status/1963966176729678066,0
2025-09-05 14:42:30+00:00,hurufsanji,"Still 13 times bigger than indonesia’s minimum wage btw
Also, remove the tunjangan pensiun because they (((worked))) only for 5 years not forever till they die?!",0,0,0,332,https://x.com/hurufsanji/status/1963976037194494380,https://x.com/IndoPopBase/status/1963966176729678066,0
2025-09-05 15:50:42+00:00,wbblbbdubdub,"Yang jadi masalah di sini yaitu kepercayaan publik dan integritas yang kita pertanyakan. Kalo kerja bagus, hasilnya ada, pro rakyat dan transparan ya pasti segitupun kita ikhlas. LAH INI?

Starts from bottom bcs you put people's trust on the bottom. Might be 9-10jt baru fair",0,1,0,1340,https://x.com/wbblbbdubdub/status/1963993199288136112,https://x.com/IndoPopBase/status/1963966176729678066,1
2025-09-05 14:12:53+00:00,nyebutdulu,bangkeeeee penurunan cuma Butiran debu,0,0,0,1020,https://x.com/nyebutdulu/status/1963968583270330825,https://x.com/IndoPopBase/status/1963966176729678066,0
2025-09-05 15:21:23+00:00,mnlghtshine,"Bisa kali turun lagi, 25jt okelah, 65.5 mah masih banyak atuh, apalagi tunjangan kehormatan, ngga usah pakai tunjangan kehormatan juga udah dihormati sih kalau kerjanya bagus wkwk",0,0,0,559,https://x.com/mnlghtshine/status/1963985823088681188,https://x.com/IndoPopBase/status/1963966176729678066,0
2025-09-05 15:46:03+00:00,Agungbusby,Diketawain pak mahfud...,0,1,0,701,https://x.com/Agungbusby/status/1963992030515954085,https://x.com/IndoPopBase/status/1963966176729678066,1
2025-09-05 14:33:55+00:00,Ibnu_stiawan,"Pada fokus di gaji. Tp ndak paham pendapatan mereka dlm hal proyek, reses, dll.",0,0,0,329,https://x.com/Ibnu_stiawan/status/1963973874380599711,https://x.com/IndoPopBase/status/1963966176729678066,0
2025-09-05 16:01:44+00:00,shinypiplupp,Gak tau diri,0,0,0,40,https://x.com/shinypiplupp/status/1963995975732936719,https://x.com/IndoPopBase/status/1963966176729678066,0
2025-09-05 15:20:00+00:00,rajakhae,"Masih ada aja itu tunjangan beras, buset, gak bisa beli sendiri apa? ",0,1,0,434,https://x.com/rajakhae/status/1963985473325683141,https://x.com/IndoPopBase/status/1963966176729678066,1
2025-09-05 14:44:31+00:00,sunnyhaseyo,"Anjirrr itu mah masih gede! 10jt itu udah pas buat mereka, gk ding kegedaan juga, kan kerjaan mereka tidur doang",0,1,0,348,https://x.com/sunnyhaseyo/status/1963976543589515497,https://x.com/IndoPopBase/status/1963966176729678066,1
2025-09-05 14:19:41+00:00,jawaberat,Turunin jd 6.5 jing,0,0,0,266,https://x.com/jawaberat/status/1963970294252749283,https://x.com/IndoPopBase/status/1963966176729678066,0
2025-09-05 15:35:16+00:00,segerrbenerrr,"percaya kalo iya juga masih kegedean, buktiin dulu kinerjanya kocak, gerecep banget kalo bahas duit",0,0,0,109,https://x.com/segerrbenerrr/status/1963989315480146047,https://x.com/IndoPopBase/status/1963966176729678066,0
2025-09-05 14:17:03+00:00,yunocokr,Need it go at least 10 times lower tbh,0,0,0,354,https://x.com/yunocokr/status/1963969632592941399,https://x.com/IndoPopBase/status/1963966176729678066,0
2025-09-05 14:25:04+00:00,chococustart,not enough decrease it mo're. its a 'noble' position after all,0,0,0,69,https://x.com/chococustart/status/1963971647762817356,https://x.com/IndoPopBase/status/1963966176729678066,0
2025-09-05 20:11:21+00:00,kkvbricks,"masij gede bgt dibandingkan negara lain, perbandingan dengan UMR kita yg sangat kecil, ga masih jomplang. aku berekspektasi sekitar 10-15jt aja THP mereka",0,0,0,165,https://x.com/kkvbricks/status/1964058793278390741,https://x.com/IndoPopBase/status/1963966176729678066,0
2025-09-05 14:39:40+00:00,__folklore__,suruh bayar pajak juga tuh dpr,0,0,0,135,https://x.com/__folklore__/status/1963975324548665534,https://x.com/IndoPopBase/status/1963966176729678066,0
2025-09-05 14:37:01+00:00,DROPTHEGRAVITY,"Masih gede kak, turunin lagi yuk",0,0,0,64,https://x.com/DROPTHEGRAVITY/status/1963974655980851510,https://x.com/IndoPopBase/status/1963966176729678066,0
2025-09-05 15:47:05+00:00,boruSidauruk,"Masih cukup masuk akal walau dibandingkan UMR masih jomplang. Asal mereka bekerja dgn maksimal dan tidak ada lagi tambahan Ini dan Itu yang berlebihan.
Dengan penghasilan segini seharusnya sih ya hidup mereka sudah nyaman dan sudah bisa fokus bekerja dengan baik untuk masyarakat.",0,0,0,539,https://x.com/boruSidauruk/status/1963992288998383880,https://x.com/IndoPopBase/status/1963966176729678066,0
2025-09-05 16:39:56+00:00,nipslipyeah,"30 juta max, no tawar nawar",0,0,0,46,https://x.com/nipslipyeah/status/1964005587454173595,https://x.com/IndoPopBase/status/1963966176729678066,0
2025-09-05 21:20:19+00:00,wh_you28,"still too big. in developed country, DPR net pay is under 2-3x Median wage. median wage not UMR jakarta. 

jadi kalo ngikutin negara maju = 3x median wage = 3x 4jt =12 jt. masih kegedean",0,0,0,27,https://x.com/wh_you28/status/1964076149295693840,https://x.com/IndoPopBase/status/1963966176729678066,0
2025-09-06 06:40:48+00:00,und_cuckoosnest,"It's not a drop!
Ini mah cara nawar nyokap gue ke pasar.
It's 11.5 million rupiah per MP hike!
And eleven people died, thousands imprisoned and hospitalized, for that!",0,0,0,114,https://x.com/und_cuckoosnest/status/1964217201184911548,https://x.com/IndoPopBase/status/1963966176729678066,0
2025-09-05 16:15:02+00:00,L0vehe4ls,65...??? Make that shit 10 tf??,0,0,0,125,https://x.com/L0vehe4ls/status/1963999324028756179,https://x.com/IndoPopBase/status/1963966176729678066,0
2025-09-05 14:16:04+00:00,sunfyresclaw,Yeah check out their other periodic massive tunjangan & you’d be even more surprised,0,0,0,51,https://x.com/sunfyresclaw/status/1963969383610355968,https://x.com/IndoPopBase/status/1963966176729678066,0
2025-09-05 15:46:08+00:00,letitoncebeme13,still alot. this is not fair,0,0,0,36,https://x.com/letitoncebeme13/status/1963992049545290224,https://x.com/IndoPopBase/status/1963966176729678066,0
2025-09-05 15:23:22+00:00,dinisuciyanti,Iya tapi itu cuma ganti nama aja,0,0,0,62,https://x.com/dinisuciyanti/status/1963986319404646514,https://x.com/IndoPopBase/status/1963966176729678066,0
2025-09-05 15:35:29+00:00,uchatadara,That still crazy amount of money considering the lowest impact and bad service they give to us,0,0,0,67,https://x.com/uchatadara/status/1963989368110043621,https://x.com/IndoPopBase/status/1963966176729678066,0
2025-09-06 04:03:16+00:00,·,,0,0,0,3,https://x.com/yuno_kitten/status/1964177553637114168,https://x.com/IndoPopBase/status/1963966176729678066,0
2025-09-06 12:59:20+00:00,sunoomesir,kurangin lg dong jadi 3 juta per bulan,0,0,0,3,https://x.com/sunoomesir/status/1964312462552912262,https://x.com/IndoPopBase/status/1963966176729678066,0
2025-09-05 17:15:47+00:00,kdzurae,"Tetep gede bgt anjrit, apa apaan",0,0,0,11,https://x.com/kdzurae/status/1964014609779871911,https://x.com/IndoPopBase/status/1963966176729678066,0
2025-09-05 15:34:39+00:00,nananyanyaw,"Ga ada kinerja kok gajinya gde banget, kocakkkk",0,0,0,32,https://x.com/nananyanyaw/status/1963989159330107500,https://x.com/IndoPopBase/status/1963966176729678066,0
2025-09-05 16:54:12+00:00,oktoshb,"yang tunjangan konstitusional, Ini semua dasar hukumnya tahun 2025.

apakah ini emang ada tahun sebelumnya atau presiden sebelumnya?",0,1,0,353,https://x.com/oktoshb/status/1964009179372286305,https://x.com/IndoPopBase/status/1963966176729678066,1
2025-09-05 14:45:30+00:00,ifyunojh,masih kebanyakan,0,0,0,20,https://x.com/ifyunojh/status/1963976789765787881,https://x.com/IndoPopBase/status/1963966176729678066,0
2025-09-06 04:10:13+00:00,Latifahnrmdhn,dih masih kegedean ege,0,0,0,24,https://x.com/Latifahnrmdhn/status/1964179304142524757,https://x.com/IndoPopBase/status/1963966176729678066,0
2025-09-06 05:02:39+00:00,nasikornettelor,"Good, now lets push them to max 1x jkt umr",0,0,0,1762,https://x.com/nasikornettelor/status/1964192501016809666,https://x.com/IndoPopBase/status/1963966176729678066,0
2025-09-05 14:19:44+00:00,amkathu18,Credibility is coming to return,0,0,0,146,https://x.com/amkathu18/status/1963970306902749213,https://x.com/IndoPopBase/status/1963966176729678066,0
2025-09-06 05:10:33+00:00,samyancheese,anyinggg apaan 65juta. harusnya umr aja,0,0,0,5,https://x.com/samyancheese/status/1964194487061631081,https://x.com/IndoPopBase/status/1963966176729678066,0
2025-09-05 16:57:25+00:00,TFI_BUZZZ,"@grok
 what is that",1,0,0,4290,https://x.com/TFI_BUZZZ/status/1964009990634819744,https://x.com/IndoPopBase/status/1963966176729678066,1
2025-09-05 18:56:45+00:00,opninaism,STILL TOO BIG FOR A JOB THAT DOES NOTHING,0,0,0,5,https://x.com/opninaism/status/1964040018793812120,https://x.com/IndoPopBase/status/1963966176729678066,0
2025-09-05 15:00:21+00:00,mdkousik31,"@grok
 source?",0,0,0,10990,https://x.com/mdkousik31/status/1963980527536673159,https://x.com/IndoPopBase/status/1963966176729678066,0
2025-09-05 15:04:40+00:00,Seung_ha_,"@grok
 this tweet valid or not",1,0,0,23736,https://x.com/Seung_ha_/status/1963981615438213552,https://x.com/IndoPopBase/status/1963966176729678066,1
2025-09-05 17:22:37+00:00,moonfraction,emang knp si ga 5-10jt perbulan? itu jg masih kebanyakan kalo nerawang KPI klen,0,0,0,29,https://x.com/moonfraction/status/1964016331990454364,https://x.com/IndoPopBase/status/1963966176729678066,0
2025-09-05 14:15:39+00:00,0xHarryry,kami bersamamuu nadinn ,0,0,0,667,https://x.com/0xHarryry/status/1963969279969374270,https://x.com/IndoPopBase/status/1963962226659700964,0
2025-09-05 14:38:13+00:00,manusahalu,"ohh GODin amizah, don't end that HAGita FLOPina like that",0,2,0,3489,https://x.com/manusahalu/status/1963974957035319740,https://x.com/IndoPopBase/status/1963962226659700964,2
2025-09-05 15:57:55+00:00,ddafid_,oh goddin amizah the mother that you are,0,0,0,2332,https://x.com/ddafid_/status/1963995014565945482,https://x.com/IndoPopBase/status/1963962226659700964,0
2025-09-06 04:58:21+00:00,pvndvmlvks,public speakingnya lebih bagus dari gibran,2,1,0,1576,https://x.com/pvndvmlvks/status/1964191417737367643,https://x.com/IndoPopBase/status/1963962226659700964,3
2025-09-05 14:02:08+00:00,pelurukuhabis,"Diam… si rakus berpesta. 
Bersuara…. harapan tumbuh. 

Nadin udah kasih contoh, giliran kita ikut bersuara.",0,0,0,2550,https://x.com/pelurukuhabis/status/1963965877617062193,https://x.com/IndoPopBase/status/1963962226659700964,0
2025-09-05 14:04:59+00:00,inijugayeni,"""pulang dengan selamat ya"" ",0,0,0,2024,https://x.com/inijugayeni/status/1963966594008420655,https://x.com/IndoPopBase/status/1963962226659700964,0
2025-09-05 14:20:23+00:00,OnetrickYasuo,Lebih punk dari rebellion rose dia rek,0,0,0,2599,https://x.com/OnetrickYasuo/status/1963970470329667907,https://x.com/IndoPopBase/status/1963962226659700964,0
2025-09-05 13:51:31+00:00,dnamadara,ok Nadin.,0,0,0,2982,https://x.com/dnamadara/status/1963963204117131530,https://x.com/IndoPopBase/status/1963962226659700964,0
2025-09-05 14:38:30+00:00,repxkomh13,OH GODIN GODMIZAH,0,0,0,1142,https://x.com/repxkomh13/status/1963975029261312101,https://x.com/IndoPopBase/status/1963962226659700964,0
2025-09-05 16:29:11+00:00,velvetthorns_,ibu peri aku,0,1,0,396,https://x.com/velvetthorns_/status/1964002883419951177,https://x.com/IndoPopBase/status/1963962226659700964,1
2025-09-07 07:01:11+00:00,5zelnut,suaranya sehangat pelukan bunda.. real mimi peri kita ,0,0,0,226,https://x.com/5zelnut/status/1964584716386127963,https://x.com/IndoPopBase/status/1963962226659700964,0
2025-09-05 14:42:30+00:00,wontonkukus,OH NADALLAH,0,0,0,559,https://x.com/wontonkukus/status/1963976037190037706,https://x.com/IndoPopBase/status/1963962226659700964,0
2025-09-05 15:42:07+00:00,dimaswaraha,Respect ,0,0,0,563,https://x.com/dimaswaraha/status/1963991039804338373,https://x.com/IndoPopBase/status/1963962226659700964,0
2025-09-05 15:35:07+00:00,getawaywar,queen shit,0,0,0,789,https://x.com/getawaywar/status/1963989275709784322,https://x.com/IndoPopBase/status/1963962226659700964,0
2025-09-05 14:25:42+00:00,estelersatu,exactly,0,0,0,730,https://x.com/estelersatu/status/1963971806039298418,https://x.com/IndoPopBase/status/1963962226659700964,0
2025-09-05 16:44:41+00:00,arthemystic,my girrrlll ,0,0,0,498,https://x.com/arthemystic/status/1964006784613404844,https://x.com/IndoPopBase/status/1963962226659700964,0
2025-09-06 10:41:14+00:00,sooyaism,and nuguta flopina?,0,0,0,77,https://x.com/sooyaism/status/1964277706553713073,https://x.com/IndoPopBase/status/1963962226659700964,0
2025-09-05 18:28:21+00:00,taproses,yass thats it my queen!!,0,0,0,534,https://x.com/taproses/status/1964032872207307173,https://x.com/IndoPopBase/status/1963962226659700964,0
2025-09-06 04:00:18+00:00,kaedehvara,shes so comforting i love her,0,0,0,526,https://x.com/kaedehvara/status/1964176809236234558,https://x.com/IndoPopBase/status/1963962226659700964,0
2025-09-05 14:22:25+00:00,imlookingfor32,Cantik banget pengantin baru,0,0,0,1622,https://x.com/imlookingfor32/status/1963970982088970542,https://x.com/IndoPopBase/status/1963962226659700964,0
2025-09-05 23:56:58+00:00,iwaklawd,mother amizah,0,0,0,370,https://x.com/iwaklawd/status/1964115571508953265,https://x.com/IndoPopBase/status/1963962226659700964,0
2025-09-05 13:48:37+00:00,pleasewelcum,say i louder nadin,0,0,0,1719,https://x.com/pleasewelcum/status/1963962476795445330,https://x.com/IndoPopBase/status/1963962226659700964,0
2025-09-05 13:56:06+00:00,ishowthejee,Louder diva,0,0,0,706,https://x.com/ishowthejee/status/1963964358754779195,https://x.com/IndoPopBase/status/1963962226659700964,0
2025-09-06 06:43:49+00:00,y0urcocaine_,cantikkuuu,0,0,0,139,https://x.com/y0urcocaine_/status/1964217959540244660,https://x.com/IndoPopBase/status/1963962226659700964,0
2025-09-06 09:01:25+00:00,syendiii,Gue sayang banget dah sama dia,0,0,0,364,https://x.com/syendiii/status/1964252587076575390,https://x.com/IndoPopBase/status/1963962226659700964,0
2025-09-06 03:43:17+00:00,suhosaleem,Ma girl ,0,0,0,281,https://x.com/suhosaleem/status/1964172526822838736,https://x.com/IndoPopBase/status/1963962226659700964,0
2025-09-08 05:44:21+00:00,piduto,SUARANYA ENAK BGT DAH,0,0,0,99,https://x.com/piduto/status/1964927770661908663,https://x.com/IndoPopBase/status/1963962226659700964,0
2025-09-05 15:11:19+00:00,americano666,yezzz that's my girl !!!,0,0,0,1241,https://x.com/americano666/status/1963983289217089942,https://x.com/IndoPopBase/status/1963962226659700964,0
2025-09-05 13:48:25+00:00,24Tryn,hmm,0,0,0,515,https://x.com/24Tryn/status/1963962424949633407,https://x.com/IndoPopBase/status/1963962226659700964,0
2025-09-05 14:02:09+00:00,RIGAM07,Tentu saja nadin,0,0,0,458,https://x.com/RIGAM07/status/1963965882821980377,https://x.com/IndoPopBase/status/1963962226659700964,0
2025-09-06 01:33:55+00:00,Cakwenyenders,Girl,0,0,0,430,https://x.com/Cakwenyenders/status/1964139971809288680,https://x.com/IndoPopBase/status/1963962226659700964,0
2025-09-06 13:02:04+00:00,haichalzzzzz,tp ka itu yg nonton ada anak pejabrut jgn2,0,0,0,306,https://x.com/haichalzzzzz/status/1964313149353697465,https://x.com/IndoPopBase/status/1963962226659700964,0
2025-09-05 17:14:36+00:00,buatbertaniii,my girrrlll,0,0,0,558,https://x.com/buatbertaniii/status/1964014311011164259,https://x.com/IndoPopBase/status/1963962226659700964,0
2025-09-05 13:48:12+00:00,24Tryn,"@grok
 what do you think?",1,0,0,1581,https://x.com/24Tryn/status/1963962371535237281,https://x.com/IndoPopBase/status/1963962226659700964,1
2025-09-05 13:48:39+00:00,TFI_BUZZZ,"@gork
 who is she",1,0,0,424,https://x.com/TFI_BUZZZ/status/1963962482013229129,https://x.com/IndoPopBase/status/1963962226659700964,1
2025-09-05 13:48:32+00:00,Kiraribami22,"@grok
 translate it",1,0,0,465,https://x.com/Kiraribami22/status/1963962454616215732,https://x.com/IndoPopBase/status/1963962226659700964,1
2025-09-05 13:20:13+00:00,admiralkizaruuu,"Semua bisa kena kecuali budi arie.
Mau bukti seterang benderang apapun, aman2 aja dia wkwkwk",25,244,0,105057,https://x.com/admiralkizaruuu/status/1963955326807674914,https://x.com/IndoPopBase/status/1963950661294494070,269
2025-09-05 13:05:31+00:00,Rumahdepok_,Kaya guru penjaskes yang sering nilep duit praktek renang,25,114,0,94407,https://x.com/Rumahdepok_/status/1963951629868384557,https://x.com/IndoPopBase/status/1963950661294494070,139
2025-09-05 17:19:17+00:00,Krai_CryptoSage,Budi arie aman aman aja nih?,12,33,0,54110,https://x.com/Krai_CryptoSage/status/1964015492190130191,https://x.com/IndoPopBase/status/1963950661294494070,45
2025-09-05 13:07:42+00:00,dnamadara,rutinitas.,1,7,0,52963,https://x.com/dnamadara/status/1963952180571877594,https://x.com/IndoPopBase/status/1963950661294494070,8
2025-09-05 13:51:20+00:00,recehtuitt,gue masih support pak nadiem tidak bersalah,9,6,0,77120,https://x.com/recehtuitt/status/1963963158382661995,https://x.com/IndoPopBase/status/1963950661294494070,15
2025-09-05 13:03:34+00:00,0xHarryry,Not expect this guy,0,0,0,33606,https://x.com/0xHarryry/status/1963951139361353740,https://x.com/IndoPopBase/status/1963950661294494070,0
2025-09-05 14:53:59+00:00,Sugilico3,Seriusan nanya. Ini AI kah atau beneran?,7,14,0,70820,https://x.com/Sugilico3/status/1963978925199306865,https://x.com/IndoPopBase/status/1963950661294494070,21
2025-09-05 13:15:41+00:00,MIKESrePLAY,Rafi next,4,0,0,37845,https://x.com/MIKESrePLAY/status/1963954187735081066,https://x.com/IndoPopBase/status/1963950661294494070,4
2025-09-05 13:05:16+00:00,ur_fave_homeboy,"Resiko masuk ke kandang tikus, kalo gak jadi tikus yaa, digerogoti tikus 
Lagian kenapa jg ikut2 politik segala, udah bagus ngurus gojek jadi pengusaha",0,16,0,14026,https://x.com/ur_fave_homeboy/status/1963951565682696298,https://x.com/IndoPopBase/status/1963950661294494070,16
2025-09-05 15:10:27+00:00,gilangrosul,Sudah dibilang. Buat profesional Jangan pernah mau diajak maenan ama pwmerintah apalagi dikompori nasionalisme silit..ujungnya dijadikan tumbal,0,0,0,1368,https://x.com/gilangrosul/status/1963983071570530692,https://x.com/IndoPopBase/status/1963950661294494070,0
2025-09-05 14:30:12+00:00,sea_stone45,,1,0,0,794,https://x.com/sea_stone45/status/1963972940925657152,https://x.com/IndoPopBase/status/1963950661294494070,1
2025-09-05 20:56:02+00:00,endiiiel,"Dim...dim udah bener megang Gojek lu, tuh perusahaan udah bisa autopilot.
Tinggal nikmatin hari-hari jadi harvestmoon di Dieng sambil sesekali meeting online/offline sama orang kantor.",3,0,0,2941,https://x.com/endiiiel/status/1964070037398163921,https://x.com/IndoPopBase/status/1963950661294494070,3
2025-09-05 13:57:04+00:00,hendrawk,alhamdulillah profil picture baru ,0,0,0,2606,https://x.com/hendrawk/status/1963964601412030536,https://x.com/IndoPopBase/status/1963950661294494070,0
2025-09-05 13:16:57+00:00,supperince,"That hairline omg, that could've been me or anybody one day",0,0,0,647,https://x.com/supperince/status/1963954508251144387,https://x.com/IndoPopBase/status/1963950661294494070,0
2025-09-05 13:05:24+00:00,kiokio878,Death penalty for him! This bastard destroying Indonesia education system alongside with fuxking Mulyono,0,1,0,1404,https://x.com/kiokio878/status/1963951598830596230,https://x.com/IndoPopBase/status/1963950661294494070,1
2025-09-05 13:13:03+00:00,indriyani_nd,Dia seharusnya ngedengerin David gadgetin.,0,0,0,1175,https://x.com/indriyani_nd/status/1963953523235959075,https://x.com/IndoPopBase/status/1963950661294494070,0
2025-09-05 18:50:22+00:00,ridzki_ss,"Menurut aku, dia ini cuma korban.
Semoga alam semesta berpihak kepadanya.",0,0,0,481,https://x.com/ridzki_ss/status/1964038412148879826,https://x.com/IndoPopBase/status/1963950661294494070,0
2025-09-05 13:01:58+00:00,calmdownhunny,hag,0,0,0,875,https://x.com/calmdownhunny/status/1963950737488314721,https://x.com/IndoPopBase/status/1963950661294494070,0
2025-09-06 02:30:37+00:00,vosverseau,He hyper experimented the hell out of everything again this time,0,0,0,264,https://x.com/vosverseau/status/1964154241125405076,https://x.com/IndoPopBase/status/1963950661294494070,0
2025-09-06 00:16:55+00:00,Ivan01915617,"Gue gak yakin Nadiem seorang koruptor..mungkin dia bersalah sebagai pengambil keputusan proyek..jika setiap proyek pemerintah yang terindikasi kerugian negara bisa di jerat korupsi, bagaimana dengan kereta whosh, bandara kertajati? Bagaimana dengan salahnya keputusan Presiden?",1,0,0,824,https://x.com/Ivan01915617/status/1964120590660620590,https://x.com/IndoPopBase/status/1963950661294494070,1
2025-09-05 15:39:59+00:00,xafinan,Udah bener berdiri di kaki sendiri malah masuk pemerintahan chuaks,0,0,0,841,https://x.com/xafinan/status/1963990500941115507,https://x.com/IndoPopBase/status/1963950661294494070,0
2025-09-05 13:03:52+00:00,eatinggewd,makarim more like makhiarim,0,0,0,910,https://x.com/eatinggewd/status/1963951215827735039,https://x.com/IndoPopBase/status/1963950661294494070,0
2025-09-05 15:08:26+00:00,yurmasofat,rafi Ahmad tayang tanggal berapa?,0,0,0,340,https://x.com/yurmasofat/status/1963982562184884380,https://x.com/IndoPopBase/status/1963950661294494070,0
2025-09-06 07:27:14+00:00,My_Eleuterio,"Dulu punya harapan yg besar pas dia jadi menteri pendidikan.
Tapi liat kurikulum merdeka ini, kok jadi lebih gak ngotak dari K13 kemaren. Hadehhh.
Dihapuskannya ""gak naik kalas"" udah hal yg kacau sihh.
Di jaman dia keknya bertaburan video anak SMP gak bisa perkalian.",1,0,0,1167,https://x.com/My_Eleuterio/status/1964228886712971462,https://x.com/IndoPopBase/status/1963950661294494070,1
2025-09-05 14:02:07+00:00,seoson_changbin,Harusnya : Nadiem Makarim stun at new photo,0,0,0,479,https://x.com/seoson_changbin/status/1963965872802033962,https://x.com/IndoPopBase/status/1963950661294494070,0
2025-09-05 16:55:35+00:00,BaruNetas4,,0,0,0,1452,https://x.com/BaruNetas4/status/1964009528309272792,https://x.com/IndoPopBase/status/1963950661294494070,0
2025-09-06 08:31:20+00:00,uxdesignerd,"Anjay pengalihan isunya kuat banget, gue punya ide, gimana kalo kita terus angkat isu yang lebih gede terus tanpa jeda dengan itu pengalihan isu nangkepin koruptor makin banyak kalo gitu cara mainnya aowkaowko",0,0,0,384,https://x.com/uxdesignerd/status/1964245015921906128,https://x.com/IndoPopBase/status/1963950661294494070,0
2025-09-06 00:14:50+00:00,ttonyams,,0,0,0,282,https://x.com/ttonyams/status/1964120068201005386,https://x.com/IndoPopBase/status/1963950661294494070,0
2025-09-05 14:00:34+00:00,NAHUCIREK,Ketika nadhiem berbuat~~,0,0,0,939,https://x.com/NAHUCIREK/status/1963965481746071589,https://x.com/IndoPopBase/status/1963950661294494070,0
2025-09-05 13:15:39+00:00,·,just hyper experiment the hell out of everything you do,0,0,0,1114,https://x.com/yuanst/status/1963954179971367046,https://x.com/IndoPopBase/status/1963950661294494070,0
2025-09-05 13:02:45+00:00,rioinfani,nadiem makarim stun in new photo,1,0,0,4464,https://x.com/rioinfani/status/1963950931294466537,https://x.com/IndoPopBase/status/1963950661294494070,1
2025-09-05 13:23:00+00:00,khaizureblue,"gara-gara elu nih, gue belajar rasanya bukan kayak sekolah. plin plan. mulai dari K13 sampe P5. dikira semua guru siap sama peraturan lu yang seenak pantat lu ubah. ah elu. mending gojek dah gojek. bolot lu",1,0,0,1631,https://x.com/khaizureblue/status/1963956029751804232,https://x.com/IndoPopBase/status/1963950661294494070,1
2025-09-06 02:15:03+00:00,linqz_4me,Hewan di lindungi kalo ketangkap kudu di realeas lagi biar ga punah,0,0,0,863,https://x.com/linqz_4me/status/1964150322399760572,https://x.com/IndoPopBase/status/1963950661294494070,0
2025-09-07 01:07:44+00:00,gstayuananda,Udh tajir melintir hidup kualitas tinggi to milih masuk pemerintahan indo what a life bro,0,0,0,71,https://x.com/gstayuananda/status/1964495768930439573,https://x.com/IndoPopBase/status/1963950661294494070,0
2025-09-05 16:17:33+00:00,DaVoida_,"udah bener fokus di gojek aja, malah nyemplung politik ",0,0,0,391,https://x.com/DaVoida_/status/1963999956295123089,https://x.com/IndoPopBase/status/1963950661294494070,0
2025-09-05 13:25:51+00:00,·,sukses ya by,0,0,0,359,https://x.com/postraumatized/status/1963956746638028824,https://x.com/IndoPopBase/status/1963950661294494070,0
2025-09-05 13:19:35+00:00,sstellajeruk,the hell out of the experiment,1,0,0,1258,https://x.com/sstellajeruk/status/1963955170036842677,https://x.com/IndoPopBase/status/1963950661294494070,1
2025-09-05 17:27:01+00:00,frz_tmr,"Cuekin aja. 
Mau alihin isu 17+8 doang. 
Bodo amat.",0,0,0,252,https://x.com/frz_tmr/status/1964017439345373197,https://x.com/IndoPopBase/status/1963950661294494070,0
2025-09-05 14:55:51+00:00,Vernsel_,ate,0,0,0,64,https://x.com/Vernsel_/status/1963979395456283095,https://x.com/IndoPopBase/status/1963950661294494070,0
2025-09-05 14:37:56+00:00,remasbulu,Stuns ga ni,0,0,0,126,https://x.com/remasbulu/status/1963974885254050026,https://x.com/IndoPopBase/status/1963950661294494070,0
2025-09-05 14:30:54+00:00,Hyungstress,taiklah ni manusia anjingg,0,0,0,314,https://x.com/Hyungstress/status/1963973114725097695,https://x.com/IndoPopBase/status/1963950661294494070,0
2025-09-05 16:29:55+00:00,andreyzzzzss,"oke gatau kenapa ragu aja sama keputusannya, mungkin krn masalah tom lembong kemarin?",0,0,0,572,https://x.com/andreyzzzzss/status/1964003068745273754,https://x.com/IndoPopBase/status/1963950661294494070,0
2025-09-05 15:29:48+00:00,bsullyoon,Did he beyond hyperexperiment the hell out of everything he does,0,0,0,788,https://x.com/bsullyoon/status/1963987937990725932,https://x.com/IndoPopBase/status/1963950661294494070,0
2025-09-05 13:22:28+00:00,kkatarin_a,"He’s going to like it there, men everywhere",0,0,0,446,https://x.com/kkatarin_a/status/1963955893059654098,https://x.com/IndoPopBase/status/1963950661294494070,0
2025-09-05 13:41:37+00:00,crowddcloud,dia mukanya cemberut terus knp y,1,0,0,5358,https://x.com/crowddcloud/status/1963960713921331515,https://x.com/IndoPopBase/status/1963950661294494070,1
2025-09-05 17:48:31+00:00,babijoged,Nah Diem diem korupsi,0,0,0,114,https://x.com/babijoged/status/1964022848051433976,https://x.com/IndoPopBase/status/1963950661294494070,0
2025-09-05 13:09:21+00:00,mikiaflynn,"He can top 
@crushrockwell",0,0,0,635,https://x.com/mikiaflynn/status/1963952592477991376,https://x.com/IndoPopBase/status/1963950661294494070,0
2025-09-06 06:41:14+00:00,senjajelitaw,hiks banget,0,0,0,27,https://x.com/senjajelitaw/status/1964217309746090319,https://x.com/IndoPopBase/status/1963950661294494070,0
2025-09-06 07:28:26+00:00,bahtiar02basri,Orang payah,0,0,0,0,https://x.com/bahtiar02basri/status/1964229185158746592,https://x.com/IndoPopBase/status/1963950661294494070,0
2025-09-06 05:55:23+00:00,H3nr16,"Aduh ni orang, bisa2 nya masa kecil bahagia dewasanya ngerasain masuk penjara ",0,0,0,331,https://x.com/H3nr16/status/1964205768829513910,https://x.com/IndoPopBase/status/1963950661294494070,0
2025-09-04 16:40:57+00:00,dewimaysaa,,4,9,0,2775,https://x.com/dewimaysaa/status/1963643458838827270,https://x.com/IndoPopBase/status/1963642458740592884,13
2025-09-04 16:42:47+00:00,Rumahdepok_,Yang bener itu tonight kelahiran Baginda nabi ,0,1,0,1184,https://x.com/Rumahdepok_/status/1963643916861018519,https://x.com/IndoPopBase/status/1963642458740592884,1
2025-09-04 16:39:01+00:00,dnamadara,Jum'at Kliwon + jadi WNI,0,0,0,1418,https://x.com/dnamadara/status/1963642968923050145,https://x.com/IndoPopBase/status/1963642458740592884,0
2025-09-04 16:40:36+00:00,laxaheat,we will make sure to set a ritual to end government this night,0,0,0,599,https://x.com/laxaheat/status/1963643366706696354,https://x.com/IndoPopBase/status/1963642458740592884,0
2025-09-04 17:17:06+00:00,BeckBekbek,,1,1,0,1132,https://x.com/BeckBekbek/status/1963652553658581405,https://x.com/IndoPopBase/status/1963642458740592884,2
2025-09-04 16:48:31+00:00,lavieenro_se,Lebih takut ngak ada duit daripada hantu gw mah,0,0,0,714,https://x.com/lavieenro_se/status/1963645360058077659,https://x.com/IndoPopBase/status/1963642458740592884,0
2025-09-04 17:29:18+00:00,ndroe_,you got a reply,0,0,0,343,https://x.com/ndroe_/status/1963655624933478423,https://x.com/IndoPopBase/status/1963642458740592884,0
2025-09-04 17:44:20+00:00,lovinfriday,Bjir,0,0,0,70,https://x.com/lovinfriday/status/1963659409357480325,https://x.com/IndoPopBase/status/1963642458740592884,0
2025-09-04 16:37:18+00:00,calmdownhunny,oh lemme ngumbah keris,0,0,0,333,https://x.com/calmdownhunny/status/1963642539241869787,https://x.com/IndoPopBase/status/1963642458740592884,0
2025-09-04 16:41:16+00:00,AGN3ZONE,So what?????,0,0,0,250,https://x.com/AGN3ZONE/status/1963643536848687132,https://x.com/IndoPopBase/status/1963642458740592884,0
2025-09-04 16:38:14+00:00,ultramenoo,lebih horor lagi jadi WNI,0,0,0,345,https://x.com/ultramenoo/status/1963642774873624848,https://x.com/IndoPopBase/status/1963642458740592884,0
2025-09-04 16:39:35+00:00,ur_fave_homeboy,And what we supposed to do with this information??,0,0,0,525,https://x.com/ur_fave_homeboy/status/1963643113161068709,https://x.com/IndoPopBase/status/1963642458740592884,0
2025-09-04 18:14:02+00:00,hardhene,chappel roan what r you doing on the floor?,0,0,0,385,https://x.com/hardhene/status/1963666883976319314,https://x.com/IndoPopBase/status/1963642458740592884,0
2025-09-05 11:29:07+00:00,gakgitudongpal,For all dukun jawir its time for you to shine and do your best to get those KORUPTOR TAI,0,0,0,61,https://x.com/gakgitudongpal/status/1963927369422622721,https://x.com/IndoPopBase/status/1963642458740592884,0
2025-09-05 02:32:41+00:00,veezy_boy,I dont give a s*it,0,0,0,29,https://x.com/veezy_boy/status/1963792370492957042,https://x.com/IndoPopBase/status/1963642458740592884,0
2025-09-04 16:51:46+00:00,eloisepickles,"Maulid Nabi, kakkk",0,0,0,839,https://x.com/eloisepickles/status/1963646180497527104,https://x.com/IndoPopBase/status/1963642458740592884,0
2025-09-04 16:57:47+00:00,eTIRnalsunshine,omg queen,0,0,0,200,https://x.com/eTIRnalsunshine/status/1963647691176776023,https://x.com/IndoPopBase/status/1963642458740592884,0
2025-09-04 16:42:30+00:00,Sanityinsan1ty,"""Suketi, manut to, Nduk. Koe neng arep dadi anakku"".",0,0,0,437,https://x.com/Sanityinsan1ty/status/1963643847105560768,https://x.com/IndoPopBase/status/1963642458740592884,0
2025-09-04 16:37:41+00:00,salllhoney,lebih horor negara ini,0,0,0,312,https://x.com/salllhoney/status/1963642635861860446,https://x.com/IndoPopBase/status/1963642458740592884,0
2025-09-04 16:58:50+00:00,diselangkangen,"@grok
 tolong jadikan terlihat lebih lucu.",1,0,0,853,https://x.com/diselangkangen/status/1963647957926121659,https://x.com/IndoPopBase/status/1963642458740592884,1
2025-09-04 16:37:49+00:00,txtfrombriii,kaget,0,0,0,384,https://x.com/txtfrombriii/status/1963642668820697591,https://x.com/IndoPopBase/status/1963642458740592884,0
2025-09-04 16:39:31+00:00,BANANAKAKUMEl,and fuck pragib,0,0,0,264,https://x.com/BANANAKAKUMEl/status/1963643096006369560,https://x.com/IndoPopBase/status/1963642458740592884,0
2025-09-04 16:44:26+00:00,3usri,she's stunning,0,0,0,285,https://x.com/3usri/status/1963644331497066794,https://x.com/IndoPopBase/status/1963642458740592884,0
2025-09-04 16:37:54+00:00,WealthyBMM,Or what is Jumat Kliwon?,0,0,0,116,https://x.com/WealthyBMM/status/1963642688239976837,https://x.com/IndoPopBase/status/1963642458740592884,0
2025-09-04 16:37:42+00:00,WealthyBMM,Who is Jumat kiliwon?,0,0,0,102,https://x.com/WealthyBMM/status/1963642639439315351,https://x.com/IndoPopBase/status/1963642458740592884,0
2025-09-04 17:06:25+00:00,containsclouds,Awas di jendela kamarmu min,0,0,0,219,https://x.com/containsclouds/status/1963649866120450190,https://x.com/IndoPopBase/status/1963642458740592884,0
2025-09-04 16:39:50+00:00,0xgasm,kaget jir,0,0,0,146,https://x.com/0xgasm/status/1963643175505138112,https://x.com/IndoPopBase/status/1963642458740592884,0
2025-09-04 17:52:12+00:00,ursbharathish,Tonight ,0,0,0,115,https://x.com/ursbharathish/status/1963661385902022772,https://x.com/IndoPopBase/status/1963642458740592884,0
2025-09-04 16:46:31+00:00,hemanthkohli149,Wt happened ?,0,0,0,102,https://x.com/hemanthkohli149/status/1963644859417534857,https://x.com/IndoPopBase/status/1963642458740592884,0
2025-09-04 16:41:54+00:00,rineeth_PRK,What that mean?,0,0,0,117,https://x.com/rineeth_PRK/status/1963643697377284596,https://x.com/IndoPopBase/status/1963642458740592884,0
2025-09-04 16:42:01+00:00,amkathu18,"@grok
 context",2,0,0,575,https://x.com/amkathu18/status/1963643725432983831,https://x.com/IndoPopBase/status/1963642458740592884,2
2025-09-04 17:50:13+00:00,HarshaKnaidu14,Evil,0,0,0,68,https://x.com/HarshaKnaidu14/status/1963660888231260430,https://x.com/IndoPopBase/status/1963642458740592884,0
2025-09-04 16:44:41+00:00,Sagar_tarak18,"@grok
 what is mean ?",1,0,0,82,https://x.com/Sagar_tarak18/status/1963644398375469229,https://x.com/IndoPopBase/status/1963642458740592884,1
2025-09-04 16:47:29+00:00,Sagar_tarak18,"Jumat Kliwon is Friday combined with ""Kliwon"" from the Javanese 5-day week (Pasaran). In Indonesian/Javanese culture, it's viewed as a sacred night for rituals, often linked to mysticism or supernatural beliefs. The image likely nods to its spooky folklore vibe.",0,0,0,122,https://x.com/Sagar_tarak18/status/1963645102003278307,https://x.com/IndoPopBase/status/1963642458740592884,0
2025-09-04 16:45:20+00:00,Sagar_tarak18,jumat kliwon,0,0,0,96,https://x.com/Sagar_tarak18/status/1963644559197614301,https://x.com/IndoPopBase/status/1963642458740592884,0
2025-09-04 17:29:29+00:00,brodeldi,Lebih serem liat kinerja pemerintah,0,0,0,40,https://x.com/brodeldi/status/1963655669867057187,https://x.com/IndoPopBase/status/1963642458740592884,0
2025-09-04 17:26:07+00:00,93TokyoDope,"Setan gabisa bikin gw takut, gapunya duit lebih bikin ketar-ketir.",0,0,0,481,https://x.com/93TokyoDope/status/1963654822684758080,https://x.com/IndoPopBase/status/1963642458740592884,0
2025-09-04 22:41:51+00:00,wickedcop86,Suzzana van Osch as Suketi,0,0,0,98,https://x.com/wickedcop86/status/1963734280464654716,https://x.com/IndoPopBase/status/1963642458740592884,0
2025-09-04 16:39:11+00:00,seninxkamis,Horor mana jumat kliwon sama jadi wni?,0,0,0,106,https://x.com/seninxkamis/status/1963643010560004508,https://x.com/IndoPopBase/status/1963642458740592884,0
2025-09-04 17:36:16+00:00,Xynte420,Kok pas banget mau pulang ngopi muncul gini,0,0,0,38,https://x.com/Xynte420/status/1963657379343647177,https://x.com/IndoPopBase/status/1963642458740592884,0
2025-09-04 09:54:27+00:00,coffebit,Laptop yang baik cuma thinkpad seken refurbished ,56,124,0,55081,https://x.com/coffebit/status/1963541157025067451,https://x.com/IndoPopBase/status/1963534435040858446,180
2025-09-04 09:38:29+00:00,okezonenews,Breaking News! Kejagung Tetapkan Nadiem Makarim Tersangka Korupsi Laptop Chromebook,0,4,0,7991,https://x.com/okezonenews/status/1963537139360284734,https://x.com/IndoPopBase/status/1963534435040858446,4
2025-09-04 10:36:28+00:00,0xHarryry,"Geloo, tangkap tangkapp tangkapp",0,0,0,3869,https://x.com/0xHarryry/status/1963551732199559691,https://x.com/IndoPopBase/status/1963534435040858446,0
2025-09-04 09:49:40+00:00,Goboovi,Never thought he’d get caught up,0,0,0,2574,https://x.com/Goboovi/status/1963539953956049056,https://x.com/IndoPopBase/status/1963534435040858446,0
2025-09-04 09:50:00+00:00,blockxs,Nadiem's Chromebook mystery continues,0,0,0,6429,https://x.com/blockxs/status/1963540039201104171,https://x.com/IndoPopBase/status/1963534435040858446,0
2025-09-04 11:05:45+00:00,bilaldsaputra,"gila ini negara, wajib diusut tuntas dan transparan, makin banyak org bener yg takut utk mengabdi, impact beliau bikin gojek udh citpakan jutaan lapangan kerja, jauh dibanding yg janjiin 19 jt lap. keria

dan budi arie, yg bakal kelola ratusan triliun APBN, masih jd menteri.",2,2,0,9987,https://x.com/bilaldsaputra/status/1963559101327413441,https://x.com/IndoPopBase/status/1963534435040858446,4
2025-09-04 10:14:52+00:00,dnamadara,orang yang pusing mikirin negara yang apa apa di korupsi:,0,6,0,10341,https://x.com/dnamadara/status/1963546294355366266,https://x.com/IndoPopBase/status/1963534435040858446,6
2025-09-04 09:35:24+00:00,motherlander,Nadiem formed a WhatsApp group called “Mas Menteri Core Team” three months before he was inaugurated as minister in October 2019. The group was used to discuss plans for the procurement of educational digitalization programs at Kemendikbudristek,1,9,0,13780,https://x.com/motherlander/status/1963536363460124837,https://x.com/IndoPopBase/status/1963534435040858446,10
2025-09-04 09:36:33+00:00,recehtuitt,"padahal nadiem ini termasuk anak bangsa yng berprestasi, eh kok malah korupsi juga",3,1,0,12902,https://x.com/recehtuitt/status/1963536654066675975,https://x.com/IndoPopBase/status/1963534435040858446,4
2025-09-04 10:22:03+00:00,DynamicFPL,"hero to zero
ngapain juga sebenernya ya
ngurus maunya mulyono emang ribet.",0,2,0,5126,https://x.com/DynamicFPL/status/1963548102909944296,https://x.com/IndoPopBase/status/1963534435040858446,2
2025-09-04 10:31:40+00:00,albrtbstn,,0,0,0,85,https://x.com/albrtbstn/status/1963550522310361094,https://x.com/IndoPopBase/status/1963534435040858446,0
2025-09-04 14:44:05+00:00,thereasonofwhy0,,0,0,0,228,https://x.com/thereasonofwhy0/status/1963614046126837995,https://x.com/IndoPopBase/status/1963534435040858446,0
2025-09-04 09:51:24+00:00,sanihanii,that's what you get when you hyper-experimenting the hell out of everything you do,1,0,0,887,https://x.com/sanihanii/status/1963540389782343890,https://x.com/IndoPopBase/status/1963534435040858446,1
2025-09-04 13:05:18+00:00,CallMeeRif21,"Laptop rasa hp android kentang sekali  maaf pak , mark up mikir dong ama spek nya, mana mau pake potato pc apalagi chromebock gini ngelag parah ",0,0,0,2070,https://x.com/CallMeeRif21/status/1963589185660445107,https://x.com/IndoPopBase/status/1963534435040858446,0
2025-09-04 11:19:00+00:00,wamadone,Udh saatnya ganti nama blio jd nadiem makelar,0,0,0,240,https://x.com/wamadone/status/1963562434339168471,https://x.com/IndoPopBase/status/1963534435040858446,0
2025-09-04 09:38:47+00:00,fikrisatria_,"One of the main allegations is Nadiem's issuance of Minister of Education and Culture Regulation (Permendikbud) Number 5 of 2021, which is considered to ""lock"" laptop specifications to the Chrome OS operating system. This policy is considered to violate several presidential",1,0,0,1878,https://x.com/fikrisatria_/status/1963537217131065421,https://x.com/IndoPopBase/status/1963534435040858446,1
2025-09-04 09:36:56+00:00,Atrheides,Fork found in the kitchen,0,0,0,556,https://x.com/Atrheides/status/1963536748589531546,https://x.com/IndoPopBase/status/1963534435040858446,0
2025-09-04 16:36:50+00:00,Ziiifauzi,Apa apa dikorupsi dah :(,1,0,0,61,https://x.com/Ziiifauzi/status/1963642419637096641,https://x.com/IndoPopBase/status/1963534435040858446,1
2025-09-04 14:46:53+00:00,canaakm,udah bener ngurus gojek anjim,0,0,0,91,https://x.com/canaakm/status/1963614750312731137,https://x.com/IndoPopBase/status/1963534435040858446,0
2025-09-04 11:20:10+00:00,hannyeinbeeny,Mampus para penyepong doi moga pade cepet sadar & tobat dh lu ye,0,0,0,187,https://x.com/hannyeinbeeny/status/1963562729719173606,https://x.com/IndoPopBase/status/1963534435040858446,0
2025-09-04 11:06:05+00:00,BuihBernada,wooy nadim anjing,0,0,0,112,https://x.com/BuihBernada/status/1963559186135957614,https://x.com/IndoPopBase/status/1963534435040858446,0
2025-09-24 11:26:36+00:00,Bandz________,This one explain it with the guud argument,0,0,0,8,https://x.com/Bandz________/status/1970812107286548884,https://x.com/IndoPopBase/status/1963534435040858446,0
2025-09-04 12:16:32+00:00,BukanMakmumm,Sapa suruh mau jadi menterinya Mulyono,0,0,0,108,https://x.com/BukanMakmumm/status/1963576914209128476,https://x.com/IndoPopBase/status/1963534435040858446,0
2025-09-04 09:30:56+00:00,amkathu18,Taxpayers money ,0,0,0,3348,https://x.com/amkathu18/status/1963535237889298534,https://x.com/IndoPopBase/status/1963534435040858446,0
2025-09-04 09:48:48+00:00,mdkousik31,Will he be arrested?,0,0,0,3257,https://x.com/mdkousik31/status/1963539735244411134,https://x.com/IndoPopBase/status/1963534435040858446,0
2025-09-04 09:58:11+00:00,Itz_aj_krish,Corruption cases never seem to end.”,0,0,0,2866,https://x.com/Itz_aj_krish/status/1963542098994716773,https://x.com/IndoPopBase/status/1963534435040858446,0
2025-09-04 14:27:14+00:00,yoogiiss,nunggu dia berkicau sana sini kalo brani,0,0,0,1277,https://x.com/yoogiiss/status/1963609807258358085,https://x.com/IndoPopBase/status/1963534435040858446,0
2025-09-04 10:00:10+00:00,Seung_ha_,"@grok
 who education Minister Nadiem Makarim",1,0,0,2148,https://x.com/Seung_ha_/status/1963542598145946110,https://x.com/IndoPopBase/status/1963534435040858446,1
2025-09-04 09:45:36+00:00,Sagar_tarak18,great ,0,0,0,2367,https://x.com/Sagar_tarak18/status/1963538931905171578,https://x.com/IndoPopBase/status/1963534435040858446,0
2025-09-05 03:37:36+00:00,rampo____,Padahal mukannya kek orang alim,0,0,0,213,https://x.com/rampo____/status/1963808708284063823,https://x.com/IndoPopBase/status/1963534435040858446,0
2025-09-04 09:30:11+00:00,HarshaKnaidu14,I don't think so,0,0,0,2325,https://x.com/HarshaKnaidu14/status/1963535050345205951,https://x.com/IndoPopBase/status/1963534435040858446,0
2025-09-04 09:29:51+00:00,HarshaKnaidu14,How much he has corrupted??,0,0,0,1291,https://x.com/HarshaKnaidu14/status/1963534967050571977,https://x.com/IndoPopBase/status/1963534435040858446,0
2025-09-04 10:17:27+00:00,piecesofsyi,new crisis comm case study alert,0,0,0,227,https://x.com/piecesofsyi/status/1963546944803856478,https://x.com/IndoPopBase/status/1963534435040858446,0
2025-09-04 10:16:39+00:00,miayamtnpakuah,Mantab Brantas habis koruptor.. Next reza chalid,0,0,0,339,https://x.com/miayamtnpakuah/status/1963546743657857314,https://x.com/IndoPopBase/status/1963534435040858446,0
2025-09-04 13:12:42+00:00,SpidyMonky,@gurlliessssss33,0,0,0,63,https://x.com/SpidyMonky/status/1963591048283771372,https://x.com/IndoPopBase/status/1963534435040858446,0
2025-09-04 09:44:01+00:00,bawangmerah105,"Udah bener ngurus gojek malah milih jd mentri, jd koruptor kn sekarang",0,0,0,517,https://x.com/bawangmerah105/status/1963538532917768525,https://x.com/IndoPopBase/status/1963534435040858446,0
2025-09-04 13:24:36+00:00,Annissasaf,Next budi arie,0,0,0,124,https://x.com/Annissasaf/status/1963594044891881829,https://x.com/IndoPopBase/status/1963534435040858446,0
2025-09-04 09:44:18+00:00,Remus92627744,"Hukum mati lah uda, pendidikan masa depan negara mala disikat jg ",0,0,0,595,https://x.com/Remus92627744/status/1963538602413187493,https://x.com/IndoPopBase/status/1963534435040858446,0
2025-09-04 12:42:22+00:00,Mngewss,oh ini yg gantiin Anies ,0,0,0,71,https://x.com/Mngewss/status/1963583415661596946,https://x.com/IndoPopBase/status/1963534435040858446,0
2025-09-04 09:46:31+00:00,Irfan5yah_Putra,Menteri Perusak Kurikulum!!,0,0,0,362,https://x.com/Irfan5yah_Putra/status/1963539160876421383,https://x.com/IndoPopBase/status/1963534435040858446,0
2025-09-04 14:50:08+00:00,wantokicaumania,"@_screenshoter
 screenshoot this",1,0,0,229,https://x.com/wantokicaumania/status/1963615568113668487,https://x.com/IndoPopBase/status/1963534435040858446,1
2025-09-04 12:16:29+00:00,adraniiss,"Rp1.98T lost isn’t just a number, it’s proof the procurement system failed. Rp9.9T meant for digital learning ended up feeding corruption. This shouldn’t stop at one name, we need real transparency!",0,0,0,105,https://x.com/adraniiss/status/1963576900925763656,https://x.com/IndoPopBase/status/1963534435040858446,0
2025-09-04 09:48:16+00:00,rogue_mercenary,Pengalihan issuee.,0,0,0,276,https://x.com/rogue_mercenary/status/1963539601613533214,https://x.com/IndoPopBase/status/1963534435040858446,0
2025-09-04 13:32:06+00:00,notursyl,pak nadiem??,0,0,0,100,https://x.com/notursyl/status/1963595933079540068,https://x.com/IndoPopBase/status/1963534435040858446,0
2025-09-04 10:57:19+00:00,IhsanMuch,"Gile ye.. udah punya gojek padahal masih aje, manusie tempatnye kureng",0,0,0,235,https://x.com/IhsanMuch/status/1963556980141822349,https://x.com/IndoPopBase/status/1963534435040858446,0
2025-09-04 10:27:41+00:00,etttdan,ealah pak pak,0,0,0,123,https://x.com/etttdan/status/1963549521578725449,https://x.com/IndoPopBase/status/1963534435040858446,0
2025-09-05 03:33:21+00:00,cleverlazyboy,RASAINNN AZAB HAPUS SEJARAH PEMINATAN DAN SEJARAH WAJIB,0,0,0,36,https://x.com/cleverlazyboy/status/1963807638954676610,https://x.com/IndoPopBase/status/1963534435040858446,0
2025-09-04 11:36:06+00:00,shumaiconsumer,We have to arrest that factgot ,0,0,0,69,https://x.com/shumaiconsumer/status/1963566737208598798,https://x.com/IndoPopBase/status/1963534435040858446,0
2025-09-04 09:32:49+00:00,trustorontto,udah bener jadi ceo gojek,0,0,0,21,https://x.com/trustorontto/status/1963535712802017631,https://x.com/IndoPopBase/status/1963534435040858446,0
2025-09-05 01:59:50+00:00,furaitochickin,Will daddy save his ass?,0,0,0,10,https://x.com/furaitochickin/status/1963784105969291330,https://x.com/IndoPopBase/status/1963534435040858446,0
2025-09-04 09:45:51+00:00,dvsirenco,,0,0,0,0,https://x.com/dvsirenco/status/1963538995000087000,https://x.com/IndoPopBase/status/1963526147398144323,0
2025-09-04 11:09:59+00:00,arrdha_,"This. If only they had listened from the beginning, things would’ve been easier, trust restored, and most importantly, no casualties. the pain people carry today could’ve been avoided",0,7,0,3095,https://x.com/arrdha_/status/1963560165350711540,https://x.com/IndoPopBase/status/1963526147398144323,7
2025-09-04 11:07:19+00:00,recordmynote,"Yeah, imagine if they still had empathy.",0,0,0,2252,https://x.com/recordmynote/status/1963559494295691732,https://x.com/IndoPopBase/status/1963526147398144323,0
2025-09-04 12:17:09+00:00,luvviehoonie,if only..,0,0,0,876,https://x.com/luvviehoonie/status/1963577069100577126,https://x.com/IndoPopBase/status/1963526147398144323,0
2025-09-04 11:54:46+00:00,virgotiaaa,Considering not forcing,0,0,0,888,https://x.com/virgotiaaa/status/1963571437576266109,https://x.com/IndoPopBase/status/1963526147398144323,0
2025-09-04 07:13:11+00:00,Rumahdepok_,"Main character di tv nasional ,di negara luar jadi NPC ",11,177,0,111683,https://x.com/Rumahdepok_/status/1963500572230951174,https://x.com/IndoPopBase/status/1963499591694733673,188
2025-09-04 07:13:22+00:00,motherlander,Wait for it..,10,132,0,104638,https://x.com/motherlander/status/1963500619626668281,https://x.com/IndoPopBase/status/1963499591694733673,142
2025-09-04 08:07:51+00:00,0xHarryry,hahaha,5,24,0,71342,https://x.com/0xHarryry/status/1963514333096546801,https://x.com/IndoPopBase/status/1963499591694733673,29
2025-09-04 07:44:02+00:00,admiralkizaruuu,"semoga The Yomiuri Shimbun menyiapkan lawyer terbaik mereka untuk menghadapi pelaporan dari ormas-ormas kita.
Terkait pasal, sebentar ya lagi dipikirkan.
Yang penting lapor dulu aja.",12,65,0,98174,https://x.com/admiralkizaruuu/status/1963508338777612407,https://x.com/IndoPopBase/status/1963499591694733673,77
2025-09-04 07:43:29+00:00,AmalaNovi,"Ya mau berharap apa? Indonesia aja masih sangat jauh kalau mau disandingkan dengan mereka. 
Ibarat kata ini agensi nugu, minta disandingkan dengan big4",14,33,0,72995,https://x.com/AmalaNovi/status/1963508197144084506,https://x.com/IndoPopBase/status/1963499591694733673,47
2025-09-04 07:43:36+00:00,dnamadara,"coba kalo saat itu beliau gak kesana, gak bakalan ada berita kek begini, batu banget sih, temuin rakyatnya dulu, beresin permasalahan negara sendiri eh kesini fotonya malah di crop",5,24,0,52614,https://x.com/dnamadara/status/1963508230031904954,https://x.com/IndoPopBase/status/1963499591694733673,29
2025-09-04 11:08:34+00:00,FajriGrahaArtha,"it refers to this photo :  he was walking  in the middle of them, not at the front line",8,36,0,54105,https://x.com/FajriGrahaArtha/status/1963559809438912960,https://x.com/IndoPopBase/status/1963499591694733673,44
2025-09-04 07:53:01+00:00,dnamadara,"Surat kabar nasional Jepang The Yomiuri Shimbun  X/Twitter, sama sama ngecrop",5,28,0,56679,https://x.com/dnamadara/status/1963510596248219889,https://x.com/IndoPopBase/status/1963499591694733673,33
2025-09-04 07:25:57+00:00,lialoves_lia,In his wet dreams                                IRL,0,0,0,2941,https://x.com/lialoves_lia/status/1963503787613843573,https://x.com/IndoPopBase/status/1963499591694733673,0
2025-09-04 07:49:20+00:00,Sugilico3,ketika bro diasingkan lewat media,0,0,0,10217,https://x.com/Sugilico3/status/1963509670599168496,https://x.com/IndoPopBase/status/1963499591694733673,0
2025-09-04 07:50:25+00:00,sparklingbeatss,"Jadi gini negara kita itu non blok, sedangkan di media itu ada teks ""Pentingnya mengenang perang melawan Jepang sebagai bagian dari perang dunia melawan fasisme"" nah ada lagi yaitu ""pidato Xi mengandung pesan untuk menentang Amerika dalam konteks global"" 
Singkatnya begitu",4,2,0,3093,https://x.com/sparklingbeatss/status/1963509945279943103,https://x.com/IndoPopBase/status/1963499591694733673,6
2025-09-04 07:27:29+00:00,mypdpkl,"flopbowo kalo lo punya biji lo bisa sebut siapa negara asing yg ganggu indo, jgn cuma ""asing"" doang semua negara bisa tersinggung. Orang mah diplomasi yang baik yang ramah biar paspor kuat ini udah paspor lemah presidennya bilang rakyatnya sendiri teroris, asing dimusuhin, tolol!",0,0,0,2390,https://x.com/mypdpkl/status/1963504172789109220,https://x.com/IndoPopBase/status/1963499591694733673,0
2025-09-04 12:20:57+00:00,ninoononie_,wkwk.,1,2,0,13854,https://x.com/ninoononie_/status/1963578024466780454,https://x.com/IndoPopBase/status/1963499591694733673,3
2025-09-04 10:04:26+00:00,fauzany90,"The headline highlights the three leaders representing a non-Western bloc. If President Prabowo were to be included, it would not be fitting, as Indonesia has always maintained its identity as a Non-Aligned nation.

Gue gak belain wowo, tapi lu provokator. Nyebarin narasi sesat",1,0,0,905,https://x.com/fauzany90/status/1963543668855300540,https://x.com/IndoPopBase/status/1963499591694733673,1
2025-09-05 16:40:26+00:00,Krai_CryptoSage,waktunya keluarin meme ini ,0,0,0,1644,https://x.com/Krai_CryptoSage/status/1964005713807655026,https://x.com/IndoPopBase/status/1963499591694733673,0
2025-09-04 07:12:06+00:00,·,suka bgt sama jpn or korea klo ada orang yg problematik pasti langsung kayak di ilangin,2,0,0,2187,https://x.com/shutsline/status/1963500300641472852,https://x.com/IndoPopBase/status/1963499591694733673,2
2025-09-04 09:38:19+00:00,SaddamPradika,Tolong jangan cari yang tidak ada,0,0,0,11810,https://x.com/SaddamPradika/status/1963537099745104231,https://x.com/IndoPopBase/status/1963499591694733673,0
2025-09-04 07:23:43+00:00,lonerhelios,When you acted like the main character with your 58% payola votes but you were actually just a khia,0,0,0,483,https://x.com/lonerhelios/status/1963503225895882756,https://x.com/IndoPopBase/status/1963499591694733673,0
2025-09-04 11:45:35+00:00,sugarbarbieeeee,"lah kan bagus di crop, klo ga dcrop malah org2 luar beranggapan klo indonesia ikut blok timur,pdhl kan non blok, indonesia dsitu kapasitasnya hanya sebagai tamu undangan",1,0,0,696,https://x.com/sugarbarbieeeee/status/1963569125680439548,https://x.com/IndoPopBase/status/1963499591694733673,1
2025-09-04 07:15:45+00:00,·,"Jepang: tiap kasih statement selalu nyalahin asing, playing victim. Sorry kita crop dulu mukanya",0,0,0,1130,https://x.com/whiterosestea/status/1963501221131739313,https://x.com/IndoPopBase/status/1963499591694733673,0
2025-09-04 07:15:59+00:00,amkathu18,No one knows who he is,0,0,0,5157,https://x.com/amkathu18/status/1963501279969513977,https://x.com/IndoPopBase/status/1963499591694733673,0
2025-09-04 07:19:20+00:00,mekencheez,"non oomf udh liat blm 
@prabowo",0,0,0,1031,https://x.com/mekencheez/status/1963502122093384124,https://x.com/IndoPopBase/status/1963499591694733673,0
2025-09-04 07:16:17+00:00,tsaniyaama,,0,1,0,1630,https://x.com/tsaniyaama/status/1963501352933625970,https://x.com/IndoPopBase/status/1963499591694733673,1
2025-09-04 08:41:03+00:00,dodojogja2,If and Only if he was the member of The Avengers He will still remains,0,0,0,10308,https://x.com/dodojogja2/status/1963522685318640081,https://x.com/IndoPopBase/status/1963499591694733673,0
2025-09-04 07:11:44+00:00,Sagar_tarak18, ,0,0,0,7508,https://x.com/Sagar_tarak18/status/1963500210040307846,https://x.com/IndoPopBase/status/1963499591694733673,0
2025-09-04 07:11:11+00:00,uyuneee,"another day, another embrassment",0,0,0,378,https://x.com/uyuneee/status/1963500069120086452,https://x.com/IndoPopBase/status/1963499591694733673,0
2025-09-05 23:27:10+00:00,allaboutoflixie,"Hadeh. cari tau dulu isi berita apa!
Itu berita jepang yg isinya membahas tentang 3 negara itu adalah negara komunis yg confronting us. Bagusnya di crop karena Indonesia negara non blok, jadi gak akan menimbulkan hal hal yg di takutkan. Harusnya kita say thank you sama jepang",0,0,0,85,https://x.com/allaboutoflixie/status/1964108071988256969,https://x.com/IndoPopBase/status/1963499591694733673,0
2025-09-05 01:38:58+00:00,tDisney,See? You just nothing out there! You could be a president bcs of a bunch dumbass who’s choosen you!,0,0,0,1325,https://x.com/tDisney/status/1963778852045705312,https://x.com/IndoPopBase/status/1963499591694733673,0
2025-09-04 10:00:20+00:00,Suara_Lambung,"Ohhh. Media Jepang ternyata cc 
@anissabayu88
 @AdamVelcro
 ",2,1,0,59,https://x.com/Suara_Lambung/status/1963542639682224473,https://x.com/IndoPopBase/status/1963499591694733673,3
2025-09-05 07:08:43+00:00,bunnybanbinbun,Dicrop wkwk,0,0,0,99,https://x.com/bunnybanbinbun/status/1963861838258475309,https://x.com/IndoPopBase/status/1963499591694733673,0
2025-09-04 15:15:14+00:00,ganyuwgy,Kena ganjil-genap (ytta),0,0,0,126,https://x.com/ganyuwgy/status/1963621886820241451,https://x.com/IndoPopBase/status/1963499591694733673,0
2025-09-04 21:03:06+00:00,djrockysmith,"Kasian di indo banyak yg kena stockholm syndrome. Padahal jepang yg menjajah indonesia, china yg kena. Pada cepat lupa sejarah.",2,0,0,3141,https://x.com/djrockysmith/status/1963709430576615557,https://x.com/IndoPopBase/status/1963499591694733673,2
2025-09-04 07:12:07+00:00,Sagar_tarak18,"@grok
 whats matter?",1,0,0,22173,https://x.com/Sagar_tarak18/status/1963500304596701700,https://x.com/IndoPopBase/status/1963499591694733673,1
2025-09-04 09:27:43+00:00,vosverseau,Oh flopbowo,0,0,0,114,https://x.com/vosverseau/status/1963534430032793656,https://x.com/IndoPopBase/status/1963499591694733673,0
2025-09-04 11:21:50+00:00,staysaferek,Konteksnya: 3 pemimpin negara komunis yg ada di dunia min....,0,0,0,45,https://x.com/staysaferek/status/1963563146687246368,https://x.com/IndoPopBase/status/1963499591694733673,0
2025-09-04 08:09:12+00:00,·,Kacau jepang ngecrop presiden bangsa yg besar,3,0,0,1421,https://x.com/FafaHaris/status/1963514669009969388,https://x.com/IndoPopBase/status/1963499591694733673,3
2025-09-04 13:54:24+00:00,lemon_taa,Wkwkwkwk,0,0,0,44,https://x.com/lemon_taa/status/1963601542294245704,https://x.com/IndoPopBase/status/1963499591694733673,0
2025-09-04 07:23:45+00:00,pimux,carmuknya ga berhasil,0,0,0,186,https://x.com/pimux/status/1963503232418025713,https://x.com/IndoPopBase/status/1963499591694733673,0
2025-09-04 08:11:05+00:00,zobkin,"Ya mereka negara super power, Indonesia negara omon* no aksi,Jadi wajar aj di bedakan",2,0,0,859,https://x.com/zobkin/status/1963515146518794430,https://x.com/IndoPopBase/status/1963499591694733673,2
2025-09-04 07:15:03+00:00,cisamsoe,"takut ntar kalo si ndut balik ke negaranya, diungkit ungkit dalam tiap pidatonya wkwkwkkwk",0,0,0,514,https://x.com/cisamsoe/status/1963501041510724023,https://x.com/IndoPopBase/status/1963499591694733673,0
2025-09-04 08:46:20+00:00,mondemon,"Coba cari tahu dulu isi beritanya, aku rasa kita juga enggak mau di framing anti-barat, seandainya enggak di crop.",0,0,0,197,https://x.com/mondemon/status/1963524014569099620,https://x.com/IndoPopBase/status/1963499591694733673,0
2025-09-04 08:48:33+00:00,bimski,"Kassym-Jomart Tokayev, presiden Kazakhstan yg paling kanan jg dicrop. So, what's the problem? Did it touch your nerve?",0,0,0,31,https://x.com/bimski/status/1963524573485212122,https://x.com/IndoPopBase/status/1963499591694733673,0
2025-09-04 10:39:22+00:00,KakMugi,nggak penting soalnya,0,0,0,271,https://x.com/KakMugi/status/1963552462347866435,https://x.com/IndoPopBase/status/1963499591694733673,0
2025-09-04 10:23:37+00:00,xcalvfin,trump pasti tertawa melihat ini,0,0,0,159,https://x.com/xcalvfin/status/1963548497892037082,https://x.com/IndoPopBase/status/1963499591694733673,0
2025-09-04 07:37:22+00:00,nameless_str4y,as they should!,0,0,0,105,https://x.com/nameless_str4y/status/1963506659030176214,https://x.com/IndoPopBase/status/1963499591694733673,0
2025-09-04 07:56:57+00:00,BANANAKAKUMEl,him:,0,0,0,77,https://x.com/BANANAKAKUMEl/status/1963511587945213995,https://x.com/IndoPopBase/status/1963499591694733673,0
2025-09-04 10:15:33+00:00,G4C0AN,zero balls prohibited,0,0,0,32,https://x.com/G4C0AN/status/1963546468016386051,https://x.com/IndoPopBase/status/1963499591694733673,0
2025-09-04 12:35:11+00:00,HarryPattyRM00,"#GantiKapolri
#StopPoliceBrutality
#GantiKetuaWaketDPRRI
x.com/HarryPattyRM00
…",0,0,0,12,https://x.com/HarryPattyRM00/status/1963581606603767808,https://x.com/IndoPopBase/status/1963499591694733673,0
2025-09-04 08:52:29+00:00,OynRetriever,khiarabowo nugubianto,0,0,0,123,https://x.com/OynRetriever/status/1963525562040730038,https://x.com/IndoPopBase/status/1963499591694733673,0
2025-09-04 07:13:55+00:00,vintaydilfs,irrelevant,0,0,0,284,https://x.com/vintaydilfs/status/1963500757527007573,https://x.com/IndoPopBase/status/1963499591694733673,0
2025-09-04 07:14:16+00:00,boyhendryko,"kawal terus progressnya: 
bijakmemantau.id/tuntutan-178 

jangan lupa terus berisik di lingkup sosial",0,63,0,14449,https://x.com/boyhendryko/status/1963500845456392439,https://x.com/IndoPopBase/status/1963481988507340806,63
2025-09-04 06:40:34+00:00,del_paijo,DPR ini ternyata sistem kerjanya Borongan bkn Harian. Kalian tau kan gimana umumnya hasil kerja borongan?? aplg dri org2 yg gak kompeten..,1,17,0,15288,https://x.com/del_paijo/status/1963492365932302645,https://x.com/IndoPopBase/status/1963481988507340806,18
2025-09-04 06:05:17+00:00,dnamadara,besok.,0,2,0,16203,https://x.com/dnamadara/status/1963483486201024535,https://x.com/IndoPopBase/status/1963481988507340806,2
2025-09-04 07:53:27+00:00,admiralkizaruuu,Tombol like buat yang yakin gak bakal ada yg terealisasi.,0,0,0,5487,https://x.com/admiralkizaruuu/status/1963510708068356265,https://x.com/IndoPopBase/status/1963481988507340806,0
2025-09-04 06:02:41+00:00,KukoGemaz,Emangnya pembahasan selain RUU perampasan aset ada RUU apa aja,1,0,0,12388,https://x.com/KukoGemaz/status/1963482832552284545,https://x.com/IndoPopBase/status/1963481988507340806,1
2025-09-04 06:05:40+00:00,ld7fish,"OK idk what happened and where everyone was beyond what I see on sosmed/news, but considering the deadline tomorrow, kayak orang ngebut projek kelompok 
Semoga membuahkan hasil (positif thinking and manifesting) ",0,4,0,2788,https://x.com/ld7fish/status/1963483581331685543,https://x.com/IndoPopBase/status/1963481988507340806,4
2025-09-04 06:01:37+00:00,xxxaryadi,,0,1,0,9623,https://x.com/xxxaryadi/status/1963482561495396667,https://x.com/IndoPopBase/status/1963481988507340806,1
2025-09-04 06:23:44+00:00,·,AWASIN GUYSSS. Stop berantem di narasi2 ga penting dan ingatkan satu sama lain: DEADLINE TUNTUTAN 17+8 BESOK,0,1,0,1291,https://x.com/intothedepthsea/status/1963488128922001858,https://x.com/IndoPopBase/status/1963481988507340806,1
2025-09-04 06:06:25+00:00,robiinuchiha,Lama amat kemaren2 kemana aja DPR KONTOL,0,0,0,1230,https://x.com/robiinuchiha/status/1963483769530470910,https://x.com/IndoPopBase/status/1963481988507340806,0
2025-09-04 07:15:07+00:00,beautiaf,"besok tanggal merah, rapatnya baru hari ini. pada kemana aja dari kemarin?:(",0,0,0,7872,https://x.com/beautiaf/status/1963501062096372024,https://x.com/IndoPopBase/status/1963481988507340806,0
2025-09-04 06:24:09+00:00,Sagar_tarak18,bebaskan seluruh demonstran,0,0,0,4703,https://x.com/Sagar_tarak18/status/1963488235486941447,https://x.com/IndoPopBase/status/1963481988507340806,0
2025-09-04 06:10:03+00:00,mdkousik31,What kind of meeting is this after killing people?,0,0,0,3870,https://x.com/mdkousik31/status/1963484684182298906,https://x.com/IndoPopBase/status/1963481988507340806,0
2025-09-04 06:34:03+00:00,pawstibisa,"Kerja yg bener goblok 
@DPR_RI
 dikasih waktu seminggu malah mepet deadline",0,0,0,554,https://x.com/pawstibisa/status/1963490727163236646,https://x.com/IndoPopBase/status/1963481988507340806,0
2025-09-04 07:13:52+00:00,tsetchaiklatte,"di kantor gue—dan gue yakin di kantor banyak orang pun sama—kalo deadlinenya besok dan udah disuruh kerjain dari minggu kemarin, baru MULAI HARI INI sih udah ditegur atasan! ",0,0,0,310,https://x.com/tsetchaiklatte/status/1963500743794856171,https://x.com/IndoPopBase/status/1963481988507340806,0
2025-09-04 08:02:39+00:00,casyizhuo,"Deadline udh bsk njr, lu pda baru kerja??? udh dikasih wktu seminggu jg, klo malam ini gk kelar lgsg DO",0,0,0,138,https://x.com/casyizhuo/status/1963513020723691764,https://x.com/IndoPopBase/status/1963481988507340806,0
2025-09-04 07:23:22+00:00,miseenscent,lemot bgt,0,0,0,2088,https://x.com/miseenscent/status/1963503136691364270,https://x.com/IndoPopBase/status/1963481988507340806,0
2025-09-04 07:50:45+00:00,Sugilico3,Semoga hasil rapatnya menyenangkan hati Rakyat Indonesia,0,0,0,1769,https://x.com/Sugilico3/status/1963510028708786514,https://x.com/IndoPopBase/status/1963481988507340806,0
2025-09-04 06:38:40+00:00,recehtuitt,"ni kalau kesimpulannya masih gak sesuai, gaktau lagi lah",0,0,0,3910,https://x.com/recehtuitt/status/1963491887588716924,https://x.com/IndoPopBase/status/1963481988507340806,0
2025-09-04 06:34:30+00:00,Sagar_tarak18,bersihkan dan reformasi,0,0,0,2273,https://x.com/Sagar_tarak18/status/1963490840568815709,https://x.com/IndoPopBase/status/1963481988507340806,0
2025-09-04 06:14:54+00:00,glushinoe,Definisi baru ngerjain tugas pas mepet deadline,0,0,0,527,https://x.com/glushinoe/status/1963485906633199802,https://x.com/IndoPopBase/status/1963481988507340806,0
2025-09-04 06:55:19+00:00,susupiisangg,mepet deadlinee baru pada rapatt yaa,0,0,0,108,https://x.com/susupiisangg/status/1963496077379736022,https://x.com/IndoPopBase/status/1963481988507340806,0
2025-09-04 06:43:48+00:00,white_lyly,Jd gini kerjanya DPR? Besok deadline baru dikerjain skrg. Shame on you!!!!!,0,0,0,226,https://x.com/white_lyly/status/1963493179350831601,https://x.com/IndoPopBase/status/1963481988507340806,0
2025-09-04 06:31:10+00:00,lovelydrumm,Bismillah dpr kerja yg bener,0,0,0,172,https://x.com/lovelydrumm/status/1963490000252649587,https://x.com/IndoPopBase/status/1963481988507340806,0
2025-09-04 06:49:03+00:00,·,"D-1
semoga nanti hasilnya selaras dan memuaskan, jangan sampe besok baca pernyataan pernyataan  yang ga nyambung sama poin tutuntanya.",0,0,0,212,https://x.com/imtheread/status/1963494498354299102,https://x.com/IndoPopBase/status/1963481988507340806,0
2025-09-04 07:27:42+00:00,najae130,"Wkwk pantes klo bikin uu ga pernah bener, orang sistem kebut semalam kek gini anjir",0,0,0,104,https://x.com/najae130/status/1963504225062969597,https://x.com/IndoPopBase/status/1963481988507340806,0
2025-09-04 08:18:45+00:00,myadorablejaem,"dari kapan hari baru mau rapat sekarang, suka banget mepet mepet, padahal bukan mahasiswa atau anak sekolahan lagi hdeh",0,0,0,107,https://x.com/myadorablejaem/status/1963517072006320529,https://x.com/IndoPopBase/status/1963481988507340806,0
2025-09-04 07:09:27+00:00,bluaesya,bener kmrn ada yg komen mepet deadline baru ditanggepin sm mereka‍,0,0,0,93,https://x.com/bluaesya/status/1963499635018027417,https://x.com/IndoPopBase/status/1963481988507340806,0
2025-09-04 06:04:32+00:00,anchocolava,lama amat baru meeting,0,0,0,696,https://x.com/anchocolava/status/1963483299168350323,https://x.com/IndoPopBase/status/1963481988507340806,0
2025-09-04 12:39:34+00:00,zidan_saputra16,"kan kabar buruk merusak September Ceria, filter berita dan fokus pada hal-hal baik aja",0,0,0,2,https://x.com/zidan_saputra16/status/1963582712133923223,https://x.com/IndoPopBase/status/1963481988507340806,0
2025-09-04 07:44:23+00:00,rzzzawr,kmana aja kmaren wfh anjr,0,0,0,45,https://x.com/rzzzawr/status/1963508425272496128,https://x.com/IndoPopBase/status/1963481988507340806,0
2025-09-04 07:24:54+00:00,haeffsunp,dari kemaren kek kosyak,0,0,0,33,https://x.com/haeffsunp/status/1963503523544371554,https://x.com/IndoPopBase/status/1963481988507340806,0
2025-09-04 06:19:35+00:00,moonlofers,better late than never,0,0,0,315,https://x.com/moonlofers/status/1963487083814949308,https://x.com/IndoPopBase/status/1963481988507340806,0
2025-09-04 07:25:05+00:00,raskineyescream,Gpp halu. Yg penting masih berharap ,0,0,0,179,https://x.com/raskineyescream/status/1963503567719014826,https://x.com/IndoPopBase/status/1963481988507340806,0
2025-09-04 06:45:33+00:00,nsnggrn,SKS banget yee,0,0,0,80,https://x.com/nsnggrn/status/1963493620750925913,https://x.com/IndoPopBase/status/1963481988507340806,0
2025-09-04 08:32:14+00:00,safirrstone,BuSeh males banget ni orang ngerjainnya kalo mepet deadline,0,0,0,52,https://x.com/safirrstone/status/1963520465601020208,https://x.com/IndoPopBase/status/1963481988507340806,0
2025-09-04 15:17:49+00:00,airasd4875321,@RezmaniaDalila,0,0,0,6,https://x.com/airasd4875321/status/1963622535133626517,https://x.com/IndoPopBase/status/1963481988507340806,0
2025-09-04 07:10:18+00:00,AmalaNovi,Sistem kerjanya sks ya..,0,0,0,3013,https://x.com/AmalaNovi/status/1963499848545833136,https://x.com/IndoPopBase/status/1963481988507340806,0
2025-09-04 16:22:41+00:00,an4kgembal4,pantes rame,0,0,0,17,https://x.com/an4kgembal4/status/1963638860425879779,https://x.com/IndoPopBase/status/1963481988507340806,0
2025-09-04 08:22:26+00:00,Itz_aj_krish,Pressure is definitely on DPR,0,0,0,992,https://x.com/Itz_aj_krish/status/1963518000729882746,https://x.com/IndoPopBase/status/1963481988507340806,0
2025-09-04 07:52:19+00:00,FlosRegis,SKS banget ya anjing.,0,0,0,55,https://x.com/FlosRegis/status/1963510423157899354,https://x.com/IndoPopBase/status/1963481988507340806,0
2025-09-04 16:22:40+00:00,Sugilico3,hasilnya gimana tuh hari ini?,0,0,0,345,https://x.com/Sugilico3/status/1963638857234104431,https://x.com/IndoPopBase/status/1963481988507340806,0
2025-09-04 08:14:38+00:00,asteIlar,h-1 si anj,0,0,0,10,https://x.com/asteIlar/status/1963516038458610064,https://x.com/IndoPopBase/status/1963481988507340806,0
2025-09-04 07:04:00+00:00,deepublishstore,tapi benerann kann? not staged kann? heuheuheu {berasa trust issue kayak di hubungan toksik},0,0,0,1262,https://x.com/deepublishstore/status/1963498263790964770,https://x.com/IndoPopBase/status/1963481988507340806,0
2025-09-04 06:33:09+00:00,dengansiapadmna,Lama ya pergerakan nya,0,0,0,112,https://x.com/dengansiapadmna/status/1963490496942137627,https://x.com/IndoPopBase/status/1963481988507340806,0
2025-09-04 07:55:05+00:00,DarkStorm_East,"Fenomena komisi di DPR yang anggotanya tidak sesuai latar belakang jurusan sering terjadi dan bukan hal yang baru, karena penempatan anggota ke dalam komisi di DPR tidak berdasarkan jurusan pendidikan, melainkan berdasarkan kebutuhan fraksi, pengalaman kerja, dan kemampuan.",1,0,0,211,https://x.com/DarkStorm_East/status/1963511116304109598,https://x.com/IndoPopBase/status/1963481988507340806,1
2025-09-04 12:58:12+00:00,pischode,"@DPR_RI
 apakah live dan tranparan para wakil rakyat yang mulia dan terhormat ?",0,0,0,4,https://x.com/pischode/status/1963587399424118954,https://x.com/IndoPopBase/status/1963481988507340806,0
2025-09-04 06:06:41+00:00,Rembotokdlng,SKS anying,0,0,0,414,https://x.com/Rembotokdlng/status/1963483837545205903,https://x.com/IndoPopBase/status/1963481988507340806,0
2025-09-04 06:41:28+00:00,hae_nova,"Mepet amat rapat nya, kan bsk udh deadline",0,0,0,100,https://x.com/hae_nova/status/1963492592035008945,https://x.com/IndoPopBase/status/1963481988507340806,0
2025-09-04 07:35:20+00:00,·,ah masa sih,0,0,0,19,https://x.com/taespuding/status/1963506147694174292,https://x.com/IndoPopBase/status/1963481988507340806,0
2025-09-04 06:18:08+00:00,uricancer,Deadline besok yah ,0,0,0,183,https://x.com/uricancer/status/1963486718247747977,https://x.com/IndoPopBase/status/1963481988507340806,0
2025-09-04 12:31:55+00:00,cassieeurp,,0,0,0,610,https://x.com/cassieeurp/status/1963580783827763533,https://x.com/IndoPopBase/status/1963449515358425327,0
2025-09-04 04:33:01+00:00,temanamaste,is it gonna be gay or not?,0,0,0,995,https://x.com/temanamaste/status/1963460266135331238,https://x.com/IndoPopBase/status/1963449515358425327,0
2025-09-04 15:07:51+00:00,japra97,Maksudnya ini pernikahannya anti nyamuk kah?,0,0,0,329,https://x.com/japra97/status/1963620028609433728,https://x.com/IndoPopBase/status/1963449515358425327,0
2025-09-04 04:08:26+00:00,poetsofparis,"ok mother 
@pradabratz",1,0,0,1208,https://x.com/poetsofparis/status/1963454081017807193,https://x.com/IndoPopBase/status/1963449515358425327,1
2025-09-04 04:35:09+00:00,Sagar_tarak18,,0,0,0,1630,https://x.com/Sagar_tarak18/status/1963460802398359568,https://x.com/IndoPopBase/status/1963449515358425327,0
2025-09-04 04:08:15+00:00,rineeth_PRK,Okay ,0,0,0,1824,https://x.com/rineeth_PRK/status/1963454034808910200,https://x.com/IndoPopBase/status/1963449515358425327,0
2025-09-04 03:57:55+00:00,HarshaKnaidu14,,0,0,0,1118,https://x.com/HarshaKnaidu14/status/1963451431362445569,https://x.com/IndoPopBase/status/1963449515358425327,0
2025-09-04 08:10:29+00:00,EabalSoad40724,"x.com/EabalSoad40724
…",0,0,0,67,https://x.com/EabalSoad40724/status/1963514994034680210,https://x.com/IndoPopBase/status/1963449515358425327,0
2025-09-04 16:19:21+00:00,bluereadau,"@sangkunyuq
 bro…..",1,0,0,211,https://x.com/bluereadau/status/1963638020860776949,https://x.com/IndoPopBase/status/1963449515358425327,1
2025-09-04 09:43:47+00:00,ferizast,I'm sat,0,0,0,387,https://x.com/ferizast/status/1963538473425809468,https://x.com/IndoPopBase/status/1963449515358425327,0
2025-09-04 04:22:53+00:00,_XIVKN,MEOWWWWWWWW ,0,0,0,518,https://x.com/_XIVKN/status/1963457714459394269,https://x.com/IndoPopBase/status/1963449515358425327,0
2025-09-04 16:23:22+00:00,gakgitudongpal,02 voter  acting bagus tapi omke gass ,1,0,0,266,https://x.com/gakgitudongpal/status/1963639030127419442,https://x.com/IndoPopBase/status/1963449515358425327,1
2025-09-04 03:55:07+00:00,hahakhal,maam,0,0,0,780,https://x.com/hahakhal/status/1963450728439320859,https://x.com/IndoPopBase/status/1963449515358425327,0
2025-09-04 03:54:02+00:00,hemanthkohli149,,0,0,0,1795,https://x.com/hemanthkohli149/status/1963450457419846057,https://x.com/IndoPopBase/status/1963449515358425327,0
2025-09-04 04:20:17+00:00,mmjussX,Oh the title? Seatedd,0,0,0,514,https://x.com/mmjussX/status/1963457060139307162,https://x.com/IndoPopBase/status/1963449515358425327,0
2025-09-04 04:27:28+00:00,wobowobow,"Baru kmrn nonton konten bang 
@gilbhas
 ttg lavender ini, udah ada filmnya ternyata",1,0,0,1380,https://x.com/wobowobow/status/1963458869184573527,https://x.com/IndoPopBase/status/1963449515358425327,1
2025-09-04 03:52:14+00:00,wasbrat,MOTHER,0,0,0,1001,https://x.com/wasbrat/status/1963450002065559642,https://x.com/IndoPopBase/status/1963449515358425327,0
2025-09-04 04:34:22+00:00,containsclouds,Interesting,0,0,0,558,https://x.com/containsclouds/status/1963460607866265786,https://x.com/IndoPopBase/status/1963449515358425327,0
2025-09-04 15:52:25+00:00,xsnose_,we will be watching,0,0,0,197,https://x.com/xsnose_/status/1963631243205255657,https://x.com/IndoPopBase/status/1963449515358425327,0
2025-09-04 03:59:25+00:00,repxkomh13,Mother is coming for that piala citra,0,0,0,1016,https://x.com/repxkomh13/status/1963451809449615787,https://x.com/IndoPopBase/status/1963449515358425327,0
2025-09-04 13:15:57+00:00,yapuntileepy,ah wanita ini lagi,0,0,0,267,https://x.com/yapuntileepy/status/1963591866361786476,https://x.com/IndoPopBase/status/1963449515358425327,0
2025-09-04 04:44:57+00:00,holidayhousse,ouuuu?,0,0,0,501,https://x.com/holidayhousse/status/1963463267923497321,https://x.com/IndoPopBase/status/1963449515358425327,0
2025-09-04 05:14:59+00:00,airdrop_goe,Yeah,0,0,0,1725,https://x.com/airdrop_goe/status/1963470828315492558,https://x.com/IndoPopBase/status/1963449515358425327,0
2025-09-04 04:00:31+00:00,theironcodee,Stunning,0,0,0,487,https://x.com/theironcodee/status/1963452087708049777,https://x.com/IndoPopBase/status/1963449515358425327,0
2025-09-04 04:46:20+00:00,izagonzalesna,no news?,1,0,0,310,https://x.com/izagonzalesna/status/1963463615828169043,https://x.com/IndoPopBase/status/1963449515358425327,1
2025-09-04 03:37:32+00:00,IndoPopBase,Happy 25th birthday to the talented Christy of no na.,89,665,0,0,https://x.com/IndoPopBase/status/1963446302114812118/history,https://x.com/IndoPopBase/status/1963446302114812118,754
2025-09-04 04:24:38+00:00,0xHarryry,Gorgeous christy,0,0,0,1891,https://x.com/0xHarryry/status/1963458155750531160,https://x.com/IndoPopBase/status/1963446302114812118,0
2025-09-04 07:45:44+00:00,christygardena,Semuanya ucapin terus tepuk tangan kenceng kenceng ya terima kasih,0,0,0,2270,https://x.com/christygardena/status/1963508764184555922,https://x.com/IndoPopBase/status/1963446302114812118,0
2025-09-04 04:54:24+00:00,·,we love you no na christy ,0,0,0,1384,https://x.com/nonawvs/status/1963465647939359228,https://x.com/IndoPopBase/status/1963446302114812118,0
2025-09-04 04:37:15+00:00,·,Happy birthday mamah,0,0,0,632,https://x.com/nonawaave/status/1963461330209538169,https://x.com/IndoPopBase/status/1963446302114812118,0
2025-09-05 01:15:32+00:00,ZeroPnumbra,Semoga bisa kalahin Lisa black pink,0,0,0,145,https://x.com/ZeroPnumbra/status/1963772954329940415,https://x.com/IndoPopBase/status/1963446302114812118,0
2025-09-04 04:08:50+00:00,rineeth_PRK,Happy Birthday ,0,0,0,1896,https://x.com/rineeth_PRK/status/1963454179499753485,https://x.com/IndoPopBase/status/1963446302114812118,0
2025-09-04 03:44:10+00:00,nonasivv,We love you mother,0,0,0,806,https://x.com/nonasivv/status/1963447974216044723,https://x.com/IndoPopBase/status/1963446302114812118,0
2025-09-04 04:11:16+00:00,cxgdn_,,0,0,0,405,https://x.com/cxgdn_/status/1963454791834898892,https://x.com/IndoPopBase/status/1963446302114812118,0
2025-09-05 13:25:39+00:00,sadbuuryy,BIRTHDAY GODDESS,0,0,0,37,https://x.com/sadbuuryy/status/1963956694133731528,https://x.com/IndoPopBase/status/1963446302114812118,0
2025-09-04 03:38:06+00:00,TFI_BUZZZ,she is great ,0,0,0,106,https://x.com/TFI_BUZZZ/status/1963446447799767200,https://x.com/IndoPopBase/status/1963446302114812118,0
2025-09-04 06:25:57+00:00,bareda,She went from 24 to 25 yo in one hour.,0,0,0,187,https://x.com/bareda/status/1963488686953164880,https://x.com/IndoPopBase/status/1963446302114812118,0
2025-09-04 09:48:34+00:00,peaudepaw,"happy birthday, mommy",0,0,0,1208,https://x.com/peaudepaw/status/1963539678881267828,https://x.com/IndoPopBase/status/1963446302114812118,0
2025-09-04 04:34:42+00:00,Sagar_tarak18,,0,0,0,1526,https://x.com/Sagar_tarak18/status/1963460691609964698,https://x.com/IndoPopBase/status/1963446302114812118,0
2025-09-05 06:03:08+00:00,nonationradio,Happy Birthday Christy,0,0,0,50,https://x.com/nonationradio/status/1963845333252804720,https://x.com/IndoPopBase/status/1963446302114812118,0
2025-09-04 06:44:11+00:00,themescor,Happy birthday barbie,0,0,0,47,https://x.com/themescor/status/1963493275043496115,https://x.com/IndoPopBase/status/1963446302114812118,0
2025-09-04 03:40:06+00:00,dpryto,Tan skin Jennie,0,0,0,666,https://x.com/dpryto/status/1963446949996368104,https://x.com/IndoPopBase/status/1963446302114812118,0
2025-09-04 11:34:01+00:00,a_mulfand,Happy birthday Queen,0,0,0,178,https://x.com/a_mulfand/status/1963566214153638104,https://x.com/IndoPopBase/status/1963446302114812118,0
2025-09-04 08:22:39+00:00,terbejrot,hbd mamacita,0,0,0,211,https://x.com/terbejrot/status/1963518055054807119,https://x.com/IndoPopBase/status/1963446302114812118,0
2025-09-04 12:15:10+00:00,fromywindow__,happy birthday sayang,0,0,0,109,https://x.com/fromywindow__/status/1963576572197380353,https://x.com/IndoPopBase/status/1963446302114812118,0
2025-09-04 09:43:59+00:00,ferizast,no na mana comebacknya,0,0,0,201,https://x.com/ferizast/status/1963538524126548181,https://x.com/IndoPopBase/status/1963446302114812118,0
2025-09-04 08:10:42+00:00,zhasc,my,0,0,0,128,https://x.com/zhasc/status/1963515047600349256,https://x.com/IndoPopBase/status/1963446302114812118,0
2025-09-04 13:45:03+00:00,baber168,"happy birthday Christy, wish you all the best ",0,0,0,187,https://x.com/baber168/status/1963599190589935831,https://x.com/IndoPopBase/status/1963446302114812118,0
2025-09-04 06:41:17+00:00,bayimeerkats,happeeee birthday mamaaaaa,0,0,0,339,https://x.com/bayimeerkats/status/1963492546568700373,https://x.com/IndoPopBase/status/1963446302114812118,0
2025-09-04 09:55:36+00:00,datuyulianto,Happy birthday nona Christy,0,0,0,354,https://x.com/datuyulianto/status/1963541446037836183,https://x.com/IndoPopBase/status/1963446302114812118,0
2025-09-04 18:21:43+00:00,JordyCorvus,My bias ,0,0,0,40,https://x.com/JordyCorvus/status/1963668817286197729,https://x.com/IndoPopBase/status/1963446302114812118,0
2025-09-04 06:34:27+00:00,hlfcomposmentis,"Bojomu ultah 
@sicmondays",1,0,0,525,https://x.com/hlfcomposmentis/status/1963490825708441855,https://x.com/IndoPopBase/status/1963446302114812118,1
2025-09-04 09:55:29+00:00,wongrravai,hbd mamah,0,0,0,132,https://x.com/wongrravai/status/1963541416715354152,https://x.com/IndoPopBase/status/1963446302114812118,0
2025-09-04 08:21:42+00:00,MARTINIBLUW,happy birthday wifey <3,0,0,0,212,https://x.com/MARTINIBLUW/status/1963517817028071485,https://x.com/IndoPopBase/status/1963446302114812118,0
2025-09-04 12:38:13+00:00,sipaling_kull,Happy birthday neng,0,0,0,117,https://x.com/sipaling_kull/status/1963582372147855830,https://x.com/IndoPopBase/status/1963446302114812118,0
2025-09-04 03:39:53+00:00,·,happy birthday mother,0,0,0,594,https://x.com/loves__gyu/status/1963446894480507204,https://x.com/IndoPopBase/status/1963446302114812118,0
2025-09-04 06:20:11+00:00,badluvkind,hbd queen,0,0,0,208,https://x.com/badluvkind/status/1963487234675675163,https://x.com/IndoPopBase/status/1963446302114812118,0
2025-09-04 06:29:28+00:00,reincouverr,my virgo gang,0,0,0,355,https://x.com/reincouverr/status/1963489570655289795,https://x.com/IndoPopBase/status/1963446302114812118,0
2025-09-04 05:57:56+00:00,moonchiidrrn,HAPPY BIRTHDAYY MOMMYYY,0,0,0,327,https://x.com/moonchiidrrn/status/1963481638123217100,https://x.com/IndoPopBase/status/1963446302114812118,0
2025-09-04 03:47:01+00:00,tempatkucrt,,0,0,0,370,https://x.com/tempatkucrt/status/1963448692029239546,https://x.com/IndoPopBase/status/1963446302114812118,0
2025-09-04 05:05:11+00:00,yoona_lim007,Barakallah fi umrik,0,0,0,362,https://x.com/yoona_lim007/status/1963468360492179709,https://x.com/IndoPopBase/status/1963446302114812118,0
2025-09-04 05:51:19+00:00,kazirinkiz,Sana versi lokal,0,0,0,356,https://x.com/kazirinkiz/status/1963479969436254597,https://x.com/IndoPopBase/status/1963446302114812118,0
2025-09-04 04:46:52+00:00,switieess,"Happy Birthday, Christy ",0,0,0,127,https://x.com/switieess/status/1963463752990560511,https://x.com/IndoPopBase/status/1963446302114812118,0
2025-09-04 13:09:16+00:00,myeunoiaaisland,Happy Birthday Christy,0,0,0,120,https://x.com/myeunoiaaisland/status/1963590186001977639,https://x.com/IndoPopBase/status/1963446302114812118,0
2025-09-04 10:15:59+00:00,BAKEM0N0E,"Happy birthday, Kak Christy. ",0,0,0,125,https://x.com/BAKEM0N0E/status/1963546578141983112,https://x.com/IndoPopBase/status/1963446302114812118,0
2025-09-04 08:38:09+00:00,KAMONEGlX,and nothing for christy of jkt48,0,0,0,336,https://x.com/KAMONEGlX/status/1963521955732361409,https://x.com/IndoPopBase/status/1963446302114812118,0
2025-09-05 03:02:42+00:00,iwalysmh,Omg virgo twins ku,0,0,0,77,https://x.com/iwalysmh/status/1963799924098879887,https://x.com/IndoPopBase/status/1963446302114812118,0
2025-09-04 03:39:55+00:00,theironcodee,Happy birthday christy,0,0,0,329,https://x.com/theironcodee/status/1963446905016594745,https://x.com/IndoPopBase/status/1963446302114812118,0
2025-09-04 05:19:42+00:00,Xynte420,Happy birthday christy,0,0,0,1247,https://x.com/Xynte420/status/1963472016402448680,https://x.com/IndoPopBase/status/1963446302114812118,0
2025-09-04 06:09:23+00:00,jackthegon,Hbd mbak,0,0,0,97,https://x.com/jackthegon/status/1963484518033363132,https://x.com/IndoPopBase/status/1963446302114812118,0
2025-09-04 03:38:16+00:00,AmberSaira95910,Omg,0,0,0,32,https://x.com/AmberSaira95910/status/1963446486647337103,https://x.com/IndoPopBase/status/1963446302114812118,0
2025-09-04 03:40:30+00:00,theironcodee,,0,0,0,270,https://x.com/theironcodee/status/1963447050080850317,https://x.com/IndoPopBase/status/1963446302114812118,0
2025-09-04 02:47:19+00:00,0xgasm,did they even hear us,2,68,0,30172,https://x.com/0xgasm/status/1963433668132966619,https://x.com/IndoPopBase/status/1963431901479534728,70
2025-09-04 02:49:36+00:00,hadilocoboy,Apa yamg terjadi jika diabaikan oleh pemerintah?,7,4,0,38632,https://x.com/hadilocoboy/status/1963434239774658561,https://x.com/IndoPopBase/status/1963431901479534728,11
2025-09-04 02:52:17+00:00,xxxaryadi,THE HISTORY,1,13,0,46656,https://x.com/xxxaryadi/status/1963434915674075593,https://x.com/IndoPopBase/status/1963431901479534728,14
2025-09-04 03:04:51+00:00,0xHarryry,Apakah akan diselesaikan?? hmmmm,0,0,0,18479,https://x.com/0xHarryry/status/1963438079924113566,https://x.com/IndoPopBase/status/1963431901479534728,0
2025-09-04 02:41:54+00:00,Rumahdepok_,Semoga kamu hai Indonesia bahagia dan terpelihara dari seluruh bahaya dan malapetaka dunia ,1,4,0,25357,https://x.com/Rumahdepok_/status/1963432302287229151,https://x.com/IndoPopBase/status/1963431901479534728,5
2025-09-04 04:19:44+00:00,melobigwavie,"ayooo buruan cek progressnya disini gais
bijakmemantau.id/tuntutan-178",0,11,0,4822,https://x.com/melobigwavie/status/1963456921551372395,https://x.com/IndoPopBase/status/1963431901479534728,11
2025-09-04 02:56:45+00:00,8ITEEZ,"beneran tanya, ini kalo udah melewati dateline kita harus apa ges? wht is our next movements? (bertanya dengan nada sopan)",1,0,0,5765,https://x.com/8ITEEZ/status/1963436041324450165,https://x.com/IndoPopBase/status/1963431901479534728,1
2025-09-04 02:53:30+00:00,·,"KERJA WOY DPR, bos nungguin nih udah mau nyentuh deadline juga, lembur sekalian kalau perlu masa bos nya mulu yang lembur pagi siang malem buat ngasih makan elu",0,0,0,3128,https://x.com/nonawaave/status/1963435220402667959,https://x.com/IndoPopBase/status/1963431901479534728,0
2025-09-04 03:10:47+00:00,ndroe_,dalam 1 tahun ke depan,1,0,0,3208,https://x.com/ndroe_/status/1963439571846533387,https://x.com/IndoPopBase/status/1963431901479534728,1
2025-09-04 04:01:33+00:00,·,g peduli mending ke cina wleee,1,0,0,2743,https://x.com/jujutjutkasien/status/1963452347029356575,https://x.com/IndoPopBase/status/1963431901479534728,1
2025-09-04 03:29:18+00:00,bawangmerah105,Mr. President lg nonton karnaval gaessss jgn diganggu,0,0,0,935,https://x.com/bawangmerah105/status/1963444230040568209,https://x.com/IndoPopBase/status/1963431901479534728,0
2025-09-04 03:27:50+00:00,joongiyah,ga digubris anj,0,0,0,509,https://x.com/joongiyah/status/1963443861382111688,https://x.com/IndoPopBase/status/1963431901479534728,0
2025-09-04 08:24:20+00:00,luxblushaurora,do they even care?,0,0,0,313,https://x.com/luxblushaurora/status/1963518478994006154,https://x.com/IndoPopBase/status/1963431901479534728,0
2025-09-04 05:06:03+00:00,ednikma,Mana mau penuhi tuntutan boomers2 itu. Gengsi bagi mereka. Selama ini mereka merasa diri raja,0,0,0,787,https://x.com/ednikma/status/1963468578877051179,https://x.com/IndoPopBase/status/1963431901479534728,0
2025-09-04 02:41:20+00:00,ripkikripik,How many has been achieved?,3,0,0,5628,https://x.com/ripkikripik/status/1963432162369437863,https://x.com/IndoPopBase/status/1963431901479534728,3
2025-09-04 03:12:20+00:00,raudhinna,bnr2 gk digubris,0,0,0,588,https://x.com/raudhinna/status/1963439959903273184,https://x.com/IndoPopBase/status/1963431901479534728,0
2025-09-04 16:16:04+00:00,lomlyzalia,takutnya malah ga di denger,0,0,0,0,https://x.com/lomlyzalia/status/1963637196260610476,https://x.com/IndoPopBase/status/1963431901479534728,0
2025-09-05 01:27:21+00:00,ramadhan0625,Wow,0,0,0,3,https://x.com/ramadhan0625/status/1963775930436145316,https://x.com/IndoPopBase/status/1963431901479534728,0
2025-09-04 03:36:12+00:00,BloodySpy1,Since when they listen to us???,0,0,0,32,https://x.com/BloodySpy1/status/1963445969200320826,https://x.com/IndoPopBase/status/1963431901479534728,0
2025-09-04 17:56:19+00:00,purplel0vee,"@prabowo
 @gibran_tweet
 @DPR_RI
 @puanmaharani_ri
 @Gerindra
 @PDemokrat
 @NasDem
 @PDI_Perjuangan
 jangan kayak tai",0,0,0,27,https://x.com/purplel0vee/status/1963662424764260799,https://x.com/IndoPopBase/status/1963431901479534728,0
2025-09-04 03:46:07+00:00,hwanippeo,"Kerjain deadline woi 
@DPR_RI
 @prabowo",0,0,0,325,https://x.com/hwanippeo/status/1963448461766107580,https://x.com/IndoPopBase/status/1963431901479534728,0
2025-09-04 09:05:03+00:00,dodowiru,+ Basmi anggota Dewan Calo Proyek,0,0,0,8375,https://x.com/dodowiru/status/1963528724844081222,https://x.com/IndoPopBase/status/1963431901479534728,0
2025-09-04 02:40:58+00:00,TFI_BUZZZ,what is that??,1,0,0,8030,https://x.com/TFI_BUZZZ/status/1963432066080805356,https://x.com/IndoPopBase/status/1963431901479534728,1
2025-09-04 02:43:30+00:00,bareda,None of those are met.,0,0,0,719,https://x.com/bareda/status/1963432704818778469,https://x.com/IndoPopBase/status/1963431901479534728,0
2025-09-04 07:07:34+00:00,AmalaNovi,"@grok
 dari tuntutan tersebut apa sudah ada yang di lakukan pemerintah",1,0,0,17765,https://x.com/AmalaNovi/status/1963499159454892230,https://x.com/IndoPopBase/status/1963431901479534728,1
2025-09-05 07:44:28+00:00,OxBrodi_,Semoga kali ini suara kita di dengar ya,0,0,0,684,https://x.com/OxBrodi_/status/1963870834956874054,https://x.com/IndoPopBase/status/1963431901479534728,0
2025-09-04 07:51:20+00:00,Sugilico3,Semoga pada sidang hari ini diberikan pencerahan,0,0,0,7227,https://x.com/Sugilico3/status/1963510172447301670,https://x.com/IndoPopBase/status/1963431901479534728,0
2025-09-04 02:55:23+00:00,rineeth_PRK,What was the final verdict?,0,0,0,14215,https://x.com/rineeth_PRK/status/1963435694879088691,https://x.com/IndoPopBase/status/1963431901479534728,0
2025-09-04 16:54:51+00:00,erdalarg,we'll see tomorrow whether they're gonna hear abt our tuntutan or not,0,0,0,139,https://x.com/erdalarg/status/1963646953197310458,https://x.com/IndoPopBase/status/1963431901479534728,0
2025-09-04 04:35:38+00:00,Sagar_tarak18,what happens at last ?,0,0,0,6295,https://x.com/Sagar_tarak18/status/1963460924419052023,https://x.com/IndoPopBase/status/1963431901479534728,0
2025-09-04 07:47:20+00:00,Seung_ha_,"@grok
 what is the 17 People's Demands?",1,0,0,14972,https://x.com/Seung_ha_/status/1963509169019130332,https://x.com/IndoPopBase/status/1963431901479534728,1
2025-09-04 03:16:04+00:00,HarshaKnaidu14,25,0,0,0,2749,https://x.com/HarshaKnaidu14/status/1963440900589363431,https://x.com/IndoPopBase/status/1963431901479534728,0
2025-09-04 06:21:14+00:00,hohologan,"Sayangnya our freakin country ugly side is, ""tidak ada reward untuk yang lurus"".",0,0,0,605,https://x.com/hohologan/status/1963487501617963376,https://x.com/IndoPopBase/status/1963431901479534728,0
2025-09-04 09:09:19+00:00,joepermana,"Tunjangan rumah sdh dihentikan, yg lain ga tau, tapi mahasiswa sdh didengarkan di DPR juga, hrsnya kasih waktu. Tapi kalau mau demo ya silahkan, tp tolong jgn rusuh, dan jgn merusak, penumpang gelap tolong di identifikasi dan ditangkap. Mahasiswa jgn sporadis tanpa komando.",0,0,0,837,https://x.com/joepermana/status/1963529798413885888,https://x.com/IndoPopBase/status/1963431901479534728,0
2025-09-04 05:56:41+00:00,thveirst_,how many have been checked??,0,0,0,602,https://x.com/thveirst_/status/1963481322459906173,https://x.com/IndoPopBase/status/1963431901479534728,0
2025-09-04 09:57:27+00:00,bubblestaffy,#ResetIndonesia masalahnya didengerin gak...,0,0,0,101,https://x.com/bubblestaffy/status/1963541913828528517,https://x.com/IndoPopBase/status/1963431901479534728,0
2025-09-04 04:04:19+00:00,bacottotheworld,"@prabowo
 udahan kan pak main karnavalnya? tuh buruan dikerjain pr-nya",0,0,0,592,https://x.com/bacottotheworld/status/1963453044756029796,https://x.com/IndoPopBase/status/1963431901479534728,0
2025-09-04 12:11:11+00:00,chopangesthii,"Otakku be likw:
The tujuh belas tuntutan rakyat dealinw ends tomorrow",0,0,0,253,https://x.com/chopangesthii/status/1963575567762010365,https://x.com/IndoPopBase/status/1963431901479534728,0
2025-09-04 12:51:17+00:00,MaybeCrypto25,85y3AuomcSaUv8tBkxDeoB2GV7HhJrkvxr37PDu8pump,0,0,0,4,https://x.com/MaybeCrypto25/status/1963585659471302964,https://x.com/IndoPopBase/status/1963431901479534728,0
2025-09-04 18:25:32+00:00,ads19sda61,Rakyatnya siapa?,0,0,0,26,https://x.com/ads19sda61/status/1963669776259076135,https://x.com/IndoPopBase/status/1963431901479534728,0
2025-09-04 02:55:05+00:00,decembersags,did they even read about it,0,0,0,1506,https://x.com/decembersags/status/1963435622187647255,https://x.com/IndoPopBase/status/1963431901479534728,0
2025-09-04 04:03:46+00:00,disitukah,"Do they even care?
I don't think so ",0,0,0,1084,https://x.com/disitukah/status/1963452904532312167,https://x.com/IndoPopBase/status/1963431901479534728,0
2025-09-04 04:40:36+00:00,sahabatnonoy,"mau tanya, genuenly ask please no salty. kalo mereka (nauzubillah) ga menyanggupi deadline, konsekuensinya apa?",0,0,0,11,https://x.com/sahabatnonoy/status/1963462175194059203,https://x.com/IndoPopBase/status/1963431901479534728,0
2025-09-04 13:11:51+00:00,gamewithwonu,thy'll be like,0,0,0,404,https://x.com/gamewithwonu/status/1963590833329856613,https://x.com/IndoPopBase/status/1963431901479534728,0
2025-09-04 13:14:03+00:00,palingGemesin,Emang dibaca?,0,0,0,79,https://x.com/palingGemesin/status/1963591388391743872,https://x.com/IndoPopBase/status/1963431901479534728,0
2025-09-04 17:16:39+00:00,5640des,It's today now.,0,0,0,70,https://x.com/5640des/status/1963652442626953576,https://x.com/IndoPopBase/status/1963431901479534728,0
2025-09-04 03:00:51+00:00,JAditya36003,Bukannya pesimis ya...cm kok gw rasa endingnya bakal super kentang (),0,0,0,75,https://x.com/JAditya36003/status/1963437070384349377,https://x.com/IndoPopBase/status/1963431901479534728,0
2025-09-04 15:04:54+00:00,costupheaval,,0,0,0,21,https://x.com/costupheaval/status/1963619285068386769,https://x.com/IndoPopBase/status/1963431901479534728,0
2025-09-04 03:28:34+00:00,cripplingjohnny,"same old story, I guess
God speed.",0,0,0,887,https://x.com/cripplingjohnny/status/1963444045105303910,https://x.com/IndoPopBase/status/1963431901479534728,0
2025-09-04 14:51:02+00:00,DimmasPutra,Santai dulu gak sih ,0,0,0,63,https://x.com/DimmasPutra/status/1963615794023235602,https://x.com/IndoPopBase/status/1963431901479534728,0
